project,pr_name,build_id,num_changed_files,num_addition,num_deletion,num_changed_line
activemq,PR-644,1,1,2,1,3
activemq,PR-656,1,2,227,1,228
activemq,PR-669,3,4,414,0,414
activemq,PR-679,1,3,130,13,143
activemq,PR-680,1,12,850,4,854
activemq,PR-681,1,6,128,2,130
activemq,PR-656,2,2,227,1,228
activemq,PR-700,1,1,1,32,33
activemq,PR-700,2,1,1,41,42
activemq,PR-700,3,1,1,41,42
activemq,PR-679,2,3,47,48,95
activemq,PR-714,1,9,156,71,227
activemq,PR-751,3,13,1230,0,1230
activemq,PR-751,4,13,1230,0,1230
activemq,PR-764,1,14,113,202,315
activemq,PR-771,4,2,112,9,121
activemq,PR-793,3,1,55,0,55
activemq,PR-793,4,1,55,0,55
activemq,PR-793,5,1,56,0,56
activemq,PR-798,1,1,1,1,2
activemq,PR-835,3,10,210,10,220
activemq,PR-835,4,10,210,10,220
activemq,PR-835,5,10,215,12,227
activemq,PR-835,6,10,211,8,219
activemq,PR-839,1,3,49,0,49
activemq,PR-839,2,3,49,0,49
activemq,PR-900,1,2,2,2,4
activemq,PR-848,4,35,4592,49,4641
activemq,PR-848,5,35,4592,49,4641
activemq,PR-839,3,3,49,0,49
activemq,PR-916,1,3,0,10,10
activemq,PR-771,5,2,112,9,121
activemq,PR-931,2,53,4780,93,4873
activemq,PR-931,3,53,4780,93,4873
activemq,PR-931,4,53,4782,93,4875
activemq,PR-937,1,8,61,4,65
activemq,PR-937,2,8,61,4,65
activemq,PR-937,3,5,49,0,49
activemq,PR-937,4,5,45,0,45
activemq,PR-907,2,1,173,0,173
activemq,PR-907,3,1,9,5,14
activemq,PR-947,2,2,162,3,165
activemq,PR-947,3,2,163,3,166
activemq,PR-947,4,2,163,3,166
activemq,PR-848,8,47,7566,8,7574
activemq,PR-949,1,3,96,30,126
activemq,PR-949,2,9,359,30,389
activemq,PR-949,3,10,423,30,453
activemq,PR-951,1,1,13,5,18
activemq,PR-931,5,53,4782,93,4875
activemq,PR-900,2,2,2,2,4
activemq,PR-839,4,3,49,0,49
activemq,PR-798,2,1,1,1,2
activemq,PR-793,7,1,57,0,57
activemq,PR-788,2,14,76,79,155
activemq,PR-771,6,2,112,9,121
activemq,PR-764,2,14,113,202,315
activemq,PR-714,2,9,156,71,227
activemq,PR-700,4,1,1,41,42
activemq,PR-679,3,3,47,48,95
activemq,PR-656,3,2,227,1,228
activemq,PR-644,2,1,2,1,3
activemq,PR-263,1,3,100,4,104
activemq,PR-230,1,1,121,0,121
activemq,PR-160,1,1,10,7,17
activemq,PR-126,1,1,1,12,13
activemq,PR-953,1,8,138,8,146
activemq,PR-953,2,8,138,8,146
activemq,PR-955,1,1,12,0,12
activemq,PR-956,3,1,15,5,20
activemq,PR-839,5,3,49,0,49
activemq,PR-953,3,8,144,8,152
activemq,PR-956,4,1,7,2,9
activemq,PR-950,7,9,282,144,426
activemq,PR-956,5,1,7,2,9
activemq,PR-950,8,9,284,146,430
activemq,PR-953,4,9,153,16,169
activemq,PR-957,1,2,44,0,44
activemq,PR-950,10,9,439,156,595
activemq,PR-950,11,9,439,156,595
activemq,PR-958,1,1,33,1,34
activemq,PR-900,3,2,2,2,4
activemq,PR-771,7,2,112,9,121
activemq,PR-960,1,1,11,11,22
activemq,PR-961,1,1,1,1,2
activemq,PR-962,1,1,1,1,2
activemq,PR-963,1,1,1,1,2
activemq,PR-900,4,2,2,2,4
activemq,PR-900,5,2,2,2,4
activemq,PR-964,9,3,14,14,28
activemq,PR-961,2,1,1,1,2
activemq,PR-771,8,3,113,9,122
activemq,PR-962,2,1,1,1,2
activemq,PR-962,3,1,1,1,2
activemq,PR-965,4,1,54,7,61
activemq,PR-962,4,1,1,1,2
activemq,PR-966,1,5,5,0,5
activemq,PR-962,5,1,1,1,2
activemq,PR-965,5,2,207,7,214
activemq,PR-916,3,3,1,10,11
activemq,PR-967,1,2,10922,4940,15862
activemq,PR-965,6,2,207,7,214
activemq,PR-965,7,3,212,7,219
activemq,PR-965,8,4,234,15,249
activemq,PR-970,1,1,1,1,2
activemq,PR-971,1,1,1,1,2
activemq,PR-972,1,2,3,4,7
activemq,PR-973,1,1,1,1,2
activemq,PR-974,1,1,1,1,2
activemq,PR-975,1,1,1,1,2
activemq,PR-976,1,1,1,1,2
activemq,PR-977,1,1,1,1,2
activemq,PR-969,2,12,8527,1,8528
activemq,PR-969,3,12,8527,1,8528
activemq,PR-978,1,2,68,3,71
activemq,PR-979,1,7,77,32,109
activemq,PR-979,3,8,315,37,352
activemq,PR-980,1,3,15,7,22
activemq,PR-979,4,9,332,40,372
activemq,PR-981,1,30,48,33,81
activemq,PR-982,1,3,16,2,18
activemq,PR-983,1,23,82,77,159
activemq,PR-983,2,23,82,77,159
activemq,PR-983,3,23,82,77,159
activemq,PR-984,2,2,140,4,144
activemq,PR-983,4,23,82,77,159
activemq,PR-983,5,23,82,77,159
activemq,PR-984,3,2,140,4,144
activemq,PR-968,6,4,286,13,299
activemq,PR-968,7,4,288,14,302
activemq,PR-931,6,53,4782,93,4875
activemq,PR-968,8,4,302,14,316
activemq,PR-985,1,1,1,1,2
activemq,PR-968,9,4,302,14,316
activemq,PR-986,1,6,7,7,14
activemq,PR-968,10,4,302,14,316
activemq,PR-987,1,1,1,1,2
activemq,PR-988,1,1,0,8,8
activemq,PR-987,2,1,1,1,2
activemq,PR-989,1,2,2,0,2
activemq,PR-990,1,2,8,12,20
activemq,PR-991,1,1,1,1,2
activemq,PR-992,1,1,1,1,2
activemq,PR-993,4,37,44,2675,2719
activemq,PR-993,5,37,44,2675,2719
activemq,PR-994,1,1,3,3,6
activemq,PR-998,1,7,261,90,351
activemq,PR-1000,1,1,1,1,2
activemq,PR-1001,1,1,94,0,94
activemq,PR-1002,2,39,7034,6,7040
activemq,PR-1003,1,1,1,2,3
activemq,PR-1004,1,1,11,2,13
activemq,PR-1004,2,3,124,6,130
activemq,PR-1004,3,3,120,6,126
activemq,PR-1005,4,3,74,1,75
activemq,PR-1005,5,3,74,1,75
activemq,PR-1005,6,3,74,1,75
activemq,PR-1007,1,1,11,2,13
activemq,PR-1005,7,3,74,1,75
activemq,PR-1008,1,1,1,1,2
activemq,PR-1009,1,18,0,2159,2159
activemq,PR-1010,1,1,1,1,2
activemq,PR-1011,1,1,1,1,2
activemq,PR-1010,2,1,1,1,2
activemq,PR-1010,3,1,1,1,2
activemq,PR-1012,1,1,1,1,2
activemq,PR-1013,1,5,567,52,619
activemq,PR-1014,1,5,567,52,619
activemq,PR-1015,1,1,1,1,2
activemq,PR-1016,1,1,1,1,2
activemq,PR-1017,1,1,1,1,2
activemq,PR-1018,1,1,1,1,2
activemq,PR-1019,1,1,1,1,2
activemq,PR-1020,1,1,1,1,2
activemq,PR-1021,1,1,1,1,2
activemq,PR-1022,1,1,1,1,2
activemq,PR-1023,1,1,1,1,2
activemq,PR-1024,1,1,1,1,2
activemq,PR-1025,1,1,1,1,2
activemq,PR-1026,1,1,1,1,2
activemq,PR-1027,1,1,1,1,2
activemq,PR-1028,1,1,1,1,2
activemq,PR-1029,1,1,1,1,2
activemq,PR-1030,1,1,1,1,2
activemq,PR-1020,2,1,1,1,2
activemq,PR-1026,2,1,1,1,2
activemq,PR-1026,3,1,1,1,2
activemq,PR-1025,2,1,1,1,2
activemq,PR-1030,2,1,1,1,2
activemq,PR-1025,3,1,1,1,2
activemq,PR-1020,3,1,1,1,2
activemq,PR-1017,2,1,1,1,2
activemq,PR-1031,1,1,1,0,1
activemq,PR-1032,1,1,1,1,2
activemq,PR-1033,1,1,1,1,2
activemq,PR-1031,2,1,1,0,1
activemq,PR-1034,1,1,1,1,2
activemq,PR-1035,1,5,512,0,512
activemq,PR-1036,1,4,363,0,363
activemq,PR-1034,2,1,1,1,2
activemq,PR-1036,2,4,363,0,363
activemq,PR-1034,3,1,1,1,2
activemq,PR-1036,3,4,364,0,364
activemq,PR-1037,1,1,1,1,2
activemq,PR-1037,2,1,1,1,2
activemq,PR-1038,1,1,1,1,2
activemq,PR-1001,2,1,94,0,94
hadoop,PR-375,2,1,2,2,4
hadoop,PR-2090,3,2,55,73,128
hadoop,PR-2071,3,1,3,1,4
hadoop,PR-2037,3,3,103,11,114
hadoop,PR-2028,3,14,93,2,95
hadoop,PR-2011,3,2,10,12,22
hadoop,PR-1924,3,2,40,8,48
hadoop,PR-1904,3,1,27,7,34
hadoop,PR-1892,3,2,40,4,44
hadoop,PR-1875,2,8,429,67,496
hadoop,PR-1860,3,2,19,6,25
hadoop,PR-1783,3,1,1,1,2
hadoop,PR-1769,3,3,106,3,109
hadoop,PR-1768,3,2,25,1,26
hadoop,PR-1746,3,1,32,49,81
hadoop,PR-1700,3,4,175,1,176
hadoop,PR-1663,3,1,2,2,4
hadoop,PR-1651,3,4,18,5,23
hadoop,PR-1300,3,1,69,25,94
hadoop,PR-1223,3,4,80,4,84
hadoop,PR-1137,3,1,5,3,8
hadoop,PR-1036,3,1,1,1,2
hadoop,PR-1021,3,1,1,1,2
hadoop,PR-2235,1,19,713,6,719
hadoop,PR-2235,2,19,713,6,719
hadoop,PR-2235,3,19,720,6,726
hadoop,PR-2235,4,19,719,9,728
hadoop,PR-2235,5,22,971,7,978
hadoop,PR-2082,1,4,32,3,35
hadoop,PR-2328,1,2,58,28,86
hadoop,PR-2388,1,1,22,6,28
hadoop,PR-2373,3,3,61,2,63
hadoop,PR-2403,1,2,18,2,20
hadoop,PR-2420,1,4,27,2,29
hadoop,PR-2430,1,2,68,5,73
hadoop,PR-2445,1,4,74,3,77
hadoop,PR-2446,1,2,728,724,1452
hadoop,PR-2457,1,1,18,0,18
hadoop,PR-2502,1,1,2,1,3
hadoop,PR-2558,1,1,1,2,3
hadoop,PR-2562,1,1,19,2,21
hadoop,PR-309,9,2,40,5,45
hadoop,PR-309,10,3,40,4,44
hadoop,PR-309,11,3,41,4,45
hadoop,PR-309,12,3,41,4,45
hadoop,PR-309,13,2,39,4,43
hadoop,PR-2574,1,2,188,3,191
hadoop,PR-2574,2,2,187,3,190
hadoop,PR-2573,2,3,312,24,336
hadoop,PR-2614,1,2,169,15,184
hadoop,PR-2611,2,37,203,81,284
hadoop,PR-2611,3,37,203,81,284
hadoop,PR-2611,5,41,197,81,278
hadoop,PR-2614,2,2,157,15,172
hadoop,PR-2643,3,78,122,114,236
hadoop,PR-2644,1,1,1,1,2
hadoop,PR-2640,2,5,543,13,556
hadoop,PR-2640,3,5,523,15,538
hadoop,PR-2595,2,8,119,1,120
hadoop,PR-2614,3,2,170,15,185
hadoop,PR-159,1,4,294,2,296
hadoop,PR-2695,1,16,886,93,979
hadoop,PR-2699,1,1,1,1,2
hadoop,PR-2720,1,7,286,8,294
hadoop,PR-2733,1,2,14,1,15
hadoop,PR-2737,1,1,31,1,32
hadoop,PR-2768,1,17,692,49,741
hadoop,PR-2771,1,3,193,0,193
hadoop,PR-2768,2,18,689,52,741
hadoop,PR-2768,3,18,690,52,742
hadoop,PR-2774,1,1,9,2,11
hadoop,PR-1894,6,1,6,8,14
hadoop,PR-2741,2,3,66,3,69
hadoop,PR-2798,1,1,3,1,4
hadoop,PR-2803,1,12,15,15,30
hadoop,PR-2809,1,1,8,3,11
hadoop,PR-2810,1,6,23,23,46
hadoop,PR-2737,2,1,12,1,13
hadoop,PR-2821,1,1,17,4,21
hadoop,PR-2822,1,3,6,3,9
hadoop,PR-2851,1,4,73,3,76
hadoop,PR-2878,1,1,14,6,20
hadoop,PR-2887,1,1,16,1,17
hadoop,PR-2888,1,1,64,31,95
hadoop,PR-2897,1,1,33,3,36
hadoop,PR-2904,2,13,114,11,125
hadoop,PR-2737,3,1,11,1,12
hadoop,PR-2737,4,3,37,1,38
hadoop,PR-2737,5,3,36,1,37
hadoop,PR-2916,1,1,1,4,5
hadoop,PR-1659,1,3,9,9,18
hadoop,PR-2542,1,1,4,4,8
hadoop,PR-2816,5,7,210,17,227
hadoop,PR-2816,6,7,187,17,204
hadoop,PR-2964,2,14,184,93,277
hadoop,PR-2966,1,1,2,0,2
hadoop,PR-2964,3,16,625,156,781
hadoop,PR-2964,4,16,625,156,781
hadoop,PR-2984,1,1,4,2,6
hadoop,PR-2987,1,1,80,35,115
hadoop,PR-2988,1,1,1,1,2
hadoop,PR-2966,3,2,59,3,62
hadoop,PR-2992,1,6,75,7,82
hadoop,PR-2993,1,2,40,3,43
hadoop,PR-2822,2,3,6,3,9
hadoop,PR-2993,2,2,40,3,43
hadoop,PR-2542,2,1,4,4,8
hadoop,PR-2541,2,1,8,0,8
hadoop,PR-2981,7,3,277,3,280
hadoop,PR-2981,8,3,278,3,281
hadoop,PR-2981,9,3,278,3,281
hadoop,PR-2981,10,3,278,3,281
hadoop,PR-2981,11,3,279,3,282
hadoop,PR-2987,2,5,283,40,323
hadoop,PR-2987,3,5,283,40,323
hadoop,PR-2966,4,1,57,3,60
hadoop,PR-2496,1,3,20,2,22
hadoop,PR-3019,1,1,4,1,5
hadoop,PR-3019,2,5,55,11,66
hadoop,PR-3019,3,6,57,11,68
hadoop,PR-3022,1,1,4,2,6
hadoop,PR-2513,1,190,19647,0,19647
hadoop,PR-2809,2,1,8,3,11
hadoop,PR-3029,1,2,2,2,4
hadoop,PR-3046,1,1,30,28,58
hadoop,PR-3047,2,1,4,3,7
hadoop,PR-2951,1,1,5,0,5
hadoop,PR-2948,1,2,30,2,32
hadoop,PR-3048,3,1,8,6,14
hadoop,PR-2816,7,9,230,17,247
hadoop,PR-3076,1,2,62,0,62
hadoop,PR-3089,1,1,16,28,44
hadoop,PR-3092,1,2,43,8,51
hadoop,PR-3094,1,1,67,0,67
hadoop,PR-3094,2,1,67,0,67
hadoop,PR-3091,2,3,91,32,123
hadoop,PR-3105,1,2,221,8,229
hadoop,PR-2816,8,9,238,17,255
hadoop,PR-2816,9,9,248,17,265
hadoop,PR-3105,2,2,239,8,247
hadoop,PR-3105,3,2,206,8,214
hadoop,PR-3105,4,2,206,8,214
hadoop,PR-3108,1,4,288,76,364
hadoop,PR-3108,2,4,290,77,367
hadoop,PR-3076,2,2,65,0,65
hadoop,PR-1953,6,16,49,39,88
hadoop,PR-3086,5,6,152,69,221
hadoop,PR-3086,6,6,162,80,242
hadoop,PR-3143,1,1,8,3,11
hadoop,PR-3143,2,1,6,4,10
hadoop,PR-3143,3,1,5,3,8
hadoop,PR-3154,1,4,106,1,107
hadoop,PR-3023,1,4,47,5,52
hadoop,PR-3157,1,2,54,34,88
hadoop,PR-1722,1,1,0,35,35
hadoop,PR-3157,2,2,54,35,89
hadoop,PR-3076,3,2,68,0,68
hadoop,PR-3162,1,1,2,2,4
hadoop,PR-2260,10,11,380,73,453
hadoop,PR-2260,11,11,379,72,451
hadoop,PR-3216,1,3,39,0,39
hadoop,PR-3216,2,3,39,0,39
hadoop,PR-3218,1,7,338,45,383
hadoop,PR-3216,3,3,39,0,39
hadoop,PR-3391,1,1,10,0,10
hadoop,PR-2552,1,6,272,5,277
hadoop,PR-3381,2,3,137,70,207
hadoop,PR-3391,2,1,12,0,12
hadoop,PR-3381,3,3,137,70,207
hadoop,PR-2611,6,41,197,81,278
hadoop,PR-3463,1,1,2,2,4
hadoop,PR-1710,1,1,11,9,20
hadoop,PR-881,1,15,368,12,380
hadoop,PR-3415,2,2,43,8,51
hadoop,PR-3502,1,1,1,0,1
hadoop,PR-1,1,1,21,22,43
hadoop,PR-881,2,15,368,12,380
hadoop,PR-1997,1,1,4,4,8
hadoop,PR-3442,1,7,174,47,221
hadoop,PR-1751,1,3,66,2,68
hadoop,PR-1747,1,5,339,99,438
hadoop,PR-3071,1,6,48,91,139
hadoop,PR-2547,1,2,8,1,9
hadoop,PR-848,1,1,2,0,2
hadoop,PR-3215,1,16,240,133,373
hadoop,PR-2919,1,4,104,37,141
hadoop,PR-1751,2,3,66,2,68
hadoop,PR-3215,2,16,240,133,373
hadoop,PR-3215,3,16,240,133,373
hadoop,PR-376,1,1,2,2,4
hadoop,PR-3539,1,24,634,24,658
hadoop,PR-1971,1,2,40,1,41
hadoop,PR-3556,1,2,3,3,6
hadoop,PR-1271,1,4,83,4,87
hadoop,PR-341,1,2,445,0,445
hadoop,PR-3586,1,1,13,10,23
hadoop,PR-2631,1,34,450,165,615
hadoop,PR-3612,3,9,910,0,910
hadoop,PR-3634,1,3,11,6,17
hadoop,PR-3649,1,1,1,1,2
hadoop,PR-3650,1,6,44,1,45
hadoop,PR-3656,1,1,2,0,2
hadoop,PR-3649,2,1,2,1,3
hadoop,PR-2912,1,2,149,1,150
hadoop,PR-3649,3,1,2,1,3
hadoop,PR-2917,1,1,1,1,2
hadoop,PR-3701,1,1,12,3,15
hadoop,PR-3705,1,2,35,6,41
hadoop,PR-3703,2,2,9,3,12
hadoop,PR-3445,6,23,233,63,296
hadoop,PR-3703,3,2,10,3,13
hadoop,PR-3445,7,23,232,62,294
hadoop,PR-3703,4,2,10,3,13
hadoop,PR-3750,1,1,1,1,2
hadoop,PR-3751,1,1,10,10,20
hadoop,PR-3758,1,5,151,7,158
hadoop,PR-3778,1,3,117,3,120
hadoop,PR-3778,2,5,138,3,141
hadoop,PR-3781,1,3,316,1,317
hadoop,PR-3782,1,1,3,1,4
hadoop,PR-3787,1,1,2,1,3
hadoop,PR-3788,1,1,2,2,4
hadoop,PR-3650,2,8,46,3,49
hadoop,PR-3778,3,5,138,3,141
hadoop,PR-3778,4,5,146,3,149
hadoop,PR-3782,2,1,3,1,4
hadoop,PR-3818,1,1,62,26,88
hadoop,PR-3743,3,13,221,0,221
hadoop,PR-3797,3,4,685,8,693
hadoop,PR-3818,2,1,65,27,92
hadoop,PR-3586,2,1,13,10,23
hadoop,PR-3830,1,1,1,1,2
hadoop,PR-3834,1,1,1,1,2
hadoop,PR-3840,1,29,1574,10,1584
hadoop,PR-3862,1,1,1,1,2
hadoop,PR-3155,1,21,302,10,312
hadoop,PR-2549,2,8,447,21,468
hadoop,PR-3754,5,4,478,1,479
hadoop,PR-3754,6,4,488,1,489
hadoop,PR-3754,7,4,488,1,489
hadoop,PR-3186,1,3,32,0,32
hadoop,PR-3901,1,7,29,3,32
hadoop,PR-3909,1,5,218,133,351
hadoop,PR-3914,1,1,1,1,2
hadoop,PR-3928,1,1,18,1,19
hadoop,PR-3935,1,1,16,5,21
hadoop,PR-3937,1,1,1,1,2
hadoop,PR-3907,3,2,91,55,146
hadoop,PR-3935,3,3,64,22,86
hadoop,PR-2239,1,2,11,1,12
hadoop,PR-2199,1,6,11,11,22
hadoop,PR-1446,1,9,617,7,624
hadoop,PR-1480,1,2,87,8,95
hadoop,PR-1380,1,1,1,1,2
hadoop,PR-3928,2,1,15,12,27
hadoop,PR-1412,1,1,1,4,5
hadoop,PR-3760,3,16,771,19,790
hadoop,PR-3754,8,4,488,1,489
hadoop,PR-297,1,1,2,2,4
hadoop,PR-285,1,1,3,5,8
hadoop,PR-277,1,1,1,1,2
hadoop,PR-16,1,3,5,5,10
hadoop,PR-3906,7,30,166,56,222
hadoop,PR-3709,1,1,1,1,2
hadoop,PR-3702,1,6,102,0,102
hadoop,PR-3469,1,1,5,3,8
hadoop,PR-3380,1,1,2,0,2
hadoop,PR-3170,1,5,125,15,140
hadoop,PR-3196,1,9,210,42,252
hadoop,PR-3754,9,4,488,1,489
hadoop,PR-3760,5,16,721,20,741
hadoop,PR-3760,6,16,733,19,752
hadoop,PR-2550,1,1,11,9,20
hadoop,PR-3702,2,7,130,0,130
hadoop,PR-3760,7,16,733,19,752
hadoop,PR-3959,4,2,78,1,79
hadoop,PR-3959,5,2,72,1,73
hadoop,PR-3702,3,7,120,0,120
hadoop,PR-3959,6,2,90,1,91
hadoop,PR-3959,7,2,89,1,90
hadoop,PR-3702,4,7,119,0,119
hadoop,PR-3966,1,20,1516,241,1757
hadoop,PR-3972,2,2,8,1,9
hadoop,PR-3448,1,2,204,194,398
hadoop,PR-3981,1,1,17,19,36
hadoop,PR-3982,1,1,2,2,4
hadoop,PR-3983,1,1,7,0,7
hadoop,PR-3979,3,3,17,2,19
hadoop,PR-3983,2,1,6,0,6
hadoop,PR-3983,3,1,6,0,6
hadoop,PR-3953,8,2,19,5,24
hadoop,PR-3966,2,18,1538,261,1799
hadoop,PR-3909,3,5,237,133,370
hadoop,PR-3470,13,32,2907,226,3133
hadoop,PR-3997,1,1,1,2,3
hadoop,PR-4005,1,8,637,3,640
hadoop,PR-3939,4,9,208,16,224
hadoop,PR-3905,2,2,22,18,40
hadoop,PR-4007,1,1,2,4,6
hadoop,PR-3966,3,18,5064,198,5262
hadoop,PR-4016,1,1,1,1,2
hadoop,PR-4017,1,1,3,1,4
hadoop,PR-3905,3,2,23,18,41
hadoop,PR-4016,2,1,1,1,2
hadoop,PR-4030,1,1,18,6,24
hadoop,PR-4033,2,1,8,2,10
hadoop,PR-3935,4,3,76,43,119
hadoop,PR-4030,2,1,22,6,28
hadoop,PR-3966,4,21,5727,273,6000
hadoop,PR-4043,1,1,5,2,7
hadoop,PR-3966,5,23,2253,279,2532
hadoop,PR-4042,2,4,95,6,101
hadoop,PR-4010,5,19,125,9,134
hadoop,PR-4059,1,5,307,12,319
hadoop,PR-3885,6,33,482,125,607
hadoop,PR-4071,1,1,11,6,17
hadoop,PR-4070,2,1,78,0,78
hadoop,PR-4070,3,1,96,0,96
hadoop,PR-4070,4,2,104,0,104
hadoop,PR-4070,5,2,107,0,107
hadoop,PR-3927,7,6,110,1,111
hadoop,PR-4070,6,2,109,0,109
hadoop,PR-3927,8,6,138,1,139
hadoop,PR-3927,9,6,136,1,137
hadoop,PR-4087,1,2,9,1,10
hadoop,PR-4089,1,1,2,2,4
hadoop,PR-4093,1,2,27,1,28
hadoop,PR-4093,2,2,30,0,30
hadoop,PR-4095,1,11,333,33,366
hadoop,PR-4098,1,11,176,10,186
hadoop,PR-4096,1,14,265,7,272
hadoop,PR-4097,1,13,313,0,313
hadoop,PR-4080,2,3,230,11,241
hadoop,PR-4118,1,13,161,5,166
hadoop,PR-3703,5,3,9,2,11
hadoop,PR-3703,6,3,9,2,11
hadoop,PR-2358,1,5,6,17,23
hadoop,PR-4096,2,17,303,8,311
hadoop,PR-4137,1,5,24,1,25
hadoop,PR-4160,1,1,1,1,2
hadoop,PR-4087,2,2,9,1,10
hadoop,PR-4171,1,6,200,26,226
hadoop,PR-4171,2,6,200,26,226
hadoop,PR-4088,5,2,21,3,24
hadoop,PR-4180,1,6,334,2,336
hadoop,PR-4180,5,7,333,2,335
hadoop,PR-4174,3,5,96,2,98
hadoop,PR-4201,1,4,49,3,52
hadoop,PR-4204,1,2,2,2,4
hadoop,PR-4006,8,6,663,19,682
hadoop,PR-3987,4,5,184,30,214
hadoop,PR-4209,1,1,6,4,10
hadoop,PR-3976,12,6,78,13,91
hadoop,PR-4207,3,5,215,18,233
hadoop,PR-4230,2,1,15,6,21
hadoop,PR-4233,1,3,14,11,25
hadoop,PR-3886,5,1,6,0,6
hadoop,PR-4230,3,1,15,6,21
hadoop,PR-4160,2,2,22,1,23
hadoop,PR-4198,5,2,36,16,52
hadoop,PR-4230,4,1,15,6,21
hadoop,PR-4171,3,6,200,26,226
hadoop,PR-4243,2,1,5,1,6
hadoop,PR-4201,2,4,62,3,65
hadoop,PR-4261,1,32,2807,54,2861
hadoop,PR-4261,2,35,2837,65,2902
hadoop,PR-4269,1,2,183,0,183
hadoop,PR-4269,2,2,200,0,200
hadoop,PR-4278,1,4,118,0,118
hadoop,PR-4295,1,2,115,1,116
hadoop,PR-3662,3,10,130,18,148
hadoop,PR-3344,3,5,86,35,121
hadoop,PR-3335,7,9,615,363,978
hadoop,PR-4307,1,15,644,13,657
hadoop,PR-4307,2,14,661,7,668
hadoop,PR-4307,3,14,667,10,677
hadoop,PR-4307,4,14,692,10,702
hadoop,PR-4322,1,3,35,0,35
hadoop,PR-4322,2,3,35,0,35
hadoop,PR-4178,9,2,14,3,17
hadoop,PR-4198,6,3,41,12,53
hadoop,PR-4198,7,3,40,11,51
hadoop,PR-4198,8,3,39,10,49
hadoop,PR-4198,9,4,47,10,57
hadoop,PR-4219,3,1,1,1,2
hadoop,PR-4359,1,6,137,48,185
hadoop,PR-4349,2,60,145,63,208
hadoop,PR-4349,3,60,150,64,214
hadoop,PR-4307,5,14,688,7,695
hadoop,PR-4361,1,1,1,1,2
hadoop,PR-4349,4,61,151,64,215
hadoop,PR-4349,5,62,153,65,218
hadoop,PR-4349,6,61,152,65,217
hadoop,PR-4376,1,1,15,22,37
hadoop,PR-4377,1,2,12,2,14
hadoop,PR-4363,4,10,140,5,145
hadoop,PR-4363,5,10,140,5,145
hadoop,PR-4363,6,10,140,5,145
hadoop,PR-4363,8,11,161,5,166
hadoop,PR-4407,1,1,10,2,12
hadoop,PR-4269,3,2,199,0,199
hadoop,PR-4420,4,4,100,6,106
hadoop,PR-4420,5,4,110,6,116
hadoop,PR-4435,1,1,24,0,24
hadoop,PR-4435,2,1,26,0,26
hadoop,PR-4437,1,1,7,3,10
hadoop,PR-316,5,6,241,468,709
hadoop,PR-4443,1,8,93,13,106
hadoop,PR-4377,2,2,13,2,15
hadoop,PR-4443,2,8,91,14,105
hadoop,PR-4450,1,23,497,24,521
hadoop,PR-4453,1,18,0,74,74
hadoop,PR-4453,2,18,1,75,76
hadoop,PR-4460,4,9,17,24,41
hadoop,PR-4460,5,9,17,24,41
hadoop,PR-4465,1,1,9,0,9
hadoop,PR-4460,6,9,17,24,41
hadoop,PR-4460,7,9,17,24,41
hadoop,PR-4460,8,9,17,24,41
hadoop,PR-4270,9,10,477,18,495
hadoop,PR-4471,1,1,57,0,57
hadoop,PR-4270,10,10,463,19,482
hadoop,PR-4270,11,11,465,19,484
hadoop,PR-4467,4,5,89,14,103
hadoop,PR-4467,5,5,89,14,103
hadoop,PR-4467,6,5,89,14,103
hadoop,PR-4450,2,23,498,24,522
hadoop,PR-4450,3,23,498,24,522
hadoop,PR-2723,3,10,962,0,962
hadoop,PR-3959,8,2,89,1,90
hadoop,PR-4450,4,23,498,24,522
hadoop,PR-4450,5,24,503,24,527
hadoop,PR-4506,1,7,50,1,51
hadoop,PR-3022,2,3,117,2,119
hadoop,PR-4509,1,1,0,1,1
hadoop,PR-4512,1,4,102,1,103
hadoop,PR-4512,2,4,107,1,108
hadoop,PR-4519,1,16,896,129,1025
hadoop,PR-4522,1,19,37,35,72
hadoop,PR-4519,2,16,906,131,1037
hadoop,PR-4519,3,17,908,131,1039
hadoop,PR-4519,4,17,910,132,1042
hadoop,PR-4528,2,4,6,6,12
hadoop,PR-4519,5,17,909,131,1040
hadoop,PR-4533,1,2,27,7,34
hadoop,PR-4539,1,3,8,2,10
hadoop,PR-4556,1,2,2,4,6
hadoop,PR-4558,1,1,16,16,32
hadoop,PR-4565,1,2,45,140,185
hadoop,PR-4270,12,11,454,19,473
hadoop,PR-4568,1,2,50,13,63
hadoop,PR-4568,2,2,52,15,67
hadoop,PR-4575,1,5,51,5,56
hadoop,PR-4558,2,1,87,71,158
hadoop,PR-4577,1,2,13,0,13
hadoop,PR-4598,1,1,1,1,2
hadoop,PR-4602,1,1,1,1,2
hadoop,PR-4604,1,1,41,17,58
hadoop,PR-4609,1,1,1,1,2
hadoop,PR-4612,1,147,4549,5275,9824
hadoop,PR-3512,1,2,107,4,111
hadoop,PR-4604,2,1,38,17,55
hadoop,PR-4621,1,2,99,11,110
hadoop,PR-4623,1,4,39,9,48
hadoop,PR-4621,2,2,99,11,110
hadoop,PR-4630,1,1,1,1,2
hadoop,PR-4638,1,43,4111,2052,6163
hadoop,PR-4640,1,45,810,0,810
hadoop,PR-4644,1,5,58,5,63
hadoop,PR-4648,1,2,6,2,8
hadoop,PR-4663,1,1,2,1,3
hadoop,PR-4665,1,5,58,1,59
hadoop,PR-4666,1,46,1896,164,2060
hadoop,PR-4568,3,4,96,15,111
hadoop,PR-4677,1,9,178,118,296
hadoop,PR-4564,6,19,537,31,568
hadoop,PR-4684,1,9,73,143,216
hadoop,PR-4684,2,8,73,132,205
hadoop,PR-4684,3,8,72,131,203
hadoop,PR-4684,5,8,71,130,201
hadoop,PR-4568,4,4,106,16,122
hadoop,PR-4691,1,4,69,2,71
hadoop,PR-4691,2,4,69,2,71
hadoop,PR-4568,5,4,106,16,122
hadoop,PR-4703,1,3,99,38,137
hadoop,PR-4653,3,2,8,0,8
hadoop,PR-4659,6,5,145,6,151
hadoop,PR-4383,14,7,929,0,929
hadoop,PR-1747,4,5,339,99,438
hadoop,PR-4653,5,2,13,0,13
hadoop,PR-4708,3,20,196,328,524
hadoop,PR-4383,15,8,934,0,934
hadoop,PR-4726,1,4,29,7,36
hadoop,PR-4665,2,5,67,7,74
hadoop,PR-4665,3,5,66,7,73
hadoop,PR-4314,20,11,883,119,1002
hadoop,PR-4314,21,11,883,119,1002
hadoop,PR-4741,1,17,914,6,920
hadoop,PR-4314,22,11,883,119,1002
hadoop,PR-4314,23,10,883,118,1001
hadoop,PR-4731,2,4,69,3,72
hadoop,PR-4564,7,24,976,48,1024
hadoop,PR-4564,8,24,963,48,1011
hadoop,PR-4753,1,4,46,2,48
hadoop,PR-4668,4,22,233,392,625
hadoop,PR-4674,3,11,158,250,408
hadoop,PR-4761,2,2,13,1,14
hadoop,PR-4780,1,2,21,14,35
hadoop,PR-4784,1,3,13,15,28
hadoop,PR-4786,1,3,65,7,72
hadoop,PR-4788,1,2,6,0,6
hadoop,PR-4791,1,2,82,4,86
hadoop,PR-4792,2,4,112,63,175
hadoop,PR-4786,4,3,65,7,72
hadoop,PR-4794,1,4,275,165,440
hadoop,PR-4786,5,3,65,7,72
hadoop,PR-4797,1,3,174,11,185
hadoop,PR-4805,1,7,22,20,42
hadoop,PR-4808,1,4,271,0,271
hadoop,PR-4809,1,2,32,1,33
hadoop,PR-4811,1,2,18,2,20
hadoop,PR-4817,2,3,387,5,392
hadoop,PR-4817,4,9,663,5,668
hadoop,PR-4831,1,2,13,14,27
hadoop,PR-4835,2,13,175,162,337
hadoop,PR-4831,2,2,13,17,30
hadoop,PR-4840,1,1,3,2,5
hadoop,PR-4835,3,13,178,165,343
hadoop,PR-4847,1,1,2,0,2
hadoop,PR-4848,1,1,4,1,5
hadoop,PR-4849,1,1,13,0,13
hadoop,PR-4854,1,39,112,127,239
hadoop,PR-4849,2,1,13,0,13
hadoop,PR-4854,2,39,117,132,249
hadoop,PR-4854,3,43,137,152,289
hadoop,PR-4867,1,2,3,2,5
hadoop,PR-4868,1,3,31,19,50
hadoop,PR-4834,2,1,1,0,1
hadoop,PR-4877,1,2,18,3,21
hadoop,PR-4887,1,1,1,1,2
hadoop,PR-4888,1,14,398,22,420
hadoop,PR-4889,1,27,81,81,162
hadoop,PR-4888,2,14,398,23,421
hadoop,PR-4891,1,3,165,47,212
hadoop,PR-4891,2,3,165,47,212
hadoop,PR-4888,3,14,396,23,419
hadoop,PR-4902,1,2,32,17,49
hadoop,PR-4911,1,1,4,1,5
hadoop,PR-4923,1,3,56,16,72
hadoop,PR-4932,1,25,1428,28,1456
hadoop,PR-4877,2,2,18,3,21
hadoop,PR-4932,2,25,1429,28,1457
hadoop,PR-4932,3,25,1429,28,1457
hadoop,PR-4932,4,25,1429,28,1457
hadoop,PR-4902,2,2,34,17,51
hadoop,PR-4854,4,45,157,152,309
hadoop,PR-4947,2,6,305,0,305
hadoop,PR-4956,1,2,29,2,31
hadoop,PR-4947,3,7,214,0,214
hadoop,PR-4947,4,7,213,0,213
hadoop,PR-4947,5,6,211,0,211
hadoop,PR-4947,6,6,211,0,211
hadoop,PR-4971,1,1,0,9,9
hadoop,PR-4968,3,12,268,35,303
hadoop,PR-4990,1,5,152,164,316
hadoop,PR-4998,1,1,20,14,34
hadoop,PR-5000,1,2,10,0,10
hadoop,PR-5001,1,2,20,6,26
hadoop,PR-4998,2,1,20,14,34
hadoop,PR-4971,2,1,2,10,12
hadoop,PR-4834,3,1,1,0,1
hadoop,PR-5020,1,4,206,176,382
hadoop,PR-5021,1,21,277,241,518
hadoop,PR-5022,1,29,1298,1196,2494
hadoop,PR-5025,1,53,3036,3010,6046
hadoop,PR-5026,1,188,4337,4230,8567
hadoop,PR-5027,1,74,1307,1157,2464
hadoop,PR-5028,1,13,520,494,1014
hadoop,PR-5020,2,4,209,179,388
hadoop,PR-5033,1,3,13,11,24
hadoop,PR-5020,3,4,209,179,388
hadoop,PR-5022,2,29,1318,1229,2547
hadoop,PR-5028,2,13,548,507,1055
hadoop,PR-4968,4,12,249,35,284
hadoop,PR-4990,2,5,158,164,322
hadoop,PR-5039,1,2,22,3,25
hadoop,PR-4968,5,12,239,35,274
hadoop,PR-5044,1,3,44,3,47
hadoop,PR-5046,1,4,294,48,342
hadoop,PR-5044,2,3,44,3,47
hadoop,PR-5065,3,2,29,6,35
hadoop,PR-4835,4,13,170,167,337
hadoop,PR-5074,1,1,22,27,49
hadoop,PR-5067,5,21,744,240,984
hadoop,PR-4996,10,51,764,384,1148
hadoop,PR-5081,1,15,180,45,225
hadoop,PR-5067,6,21,752,240,992
hadoop,PR-5071,8,4,244,1,245
hadoop,PR-5071,9,4,243,1,244
hadoop,PR-5074,2,1,22,28,50
hadoop,PR-5071,10,5,251,1,252
hadoop,PR-5082,1,3,15,7,22
hadoop,PR-5071,11,5,255,1,256
hadoop,PR-5071,12,5,261,1,262
hadoop,PR-5067,7,21,751,239,990
hadoop,PR-5085,1,1,10,2,12
hadoop,PR-5082,2,3,15,5,20
hadoop,PR-5089,1,1,37,45,82
hadoop,PR-5089,2,1,37,45,82
hadoop,PR-5089,3,2,43,45,88
hadoop,PR-4968,6,11,228,35,263
hadoop,PR-5067,9,21,751,239,990
hadoop,PR-5095,1,2,2,2,4
hadoop,PR-5033,2,3,14,12,26
hadoop,PR-5095,4,6,61,58,119
hadoop,PR-5095,5,6,61,58,119
hadoop,PR-5133,1,3,26,3,29
hadoop,PR-5139,1,5,43,6,49
hadoop,PR-5127,2,3,72,19,91
hadoop,PR-5139,2,5,43,6,49
hadoop,PR-5157,1,2,58,0,58
hadoop,PR-5139,3,5,43,6,49
hadoop,PR-5117,5,15,1133,177,1310
hadoop,PR-5117,6,16,1605,196,1801
hadoop,PR-5165,1,2,2,2,4
hadoop,PR-5166,1,2,4,3,7
hadoop,PR-5170,1,1,9,11,20
hadoop,PR-5117,7,16,1812,200,2012
hadoop,PR-5174,1,5,86,2,88
hadoop,PR-5117,8,16,1812,201,2013
hadoop,PR-5174,2,5,86,2,88
hadoop,PR-5170,2,1,9,11,20
hadoop,PR-5177,1,2,20,1,21
hadoop,PR-5178,1,1,1913,1903,3816
hadoop,PR-5177,2,2,20,1,21
hadoop,PR-5139,4,5,43,6,49
hadoop,PR-5195,1,8,946,1049,1995
hadoop,PR-5148,8,10,329,29,358
hadoop,PR-5061,1,6,62,15,77
hadoop,PR-5200,1,4,54,33,87
hadoop,PR-5203,1,3,19,16,35
hadoop,PR-5117,9,16,1813,196,2009
hadoop,PR-5204,1,1,4,0,4
hadoop,PR-4139,1,3,58,14,72
hadoop,PR-5230,1,2,21,0,21
hadoop,PR-5233,1,1,14,0,14
hadoop,PR-5234,1,3,14,0,14
hadoop,PR-5235,1,1,4,0,4
hadoop,PR-5237,1,1,1,1,2
hadoop,PR-5238,1,1,2,0,2
hadoop,PR-5139,5,5,43,6,49
hadoop,PR-5237,2,1,2,1,3
hadoop,PR-5241,1,2,70,12,82
hadoop,PR-5203,2,3,20,16,36
hadoop,PR-5236,6,4,126,0,126
hadoop,PR-5236,7,4,126,0,126
hadoop,PR-5236,8,4,126,0,126
hadoop,PR-5247,1,1,1,5,6
hadoop,PR-5236,9,4,125,0,125
hadoop,PR-5236,10,4,125,0,125
hadoop,PR-5148,14,11,354,28,382
hadoop,PR-5255,1,1,4,1,5
hadoop,PR-5255,2,1,4,1,5
hadoop,PR-5259,1,2,3,67,70
hadoop,PR-5259,2,2,3,67,70
hadoop,PR-5258,2,8,304,48,352
hadoop,PR-5258,3,8,300,48,348
hadoop,PR-5258,4,8,300,48,348
hadoop,PR-5259,3,3,4,70,74
hadoop,PR-5148,15,11,1380,1055,2435
hadoop,PR-5148,16,11,354,28,382
hadoop,PR-5148,17,11,352,28,380
hadoop,PR-5148,18,11,356,28,384
hadoop,PR-4714,1,2,16,4,20
hadoop,PR-5261,3,31,1607,1216,2823
hadoop,PR-5261,4,31,1643,1216,2859
hadoop,PR-5262,3,6,33,23,56
hadoop,PR-5263,1,1,30,1,31
hadoop,PR-5261,5,31,1649,1216,2865
hadoop,PR-5261,6,31,1653,1216,2869
hadoop,PR-5269,1,1,51,49,100
hadoop,PR-5273,3,1,12,0,12
hadoop,PR-5200,2,4,56,33,89
hadoop,PR-5273,4,4,91,3,94
hadoop,PR-5273,5,4,90,3,93
hadoop,PR-5273,6,4,145,3,148
hadoop,PR-5204,2,1,4,0,4
hadoop,PR-5293,1,1,40,19,59
hadoop,PR-5297,1,7,563,17,580
hadoop,PR-5304,1,3,27,0,27
hadoop,PR-5306,1,23,99,36,135
hadoop,PR-5306,2,24,100,36,136
hadoop,PR-5306,3,25,102,37,139
hadoop,PR-5297,2,7,562,17,579
hadoop,PR-4967,7,29,1393,595,1988
hadoop,PR-4967,8,29,1399,595,1994
hadoop,PR-5318,1,27,1506,913,2419
hadoop,PR-5318,2,27,1557,915,2472
hadoop,PR-5320,1,3,96,84,180
hadoop,PR-5317,7,2,276,485,761
hadoop,PR-4967,9,29,1399,595,1994
hadoop,PR-5320,2,5,171,157,328
hadoop,PR-5204,3,1,4,0,4
hadoop,PR-4967,10,29,813,9,822
hadoop,PR-4967,11,29,813,9,822
hadoop,PR-5318,3,30,1631,946,2577
hadoop,PR-5329,2,1,1,1,2
hadoop,PR-5333,2,2,168,70,238
hadoop,PR-5318,4,31,1676,988,2664
hadoop,PR-5320,3,11,450,383,833
hadoop,PR-5337,1,4,49,87,136
hadoop,PR-5329,3,1,1,1,2
hadoop,PR-5340,1,4,233,195,428
hadoop,PR-5341,1,1,65,58,123
hadoop,PR-5351,1,1,2,2,4
hadoop,PR-5352,1,3,93,2,95
hadoop,PR-5353,1,1,5,5,10
hadoop,PR-5354,1,6,458,18,476
hadoop,PR-5320,4,11,441,385,826
hadoop,PR-5355,1,1,10,3,13
hadoop,PR-5340,2,4,237,197,434
hadoop,PR-4968,7,11,228,35,263
hadoop,PR-5362,1,15,75,2,77
hadoop,PR-5367,1,1,6,0,6
hadoop,PR-5341,2,1,65,58,123
hadoop,PR-5374,1,7,510,37,547
hadoop,PR-5376,1,1,4,0,4
hadoop,PR-5329,4,1,1,1,2
hadoop,PR-5378,1,1,6,6,12
hadoop,PR-5365,2,2,48,3,51
hadoop,PR-5177,3,2,20,1,21
hadoop,PR-5380,1,22,1732,1680,3412
hadoop,PR-5384,1,1,1,1,2
hadoop,PR-4835,5,13,172,166,338
hadoop,PR-4835,6,13,172,166,338
hadoop,PR-5391,2,11,146,6,152
hadoop,PR-5392,1,1,34,19,53
hadoop,PR-5391,3,10,159,5,164
hadoop,PR-5398,1,1,7,1,8
hadoop,PR-5402,1,2,13,0,13
hadoop,PR-5403,2,2,35,0,35
hadoop,PR-5408,1,2,22,14,36
hadoop,PR-5408,2,2,22,14,36
hadoop,PR-5402,2,3,19,1,20
hadoop,PR-5402,3,3,23,1,24
hadoop,PR-5204,4,1,4,0,4
hadoop,PR-5414,1,3,27,1,28
hadoop,PR-5415,1,1,4,4,8
hadoop,PR-5416,1,1,8,4,12
hadoop,PR-5403,3,2,41,0,41
hadoop,PR-5419,1,1,2,2,4
hadoop,PR-5403,4,2,66,6,72
hadoop,PR-5403,5,2,66,6,72
hadoop,PR-4834,4,1,1,0,1
hadoop,PR-5337,2,4,49,87,136
hadoop,PR-5423,1,4,73,4,77
hadoop,PR-5424,1,5,18,9,27
hadoop,PR-5425,1,2,62,0,62
hadoop,PR-5425,2,2,62,0,62
hadoop,PR-5054,18,13,317,63,380
hadoop,PR-5054,19,13,317,63,380
hadoop,PR-5402,4,3,23,1,24
hadoop,PR-5399,4,9,524,15,539
hadoop,PR-5200,3,4,57,18,75
hadoop,PR-5430,1,1,15,10,25
hadoop,PR-5380,4,23,1739,1687,3426
hadoop,PR-5329,5,1,3,2,5
hadoop,PR-5403,6,2,66,6,72
hadoop,PR-5436,1,2,62,8,70
hadoop,PR-5399,7,8,527,13,540
hadoop,PR-5438,1,1,14,7,21
hadoop,PR-5438,2,1,14,7,21
hadoop,PR-5438,3,1,26,15,41
hadoop,PR-5438,4,1,27,16,43
hadoop,PR-5442,1,1,5,1,6
hadoop,PR-5443,1,17,342,505,847
hadoop,PR-5317,8,2,276,485,761
hadoop,PR-5332,4,106,2292,2013,4305
hadoop,PR-5317,9,2,272,483,755
hadoop,PR-5445,1,7,66,5,71
hadoop,PR-5445,2,7,85,5,90
hadoop,PR-5445,3,7,85,5,90
hadoop,PR-5447,1,7,273,9,282
hadoop,PR-5399,8,8,515,14,529
hadoop,PR-5447,2,7,276,11,287
hadoop,PR-5447,3,7,278,11,289
hadoop,PR-5443,2,19,565,707,1272
hadoop,PR-5332,5,106,2294,2015,4309
hadoop,PR-5452,1,1,4,0,4
hadoop,PR-5204,5,1,4,0,4
hadoop,PR-5335,11,4,42,1,43
hadoop,PR-5391,4,10,159,5,164
hadoop,PR-5455,1,2,114,95,209
hadoop,PR-5391,5,11,226,5,231
hadoop,PR-5443,3,21,540,693,1233
hadoop,PR-5391,6,11,226,7,233
hadoop,PR-5332,7,106,2281,2012,4293
hadoop,PR-5455,2,2,113,95,208
hadoop,PR-4996,11,51,764,384,1148
hadoop,PR-4996,12,51,766,384,1150
hadoop,PR-5443,4,21,541,695,1236
hadoop,PR-5446,4,9,209,13,222
hadoop,PR-5332,8,106,2282,2006,4288
hadoop,PR-5335,13,4,42,1,43
hadoop,PR-5446,5,9,215,13,228
hadoop,PR-4996,13,52,779,384,1163
hadoop,PR-5424,2,5,19,9,28
hadoop,PR-5462,1,1,33,12,45
hadoop,PR-4996,14,52,770,384,1154
hadoop,PR-5464,1,1,12,10,22
hadoop,PR-5446,7,8,204,11,215
hadoop,PR-5465,1,55,1799,1625,3424
hadoop,PR-5466,1,1,9,3,12
hadoop,PR-5446,8,8,203,11,214
hadoop,PR-5468,1,3,166,10,176
hadoop,PR-5468,2,3,184,10,194
hadoop,PR-5469,5,3,530,1,531
hadoop,PR-5421,10,55,1000,1358,2358
hadoop,PR-5335,14,4,42,1,43
hadoop,PR-5447,4,7,304,11,315
hadoop,PR-5475,1,1,2,2,4
hadoop,PR-5150,1,1,14,0,14
hadoop,PR-5477,1,2,37,2,39
hadoop,PR-5479,1,6,31,31,62
hadoop,PR-5475,2,12,28,26,54
hadoop,PR-5479,2,6,32,31,63
hadoop,PR-5462,2,2,60,13,73
hadoop,PR-5475,3,12,28,26,54
hadoop,PR-5451,10,4,89,131,220
hadoop,PR-5451,11,5,89,160,249
hadoop,PR-5484,1,2,22,16,38
hadoop,PR-5421,11,55,1003,1357,2360
hadoop,PR-5472,4,10,426,3,429
hadoop,PR-5451,12,5,89,160,249
hadoop,PR-5451,13,5,89,160,249
hadoop,PR-5475,4,12,28,26,54
hadoop,PR-5485,1,5,40,7,47
hadoop,PR-5485,2,5,44,8,52
hadoop,PR-5487,1,2,7,1,8
hadoop,PR-5487,2,2,10,4,14
hadoop,PR-5489,1,1,1,2,3
hadoop,PR-5490,1,1,2,0,2
hadoop,PR-5486,8,7,124,16,140
hadoop,PR-5486,9,7,122,16,138
hadoop,PR-5476,7,8,431,6,437
hadoop,PR-5486,10,7,130,15,145
hadoop,PR-5476,8,8,430,5,435
hadoop,PR-5475,5,12,28,26,54
hadoop,PR-5486,11,7,131,16,147
hadoop,PR-5485,3,5,44,8,52
hadoop,PR-5494,1,7,204,17,221
hadoop,PR-5486,12,7,131,16,147
hadoop,PR-5495,1,5,173,7,180
hadoop,PR-5495,3,5,175,7,182
hadoop,PR-5421,12,59,1271,1556,2827
hadoop,PR-5421,13,60,1292,1569,2861
hadoop,PR-5494,2,8,437,39,476
hadoop,PR-5494,3,8,449,39,488
hadoop,PR-5476,9,8,431,6,437
hadoop,PR-5498,1,20,1236,6,1242
hadoop,PR-5499,1,2,39,25,64
hadoop,PR-5483,4,2,23,0,23
hadoop,PR-5483,5,3,52,5,57
hadoop,PR-5483,6,2,52,0,52
hadoop,PR-5421,14,60,1293,1579,2872
hadoop,PR-5483,7,2,52,0,52
hadoop,PR-5500,1,1,3,0,3
hadoop,PR-5499,2,2,39,25,64
hadoop,PR-5501,1,2,8,4,12
hadoop,PR-5477,2,2,62,2,64
hadoop,PR-5477,3,2,62,2,64
hadoop,PR-5364,7,2,141,37,178
hadoop,PR-5364,8,2,140,37,177
hadoop,PR-5364,9,2,140,37,177
hadoop,PR-5503,1,119,1146,1094,2240
hadoop,PR-5420,15,4,288,405,693
hadoop,PR-5420,16,4,289,410,699
hadoop,PR-5503,2,119,1146,1094,2240
hadoop,PR-5503,3,119,1146,1094,2240
hadoop,PR-5496,2,8,278,3,281
hadoop,PR-5508,1,2,52,2,54
hadoop,PR-5508,2,2,50,2,52
hadoop,PR-5508,3,2,50,2,52
hadoop,PR-5364,10,2,140,37,177
hadoop,PR-5503,4,119,1170,1108,2278
hadoop,PR-5503,5,119,1170,1108,2278
hadoop,PR-5333,3,2,137,4,141
hadoop,PR-5505,3,5,68,27,95
hadoop,PR-5380,5,23,1667,1616,3283
hadoop,PR-5505,4,5,81,27,108
hadoop,PR-5505,5,5,108,27,135
hadoop,PR-5465,2,56,1802,1627,3429
hadoop,PR-5510,1,1,34,21,55
hadoop,PR-5496,3,10,328,4,332
hadoop,PR-5496,4,10,366,4,370
hadoop,PR-5054,20,13,317,63,380
hadoop,PR-5054,21,13,317,63,380
hadoop,PR-5512,1,1,0,8,8
hadoop,PR-5513,1,2,24,0,24
hadoop,PR-5364,11,2,140,37,177
hadoop,PR-5497,14,7,117,11,128
hadoop,PR-5497,15,7,117,11,128
hadoop,PR-5497,16,7,117,11,128
hadoop,PR-5496,5,10,364,5,369
hadoop,PR-5054,22,13,317,63,380
hadoop,PR-5510,2,1,38,21,59
hadoop,PR-5496,6,10,360,5,365
hadoop,PR-5476,10,8,431,6,437
hadoop,PR-5420,17,4,289,410,699
hadoop,PR-5510,3,1,38,21,59
hadoop,PR-5465,3,56,1802,1627,3429
hadoop,PR-5515,1,4,109,1,110
hadoop,PR-5481,3,13,155,58,213
hadoop,PR-5483,8,2,52,0,52
hadoop,PR-5476,11,8,430,6,436
hadoop,PR-5335,15,4,42,1,43
hadoop,PR-5329,6,1,3,2,5
hadoop,PR-5516,1,27,938,90,1028
hadoop,PR-5517,1,6,46,1,47
hadoop,PR-5517,2,6,46,1,47
hadoop,PR-5355,2,1,10,3,13
hadoop,PR-5518,1,2,65,4,69
hadoop,PR-5518,2,2,69,5,74
hadoop,PR-5518,3,3,106,5,111
hadoop,PR-5520,1,3,70,1,71
hadoop,PR-5520,2,3,70,1,71
hadoop,PR-5521,6,4,80,6,86
hadoop,PR-5523,1,8,243,62,305
hadoop,PR-5521,7,3,75,5,80
hadoop,PR-5524,1,2,0,16,16
hadoop,PR-5520,3,3,66,1,67
hadoop,PR-5519,3,16,394,122,516
hadoop,PR-5521,8,4,86,6,92
hadoop,PR-5523,2,8,244,62,306
hadoop,PR-5525,1,3,41,0,41
hadoop,PR-5526,1,1,1,0,1
hadoop,PR-5527,1,2,2,2,4
hadoop,PR-5528,1,15,287,35,322
hadoop,PR-5529,1,15,287,35,322
hadoop,PR-5521,9,4,89,6,95
hadoop,PR-5523,3,8,268,62,330
hadoop,PR-5530,1,15,302,49,351
hadoop,PR-5531,1,15,296,49,345
hadoop,PR-5531,2,15,297,49,346
hadoop,PR-5529,2,15,287,35,322
hadoop,PR-5530,2,15,302,49,351
hadoop,PR-5531,3,15,297,49,346
hadoop,PR-5521,10,4,89,6,95
hadoop,PR-5519,4,28,1213,244,1457
hadoop,PR-5533,1,2,13,4,17
hadoop,PR-5518,4,3,106,5,111
hadoop,PR-5525,2,9,362,9,371
hadoop,PR-5529,3,15,288,35,323
hadoop,PR-5535,1,1,2,3,5
hadoop,PR-5519,5,30,1391,271,1662
hadoop,PR-5534,2,7,62,9,71
hadoop,PR-5533,2,2,19,4,23
hadoop,PR-5536,3,7,62,9,71
hadoop,PR-5525,3,9,368,9,377
hadoop,PR-5535,2,4,154,135,289
hadoop,PR-5537,1,2,90,8,98
hadoop,PR-5537,2,2,90,5,95
hadoop,PR-5537,3,2,90,5,95
hadoop,PR-5519,6,30,1569,271,1840
hadoop,PR-5536,4,7,62,9,71
hadoop,PR-5536,5,7,62,9,71
hadoop,PR-5538,1,3,63,19,82
hadoop,PR-5537,4,2,90,5,95
hadoop,PR-5525,4,9,368,9,377
hadoop,PR-5536,6,7,62,9,71
hadoop,PR-5539,1,16,19,19,38
hadoop,PR-5540,1,2,9,0,9
hadoop,PR-5540,2,2,9,0,9
hadoop,PR-5540,3,3,18,4,22
hadoop,PR-5541,1,10,245,4,249
hadoop,PR-5541,2,11,253,5,258
hadoop,PR-5541,3,11,253,5,258
hadoop,PR-5525,5,9,368,9,377
hadoop,PR-5532,2,4,113,19,132
hadoop,PR-5537,5,2,87,5,92
hadoop,PR-5541,4,11,254,5,259
hadoop,PR-5519,7,30,1569,271,1840
hadoop,PR-5532,3,4,139,22,161
hadoop,PR-5543,1,20,467,73,540
hadoop,PR-5536,7,7,62,9,71
hadoop,PR-5543,2,20,466,73,539
hadoop,PR-5543,3,20,465,73,538
hadoop,PR-5544,1,9,58,55,113
hadoop,PR-5542,2,1,1,1,2
hadoop,PR-5545,1,2,20,0,20
hadoop,PR-5567,3,3,7,3,10
hadoop,PR-5575,2,6,58,57,115
hadoop,PR-5575,3,6,58,57,115
hadoop,PR-5576,1,22,889,63,952
hadoop,PR-5575,4,6,59,57,116
hadoop,PR-5575,5,6,59,57,116
hadoop,PR-5581,1,1,8,0,8
hadoop,PR-5583,1,4,158,10,168
hadoop,PR-5583,2,4,158,10,168
hadoop,PR-5591,1,1,1,1,2
hadoop,PR-5583,3,4,154,1,155
hadoop,PR-5593,1,1,16,1,17
hadoop,PR-5583,4,4,146,1,147
hadoop,PR-5599,1,2,40,0,40
hadoop,PR-5599,2,2,40,0,40
hadoop,PR-5576,2,29,1225,135,1360
hadoop,PR-5603,1,2,5,1,6
hadoop,PR-5604,1,3,3,3,6
hadoop,PR-5576,3,29,1227,135,1362
hadoop,PR-5603,2,2,7,1,8
hadoop,PR-5591,3,1,9,1,10
hadoop,PR-5603,3,2,6,1,7
hadoop,PR-5603,4,2,7,1,8
hadoop,PR-5617,1,1,7,5,12
hadoop,PR-5617,2,1,7,5,12
hadoop,PR-5603,5,2,7,1,8
hadoop,PR-5583,5,4,155,8,163
hadoop,PR-5627,1,1,3,3,6
hadoop,PR-5632,1,1,26,8,34
hadoop,PR-5633,1,2,60,6,66
hadoop,PR-5633,2,2,59,6,65
hadoop,PR-5637,1,1,1,1,2
hadoop,PR-5639,1,4,15,6,21
hadoop,PR-5640,1,2,64,17,81
hadoop,PR-5640,2,2,64,17,81
hadoop,PR-5642,1,1,3,2,5
hadoop,PR-5642,2,1,3,5,8
hadoop,PR-5642,3,1,2,5,7
hadoop,PR-5640,3,3,185,17,202
hadoop,PR-5640,4,3,184,16,200
hadoop,PR-5640,5,3,186,16,202
hadoop,PR-5673,1,3,7,13,20
hadoop,PR-5680,1,4,125,0,125
hadoop,PR-5680,2,4,123,0,123
hadoop,PR-5682,1,2,381,0,381
hadoop,PR-5686,1,1,9,9,18
hadoop,PR-5639,2,4,15,7,22
hadoop,PR-5687,1,1,5,4,9
hadoop,PR-5639,3,4,15,7,22
hadoop,PR-5673,2,1,2,1,3
hadoop,PR-5673,3,3,8,13,21
hadoop,PR-5673,4,3,9,14,23
hadoop,PR-5673,5,3,9,14,23
hadoop,PR-5706,1,1,1,1,2
hadoop,PR-5710,1,2,67,10,77
hadoop,PR-5714,1,4,119,41,160
hadoop,PR-5719,1,16,427,25,452
hadoop,PR-5720,2,6,65,12,77
hadoop,PR-5720,3,6,64,12,76
hadoop,PR-5720,4,6,64,12,76
hadoop,PR-5719,2,17,440,25,465
hadoop,PR-5711,9,18,510,78,588
hadoop,PR-5711,10,18,511,79,590
hadoop,PR-5711,11,16,509,75,584
hadoop,PR-5711,12,16,596,77,673
hadoop,PR-5720,5,6,66,12,78
hadoop,PR-5720,6,6,66,12,78
hadoop,PR-5685,10,2,34,35,69
hadoop,PR-5685,11,2,34,35,69
hadoop,PR-5685,12,1,32,35,67
hadoop,PR-5685,13,1,30,36,66
hadoop,PR-5685,14,1,32,36,68
hadoop,PR-5726,3,3,61,91,152
hadoop,PR-5758,1,6,227,0,227
hadoop,PR-5760,2,2,17,7,24
hadoop,PR-5760,3,1,16,7,23
hadoop,PR-5767,1,17,340,269,609
hadoop,PR-5771,1,9,268,19,287
hadoop,PR-5776,1,1,0,1,1
hadoop,PR-5776,2,2,0,2,2
hadoop,PR-5778,1,4,157,1,158
hadoop,PR-5778,2,4,157,0,157
hadoop,PR-5778,3,5,165,0,165
hadoop,PR-5776,3,2,2,2,4
hadoop,PR-5778,4,5,165,0,165
hadoop,PR-5778,5,5,165,0,165
hadoop,PR-5786,1,8,32,0,32
hadoop,PR-5706,2,2,3,3,6
hadoop,PR-5793,1,3,60,15,75
hadoop,PR-5793,2,4,77,18,95
hadoop,PR-5793,3,4,78,18,96
hadoop,PR-5717,4,123,1210,1125,2335
hadoop,PR-5799,1,3,15,4,19
hadoop,PR-5717,5,123,1210,1125,2335
hadoop,PR-5768,11,63,938,1481,2419
hadoop,PR-5768,13,64,956,1494,2450
hadoop,PR-5806,1,4,119,1,120
hadoop,PR-5807,1,2,32,15,47
hadoop,PR-5813,1,1,1,1,2
hadoop,PR-5768,14,66,998,1508,2506
hadoop,PR-5814,1,3,19,1,20
hadoop,PR-5821,1,3,102,24,126
hadoop,PR-5814,2,4,212,1,213
hadoop,PR-5814,3,4,212,1,213
hadoop,PR-5829,1,4,82,28,110
hadoop,PR-5826,3,2,2,2,4
hadoop,PR-5726,4,3,61,91,152
hadoop,PR-5637,2,1,1,1,2
hadoop,PR-5832,2,18,383,126,509
hadoop,PR-5835,1,18,294,74,368
hadoop,PR-5832,3,29,591,143,734
hadoop,PR-5816,15,25,1256,7,1263
hadoop,PR-5816,16,26,1320,11,1331
hadoop,PR-5810,7,18,1776,2,1778
hadoop,PR-5837,1,1,11,9,20
hadoop,PR-5835,2,20,316,85,401
hadoop,PR-5835,3,20,316,85,401
hadoop,PR-5838,1,1,1,1,2
hadoop,PR-5840,1,2,294,50,344
hadoop,PR-5841,1,14,710,858,1568
hadoop,PR-5816,17,26,1320,11,1331
hadoop,PR-5832,4,37,1312,316,1628
hadoop,PR-5821,2,3,102,24,126
hadoop,PR-5844,1,1,8,0,8
hadoop,PR-5843,5,1,25,21,46
hadoop,PR-5845,1,4,30,1,31
hadoop,PR-5847,2,3,81,0,81
hadoop,PR-5847,3,3,81,0,81
hadoop,PR-5847,4,3,98,0,98
hadoop,PR-5816,18,26,1323,11,1334
hadoop,PR-5841,2,14,712,858,1570
hadoop,PR-5810,8,18,1776,2,1778
hadoop,PR-5838,2,1,1,1,2
hadoop,PR-5848,1,1,1,1,2
hadoop,PR-5849,1,3,134,62,196
hadoop,PR-5849,2,3,132,60,192
hadoop,PR-5816,19,26,1322,11,1333
hadoop,PR-5821,3,3,103,24,127
hadoop,PR-5849,3,3,127,58,185
hadoop,PR-5850,1,1,11,0,11
hadoop,PR-5784,3,4,30,3,33
hadoop,PR-5852,1,2,46,24,70
hadoop,PR-5847,5,3,95,0,95
hadoop,PR-5853,1,1,9,9,18
hadoop,PR-5717,6,123,1210,1125,2335
hadoop,PR-5706,5,2,3,1,4
hadoop,PR-5854,1,3,75,4,79
hadoop,PR-5784,4,4,31,3,34
hadoop,PR-5841,3,15,708,858,1566
hadoop,PR-5810,9,18,1810,2,1812
hadoop,PR-5637,3,2,4,3,7
hadoop,PR-5841,4,15,707,857,1564
hadoop,PR-5855,1,3,15,12,27
hadoop,PR-5854,2,3,75,4,79
hadoop,PR-5784,7,4,34,3,37
hadoop,PR-5856,1,3,17,12,29
hadoop,PR-5854,3,3,75,4,79
hadoop,PR-5857,1,187,6453,5117,11570
hadoop,PR-5858,1,187,6478,5135,11613
hadoop,PR-5859,1,6,139,157,296
hadoop,PR-5859,2,6,139,157,296
hadoop,PR-5851,4,2,66,72,138
hadoop,PR-5855,2,3,17,12,29
hadoop,PR-5810,10,17,1797,2,1799
hadoop,PR-5726,5,3,61,91,152
hadoop,PR-5861,1,1,1,1,2
hadoop,PR-5864,1,3,19,9,28
hadoop,PR-5859,3,6,137,157,294
hadoop,PR-5597,7,6,180,0,180
hadoop,PR-5865,1,3,100,0,100
hadoop,PR-5866,1,2,4,0,4
hadoop,PR-5864,2,4,63,9,72
hadoop,PR-5857,2,187,6453,5117,11570
hadoop,PR-5859,4,6,137,157,294
hadoop,PR-5864,3,5,67,9,76
hadoop,PR-5863,4,10,206,19,225
hadoop,PR-5851,5,2,68,77,145
hadoop,PR-5851,6,2,69,77,146
hadoop,PR-5832,5,37,1309,313,1622
hadoop,PR-5832,6,37,1324,322,1646
hadoop,PR-5858,2,187,6478,5135,11613
hadoop,PR-5851,7,2,61,94,155
hadoop,PR-5851,8,2,61,94,155
hadoop,PR-5860,11,3,81,7,88
hadoop,PR-5597,8,6,179,0,179
hadoop,PR-5597,9,6,177,0,177
hadoop,PR-5866,2,2,4,0,4
hadoop,PR-5865,2,3,100,0,100
hadoop,PR-5863,5,10,209,19,228
hadoop,PR-5768,15,66,997,1507,2504
hadoop,PR-5864,4,5,67,9,76
hadoop,PR-5863,6,11,290,19,309
hadoop,PR-5863,7,11,291,19,310
hadoop,PR-5867,3,2,2,2,4
hadoop,PR-5597,10,8,232,2,234
hadoop,PR-5869,1,4,99,11,110
hadoop,PR-5845,2,5,109,1,110
hadoop,PR-5868,2,4,183,171,354
hadoop,PR-5860,12,3,44,8,52
hadoop,PR-5869,2,4,99,11,110
hadoop,PR-5597,11,8,268,2,270
hadoop,PR-5845,3,5,113,1,114
hadoop,PR-5845,4,5,113,1,114
hadoop,PR-5875,1,6,96,2,98
hadoop,PR-5876,1,2,40,4,44
hadoop,PR-5866,3,2,4,0,4
hadoop,PR-5880,1,1,4,5,9
hadoop,PR-5863,8,11,266,19,285
hadoop,PR-5881,1,19,547,88,635
hadoop,PR-5882,1,1,1,1,2
hadoop,PR-5855,3,3,89,12,101
hadoop,PR-5883,1,21,25844,574,26418
hadoop,PR-5877,2,4,23,0,23
hadoop,PR-5881,2,19,659,90,749
hadoop,PR-5881,3,19,659,93,752
hadoop,PR-5825,7,9,195,2,197
hadoop,PR-5880,2,1,13,14,27
hadoop,PR-5871,3,7,539,206,745
hadoop,PR-5860,13,3,63,5,68
hadoop,PR-5884,1,1,10,0,10
hadoop,PR-5860,14,3,64,5,69
hadoop,PR-5878,9,2,301,9,310
hadoop,PR-5860,15,3,64,5,69
hadoop,PR-5887,1,2,61,94,155
hadoop,PR-5825,8,9,190,2,192
hadoop,PR-5825,9,9,191,3,194
hadoop,PR-5875,2,6,107,2,109
hadoop,PR-5878,10,2,301,9,310
hadoop,PR-5878,11,2,301,9,310
hadoop,PR-5825,10,9,191,3,194
hadoop,PR-5888,1,1,31,3,34
hadoop,PR-5877,3,5,71,2,73
hadoop,PR-5889,1,5,12,5,17
hadoop,PR-5855,4,4,101,12,113
hadoop,PR-5889,2,5,11,5,16
hadoop,PR-5887,2,2,61,94,155
hadoop,PR-5885,5,8,216,27,243
hadoop,PR-5810,11,17,1797,2,1799
hadoop,PR-5726,6,3,61,91,152
hadoop,PR-5888,2,1,31,3,34
hadoop,PR-5862,4,10,344,4,348
hadoop,PR-5878,12,2,301,9,310
hadoop,PR-5891,1,5,11,5,16
hadoop,PR-5871,4,8,540,207,747
hadoop,PR-5862,5,10,486,6,492
hadoop,PR-5877,4,5,73,4,77
hadoop,PR-5877,5,5,73,4,77
hadoop,PR-5877,6,5,73,4,77
hadoop,PR-5885,8,5,127,23,150
hadoop,PR-5890,2,2,38,0,38
hadoop,PR-5855,5,4,104,12,116
hadoop,PR-5885,9,5,122,23,145
hadoop,PR-5862,6,15,837,6,843
hadoop,PR-5891,2,5,13,7,20
hadoop,PR-5872,4,26,1452,567,2019
hadoop,PR-5872,5,27,1470,567,2037
hadoop,PR-5871,5,8,540,207,747
hadoop,PR-5878,13,2,301,9,310
hadoop,PR-5717,7,123,1210,1125,2335
hadoop,PR-5717,8,123,1210,1125,2335
hadoop,PR-5888,3,1,41,10,51
hadoop,PR-5892,1,1,9,8,17
hadoop,PR-5890,3,2,38,0,38
hadoop,PR-5825,11,9,191,3,194
hadoop,PR-5893,1,8,39,1,40
hadoop,PR-5862,7,24,1064,41,1105
hadoop,PR-5871,6,7,539,206,745
hadoop,PR-5871,7,4,358,37,395
hadoop,PR-5883,2,20,25705,447,26152
hadoop,PR-5881,4,19,659,93,752
hadoop,PR-5894,1,1,6,1,7
hadoop,PR-5895,2,1,5,1,6
hadoop,PR-5872,6,34,1489,582,2071
hadoop,PR-5879,6,3,46,27,73
hadoop,PR-5876,2,2,7,8,15
hadoop,PR-5890,4,5,45,8,53
hadoop,PR-5890,5,7,69,20,89
hadoop,PR-5895,3,1,5,1,6
hadoop,PR-5872,7,36,1534,588,2122
hadoop,PR-5896,1,2,33,25,58
hadoop,PR-5872,8,37,1574,595,2169
hadoop,PR-5714,2,4,119,41,160
hadoop,PR-5897,1,4,290,32,322
hadoop,PR-5890,6,7,69,21,90
hadoop,PR-5879,7,3,46,27,73
hadoop,PR-5855,6,4,100,12,112
hadoop,PR-5726,7,3,61,91,152
hadoop,PR-5897,2,4,282,32,314
hadoop,PR-5888,4,1,41,10,51
hadoop,PR-5879,8,3,49,27,76
hadoop,PR-5895,4,1,9,5,14
hadoop,PR-5862,9,26,1280,78,1358
hadoop,PR-5895,5,1,8,5,13
hadoop,PR-5898,1,1,47,36,83
hadoop,PR-5888,5,1,47,36,83
hadoop,PR-5895,6,1,8,5,13
hadoop,PR-5896,2,2,33,24,57
hadoop,PR-5900,1,2,70,15,85
hadoop,PR-5901,1,1,20,11,31
hadoop,PR-5902,1,4,471,1,472
hadoop,PR-5900,2,2,73,19,92
hadoop,PR-5879,9,3,50,27,77
hadoop,PR-5879,10,3,50,27,77
hadoop,PR-5897,3,4,286,32,318
hadoop,PR-5903,1,1,1,1,2
hadoop,PR-5904,1,3,50,3,53
hadoop,PR-5845,5,5,113,1,114
hadoop,PR-5904,2,3,51,3,54
hadoop,PR-5905,1,7,182,8,190
hbase,PR-4206,1,3,29,18,47
hbase,PR-4215,1,1,6,3,9
hbase,PR-4246,1,21,946,26,972
hbase,PR-4258,2,8,503,96,599
hbase,PR-4052,1,13,176,19,195
hbase,PR-4246,2,22,990,27,1017
hbase,PR-4258,3,8,509,96,605
hbase,PR-4258,4,9,514,96,610
hbase,PR-4258,5,9,515,96,611
hbase,PR-4258,6,9,515,96,611
hbase,PR-4275,1,1,23,1,24
hbase,PR-4275,2,1,23,1,24
hbase,PR-3360,1,13,507,28,535
hbase,PR-3352,1,34,1582,155,1737
hbase,PR-4294,1,5,175,10,185
hbase,PR-4294,2,9,238,14,252
hbase,PR-4294,3,10,242,14,256
hbase,PR-4294,4,10,242,14,256
hbase,PR-4320,1,2,20,2,22
hbase,PR-4294,5,10,242,14,256
hbase,PR-4246,3,22,982,13,995
hbase,PR-4349,1,1,6,0,6
hbase,PR-4367,1,16,864,16,880
hbase,PR-4258,7,9,535,96,631
hbase,PR-4367,2,16,871,19,890
hbase,PR-4258,8,8,536,96,632
hbase,PR-4258,9,8,536,96,632
hbase,PR-4367,3,16,879,19,898
hbase,PR-4390,2,6,75,15,90
hbase,PR-4258,10,8,519,88,607
hbase,PR-4410,1,1,13,1,14
hbase,PR-4258,11,8,519,88,607
hbase,PR-4410,2,1,15,1,16
hbase,PR-4430,1,1,2,8,10
hbase,PR-4423,2,1,3,0,3
hbase,PR-4423,3,1,4,0,4
hbase,PR-4423,4,1,1,0,1
hbase,PR-4423,5,1,2,0,2
hbase,PR-4423,6,2,45,0,45
hbase,PR-4423,7,2,48,0,48
hbase,PR-4423,13,2,48,0,48
hbase,PR-4470,1,2,138,0,138
hbase,PR-4470,2,2,138,0,138
hbase,PR-4470,3,3,295,0,295
hbase,PR-4470,4,3,383,0,383
hbase,PR-4483,1,1,2,2,4
hbase,PR-4483,2,1,3,2,5
hbase,PR-4490,1,2,5,2,7
hbase,PR-4470,5,3,383,0,383
hbase,PR-4490,2,2,4,2,6
hbase,PR-4258,12,8,519,88,607
hbase,PR-4531,1,2,29,2,31
hbase,PR-4536,1,4,151,3,154
hbase,PR-4540,1,5,61,2,63
hbase,PR-4545,1,18,530,228,758
hbase,PR-4545,2,18,545,220,765
hbase,PR-4555,1,2,16,4,20
hbase,PR-4556,3,40,2034,67,2101
hbase,PR-4570,1,1,5,0,5
hbase,PR-4555,2,3,39,4,43
hbase,PR-4555,3,3,18,5,23
hbase,PR-4556,5,40,2037,67,2104
hbase,PR-4556,6,40,2037,67,2104
hbase,PR-4246,4,22,976,4,980
hbase,PR-4246,5,22,972,4,976
hbase,PR-4206,2,3,31,17,48
hbase,PR-4555,4,3,18,5,23
hbase,PR-4556,7,42,2090,67,2157
hbase,PR-4660,1,1,2,2,4
hbase,PR-4661,1,19,485,25,510
hbase,PR-4670,1,1,3,2,5
hbase,PR-4670,2,3,6,5,11
hbase,PR-4664,2,4,39,17,56
hbase,PR-4555,5,3,19,4,23
hbase,PR-4719,1,2,10,2,12
hbase,PR-4720,1,6,237,1,238
hbase,PR-4721,1,9,1019,2099,3118
hbase,PR-4660,2,1,4,4,8
hbase,PR-4720,2,6,236,1,237
hbase,PR-4721,2,9,1026,2099,3125
hbase,PR-4721,3,9,1027,2100,3127
hbase,PR-4713,4,7,335,4,339
hbase,PR-4721,4,10,1028,2101,3129
hbase,PR-4713,5,7,335,4,339
hbase,PR-4721,5,10,1030,2098,3128
hbase,PR-4721,6,10,1030,2098,3128
hbase,PR-4721,7,10,1057,2098,3155
hbase,PR-4721,8,10,1074,2097,3171
hbase,PR-4733,1,39,3752,3,3755
hbase,PR-4733,2,39,3650,2,3652
hbase,PR-4756,1,1,9,3,12
hbase,PR-4760,1,10,57,12,69
hbase,PR-4760,2,11,90,42,132
hbase,PR-4367,5,16,877,17,894
hbase,PR-4367,6,19,878,27,905
hbase,PR-4764,1,2,2,1,3
hbase,PR-4765,1,1,166,132,298
hbase,PR-4664,3,4,45,18,63
hbase,PR-4765,2,1,169,132,301
hbase,PR-4770,2,89,18892,44,18936
hbase,PR-4765,3,1,172,132,304
hbase,PR-4765,4,1,172,132,304
hbase,PR-4765,5,1,171,132,303
hbase,PR-4724,5,11,1700,30,1730
hbase,PR-4724,6,11,1707,35,1742
hbase,PR-4774,1,2,2,1,3
hbase,PR-4774,2,2,8,2,10
hbase,PR-4765,6,1,171,132,303
hbase,PR-4770,5,89,18881,44,18925
hbase,PR-4780,1,1,3,0,3
hbase,PR-4781,1,5,120,22,142
hbase,PR-4782,1,10,1375,5,1380
hbase,PR-4782,2,10,1365,5,1370
hbase,PR-4785,1,2,23,3,26
hbase,PR-4781,2,5,118,23,141
hbase,PR-4781,4,5,116,23,139
hbase,PR-4788,2,8,311,39,350
hbase,PR-4786,5,9,69,15,84
hbase,PR-4765,7,1,174,132,306
hbase,PR-4799,1,11,398,5,403
hbase,PR-4799,2,11,385,7,392
hbase,PR-4801,1,10,101,37,138
hbase,PR-4827,1,2,16,1,17
hbase,PR-4827,2,2,23,1,24
hbase,PR-4827,3,2,23,1,24
hbase,PR-4801,2,7,119,47,166
hbase,PR-4827,4,2,30,1,31
hbase,PR-4890,1,2,17,3,20
hbase,PR-4891,1,14,230,2,232
hbase,PR-4891,2,14,466,4,470
hbase,PR-4916,1,2,28,1,29
hbase,PR-4916,2,2,25,1,26
hbase,PR-4935,1,1,2,1,3
hbase,PR-4891,3,14,467,4,471
hbase,PR-4975,1,6,399,11,410
hbase,PR-4979,1,2,277,0,277
hbase,PR-4799,3,24,661,23,684
hbase,PR-4799,4,24,697,25,722
hbase,PR-4799,5,24,697,25,722
hbase,PR-4979,2,2,285,0,285
hbase,PR-4799,6,24,697,25,722
hbase,PR-4935,2,1,3,2,5
hbase,PR-4935,3,2,96,7,103
hbase,PR-5002,1,1,1,1,2
hbase,PR-4975,2,7,461,11,472
hbase,PR-5013,1,1,10,2,12
hbase,PR-5024,1,2,42,20,62
hbase,PR-5027,1,1,31,2,33
hbase,PR-5051,1,2,238,27,265
hbase,PR-5027,2,1,32,2,34
hbase,PR-5051,2,2,238,27,265
hbase,PR-5051,3,2,244,26,270
hbase,PR-5051,4,2,245,26,271
hbase,PR-5051,5,2,239,25,264
hbase,PR-4799,7,24,727,25,752
hbase,PR-4799,8,24,722,24,746
hbase,PR-4799,9,24,722,24,746
hbase,PR-5087,1,2,67,1,68
hbase,PR-5094,1,7,70,0,70
hbase,PR-5100,1,5,17,18,35
hbase,PR-5100,2,5,17,20,37
hbase,PR-5107,1,2,0,4,4
hbase,PR-5107,2,2,0,5,5
hbase,PR-5110,1,1,10,2,12
hbase,PR-5100,3,5,17,20,37
hbase,PR-5051,6,3,269,30,299
hbase,PR-5121,1,2,261,4,265
hbase,PR-5121,2,2,178,25,203
hbase,PR-5051,7,3,291,30,321
hbase,PR-5121,3,2,176,23,199
hbase,PR-5121,4,2,177,23,200
hbase,PR-5121,5,2,176,23,199
hbase,PR-5121,6,2,176,23,199
hbase,PR-5051,8,3,290,30,320
hbase,PR-5051,9,3,291,30,321
hbase,PR-5121,7,2,177,23,200
hbase,PR-5121,8,2,177,23,200
hbase,PR-5121,9,2,178,23,201
hbase,PR-5138,1,3,19,2,21
hbase,PR-4799,10,25,1063,23,1086
hbase,PR-4799,11,26,1060,24,1084
hbase,PR-4799,12,27,1064,30,1094
hbase,PR-5051,10,3,291,30,321
hbase,PR-5142,1,2,59,4,63
hbase,PR-5144,1,3,234,0,234
hbase,PR-5142,2,2,56,2,58
hbase,PR-5145,1,4,9,2,11
hbase,PR-4799,13,27,1062,30,1092
hbase,PR-5144,2,3,223,0,223
hbase,PR-5150,1,1,43,3,46
hbase,PR-5155,1,8,228,20,248
hbase,PR-5155,2,8,227,18,245
hbase,PR-5155,3,8,242,21,263
hbase,PR-5155,4,8,242,21,263
hbase,PR-5155,5,8,242,21,263
hbase,PR-5155,6,8,246,21,267
hbase,PR-5165,1,26,1323,304,1627
hbase,PR-5165,2,26,1329,304,1633
hbase,PR-5166,1,8,240,21,261
hbase,PR-5155,8,8,240,21,261
hbase,PR-5167,1,1,6,3,9
hbase,PR-5168,1,11,56,87,143
hbase,PR-5155,9,8,241,21,262
hbase,PR-5166,2,8,241,21,262
hbase,PR-5169,1,1,1,1,2
hbase,PR-5155,10,8,237,21,258
hbase,PR-5166,3,8,237,21,258
hbase,PR-5168,2,11,56,87,143
hbase,PR-5170,1,2,81,6,87
hbase,PR-5171,1,6,116,20,136
hbase,PR-5171,4,6,126,20,146
hbase,PR-5171,5,6,126,20,146
hbase,PR-5171,6,12,218,42,260
hbase,PR-5175,1,1,2,1,3
hbase,PR-5177,1,3,44,3,47
hbase,PR-5189,1,1,6,0,6
hbase,PR-5189,2,2,11,1,12
hbase,PR-5213,1,6,396,0,396
hbase,PR-5215,1,6,422,67,489
hbase,PR-5215,2,6,422,67,489
hbase,PR-5213,2,6,396,0,396
hbase,PR-5228,1,7,187,46,233
hbase,PR-5243,1,1,5,1,6
hbase,PR-5243,2,1,5,1,6
hbase,PR-5243,3,1,5,1,6
hbase,PR-5252,1,1,10,9,19
hbase,PR-5252,2,1,12,9,21
hbase,PR-5253,1,1,4,0,4
hbase,PR-5252,3,1,6,1,7
hbase,PR-5252,4,1,4,1,5
hbase,PR-5253,2,2,7,0,7
hbase,PR-5253,4,2,12,0,12
hbase,PR-5256,1,22,893,6,899
hbase,PR-5257,2,8,599,40,639
hbase,PR-5252,5,2,22,9,31
hbase,PR-5259,1,2,15,1,16
hbase,PR-5260,2,11,301,21,322
hbase,PR-5260,3,11,306,21,327
hbase,PR-5256,3,21,895,4,899
hbase,PR-5256,4,21,894,4,898
hbase,PR-5256,5,21,893,4,897
hbase,PR-5267,1,3,66,5,71
hbase,PR-5256,6,21,893,4,897
hbase,PR-5252,6,2,22,11,33
hbase,PR-5274,1,2,5,3,8
hbase,PR-5274,2,2,5,3,8
hbase,PR-5279,1,5,680,0,680
hbase,PR-5274,3,2,5,3,8
hbase,PR-5289,2,1,15,1,16
hbase,PR-5289,3,1,15,1,16
hbase,PR-5301,1,2,8,1,9
hbase,PR-5307,1,1,41,11,52
hbase,PR-5256,7,21,893,4,897
hbase,PR-5307,2,1,42,11,53
hbase,PR-5310,1,1,42,11,53
hbase,PR-5310,2,1,42,5,47
hbase,PR-5307,3,1,42,5,47
hbase,PR-5315,1,1,2,2,4
hbase,PR-5315,2,2,3,2,5
hbase,PR-5316,1,5,307,15,322
hbase,PR-5316,2,5,309,15,324
hbase,PR-5316,3,5,309,15,324
hbase,PR-5318,1,1,7,2,9
hbase,PR-5318,2,1,7,2,9
hbase,PR-5318,3,1,7,2,9
hbase,PR-5256,8,31,1111,29,1140
hbase,PR-5319,1,2,10,0,10
hbase,PR-5319,2,7,66,12,78
hbase,PR-5319,3,7,68,14,82
hbase,PR-5319,4,7,69,19,88
hbase,PR-5323,1,3,130,8,138
hbase,PR-5316,4,5,329,15,344
hbase,PR-5316,5,5,329,15,344
hbase,PR-5327,1,47,58,58,116
hbase,PR-5323,2,3,134,8,142
hbase,PR-5330,1,1,25,4,29
hbase,PR-5330,2,1,23,4,27
hbase,PR-5335,1,5,152,10,162
hive,PR-2800,1,2,2,2,4
hive,PR-2866,1,1,14,0,14
hive,PR-2866,2,1,14,0,14
hive,PR-3133,1,1,1,1,2
hive,PR-3137,1,57,1765,347,2112
hive,PR-3137,2,57,1765,347,2112
hive,PR-3137,3,59,2001,347,2348
hive,PR-3137,5,68,3040,348,3388
hive,PR-3137,7,65,3350,358,3708
hive,PR-3137,9,65,3389,371,3760
hive,PR-3137,10,65,3408,379,3787
hive,PR-3137,11,65,3408,379,3787
hive,PR-3137,12,65,3407,379,3786
hive,PR-3137,13,64,3359,379,3738
hive,PR-3197,1,14,1817,2,1819
hive,PR-3221,1,8,367,65,432
hive,PR-3218,2,6,102,9,111
hive,PR-3247,1,32,341,232,573
hive,PR-3218,3,69,260,140,400
hive,PR-3218,4,76,364,217,581
hive,PR-3218,6,83,389,253,642
hive,PR-3218,7,83,389,253,642
hive,PR-3218,8,83,389,253,642
hive,PR-3276,1,4,157,0,157
hive,PR-3276,2,4,157,0,157
hive,PR-3276,3,5,158,1,159
hive,PR-3276,4,5,158,1,159
hive,PR-3276,5,4,157,0,157
hive,PR-3279,1,5,6,6,12
hive,PR-3137,15,64,3371,379,3750
hive,PR-3279,2,24,196,98,294
hive,PR-3279,3,25,202,98,300
hive,PR-3279,4,27,213,114,327
hive,PR-3279,5,28,223,115,338
hive,PR-3279,6,29,227,151,378
hive,PR-3279,7,30,196,122,318
hive,PR-3288,1,36,1524,23,1547
hive,PR-3279,8,31,198,122,320
hive,PR-3289,1,3,51,11,62
hive,PR-3247,4,32,175,105,280
hive,PR-3137,18,71,4372,819,5191
hive,PR-3137,19,71,4370,819,5189
hive,PR-3137,23,71,4378,824,5202
hive,PR-3137,24,71,4376,824,5200
hive,PR-3137,25,71,4358,819,5177
hive,PR-3289,2,3,47,3,50
hive,PR-3137,26,72,4472,859,5331
hive,PR-3279,9,31,198,122,320
hive,PR-3137,27,72,4493,860,5353
hive,PR-3137,28,72,4493,860,5353
hive,PR-3137,29,83,4543,902,5445
hive,PR-3289,3,3,47,3,50
hive,PR-3137,30,83,4564,902,5466
hive,PR-3289,4,3,47,3,50
hive,PR-3312,1,9,433,3,436
hive,PR-3137,31,82,4537,881,5418
hive,PR-3317,3,21,1161,52,1213
hive,PR-3137,33,82,4549,881,5430
hive,PR-3137,34,82,4550,881,5431
hive,PR-3303,3,3,412,64,476
hive,PR-3303,4,3,412,64,476
hive,PR-3254,35,2,27,0,27
hive,PR-3289,6,5,99,54,153
hive,PR-3288,4,38,1538,23,1561
hive,PR-3289,7,5,99,54,153
hive,PR-3289,8,5,99,54,153
hive,PR-3303,9,4,442,65,507
hive,PR-3289,10,5,104,62,166
hive,PR-3347,1,3,95,0,95
hive,PR-3247,6,31,172,19,191
hive,PR-3296,9,69,38,147,185
hive,PR-3137,35,83,4959,881,5840
hive,PR-3296,10,69,42,152,194
hive,PR-3247,7,31,171,11,182
hive,PR-3339,4,16,2339,16,2355
hive,PR-3359,1,1,0,2,2
hive,PR-3360,1,10,122,33,155
hive,PR-3362,1,8,169,80,249
hive,PR-3364,1,1,2,1,3
hive,PR-3362,2,11,200,85,285
hive,PR-3364,2,5,53,1,54
hive,PR-3360,2,18,140,32,172
hive,PR-3247,9,31,171,10,181
hive,PR-3304,4,8,72,5,77
hive,PR-3365,3,106,8642,4029,12671
hive,PR-3377,1,4,6,6,12
hive,PR-3362,4,11,200,85,285
hive,PR-3362,5,11,200,85,285
hive,PR-3377,2,4,6,6,12
hive,PR-3377,3,4,6,6,12
hive,PR-3381,2,3,55,13,68
hive,PR-3377,4,4,6,6,12
hive,PR-3375,2,5,5,5,10
hive,PR-3289,12,6,127,79,206
hive,PR-3381,3,3,55,13,68
hive,PR-3345,4,1,2,4,6
hive,PR-3386,1,10,365,34,399
hive,PR-3388,2,3,54,5,59
hive,PR-3137,36,83,5016,929,5945
hive,PR-3289,13,15,216,137,353
hive,PR-3388,3,3,54,5,59
hive,PR-3360,5,32,297,133,430
hive,PR-3377,5,4,6,6,12
hive,PR-3381,4,3,55,13,68
hive,PR-3289,14,14,198,119,317
hive,PR-3360,6,40,275,164,439
hive,PR-3137,37,94,5694,1047,6741
hive,PR-3396,1,1,1,0,1
hive,PR-3289,15,18,260,143,403
hive,PR-3289,16,18,260,143,403
hive,PR-3379,3,6,131,29,160
hive,PR-3400,1,11,74,30,104
hive,PR-3401,1,7,100,5,105
hive,PR-3404,1,3,262,2,264
hive,PR-3404,2,3,262,2,264
hive,PR-3402,3,1,16,0,16
hive,PR-3339,10,20,2370,16,2386
hive,PR-3303,11,4,442,65,507
hive,PR-3289,18,18,261,142,403
hive,PR-3303,12,4,442,65,507
hive,PR-3289,19,18,261,142,403
hive,PR-3247,11,31,170,12,182
hive,PR-3381,8,4,80,16,96
hive,PR-3408,1,3,24,0,24
hive,PR-3408,2,3,25,0,25
hive,PR-3401,5,7,100,6,106
hive,PR-3381,9,4,80,16,96
hive,PR-3365,14,16,764,11,775
hive,PR-3381,10,4,80,16,96
hive,PR-3362,10,11,331,143,474
hive,PR-3339,11,20,2370,16,2386
hive,PR-3386,4,13,399,21,420
hive,PR-3411,1,7,151,1107,1258
hive,PR-3247,12,31,185,14,199
hive,PR-3316,4,35,400,196,596
hive,PR-3247,14,33,193,20,213
hive,PR-3412,1,5,1489,623,2112
hive,PR-3137,43,95,5810,1050,6860
hive,PR-3412,2,5,1273,407,1680
hive,PR-3247,17,33,186,20,206
hive,PR-3386,7,13,408,22,430
hive,PR-3247,20,33,182,20,202
hive,PR-3279,12,41,1516,559,2075
hive,PR-3413,2,7,21,14,35
hive,PR-3413,3,8,22,14,36
hive,PR-3279,13,42,1517,559,2076
hive,PR-3414,1,13,513,125,638
hive,PR-3279,15,37,244,152,396
hive,PR-3414,2,13,518,135,653
hive,PR-3414,3,13,518,135,653
hive,PR-3415,1,3,75,1,76
hive,PR-3416,1,1,3,3,6
hive,PR-3417,1,4,494,1,495
hive,PR-3418,1,5,142,1,143
hive,PR-3419,1,2,8,8,16
hive,PR-3419,2,3,84,9,93
hive,PR-3418,2,5,145,1,146
hive,PR-3420,1,10,133,182,315
hive,PR-3419,3,3,73,8,81
hive,PR-3419,5,3,73,8,81
hive,PR-3386,8,13,408,22,430
hive,PR-3279,16,37,244,152,396
hive,PR-3424,1,1,17,16,33
hive,PR-3425,1,1,1,1,2
hive,PR-3429,1,113,28918,816,29734
hive,PR-3430,1,9,884,76,960
hive,PR-3430,2,24,1306,548,1854
hive,PR-3431,1,2,18,21,39
hive,PR-3432,1,3,33,1,34
hive,PR-3433,1,3,95,0,95
hive,PR-3429,2,113,28918,816,29734
hive,PR-3386,9,13,413,22,435
hive,PR-3434,1,118,499,404,903
hive,PR-3435,1,10,346,93,439
hive,PR-3432,2,5,46,14,60
hive,PR-3429,3,113,28918,816,29734
hive,PR-3419,7,3,73,9,82
hive,PR-3419,9,3,73,9,82
hive,PR-3434,2,119,574,407,981
hive,PR-3434,3,119,575,407,982
hive,PR-3441,1,119,572,404,976
hive,PR-3442,1,3,27,7,34
hive,PR-3443,1,12,942,33,975
hive,PR-3443,2,13,949,33,982
hive,PR-3442,2,3,27,7,34
hive,PR-3442,3,3,27,7,34
hive,PR-3435,2,10,348,93,441
hive,PR-3137,44,96,6544,1053,7597
hive,PR-3445,1,9,329,62,391
hive,PR-3442,4,3,27,7,34
hive,PR-3448,1,7,310,0,310
hive,PR-3448,2,7,345,0,345
hive,PR-3363,3,1,1,1,2
hive,PR-3445,2,9,344,62,406
hive,PR-3445,3,9,344,62,406
hive,PR-3137,45,96,6570,1053,7623
hive,PR-3451,1,2,31,14,45
hive,PR-3443,5,15,1108,36,1144
hive,PR-3453,1,3,118,4,122
hive,PR-3449,2,2,3,3,6
hive,PR-3449,3,2,4,5,9
hive,PR-3454,1,3,95,3,98
hive,PR-3454,2,3,95,3,98
hive,PR-3137,46,152,8439,1142,9581
hive,PR-3218,10,83,389,253,642
hive,PR-3454,3,3,99,7,106
hive,PR-3429,4,112,28909,816,29725
hive,PR-3449,4,2,4,5,9
hive,PR-3454,4,4,164,48,212
hive,PR-3457,1,5,97,12,109
hive,PR-3458,1,2,19,0,19
hive,PR-3459,1,3,6,3,9
hive,PR-3386,13,12,419,22,441
hive,PR-3454,5,4,166,48,214
hive,PR-3386,14,12,419,22,441
hive,PR-3429,5,112,28857,32915,61772
hive,PR-3461,2,14,635,630,1265
hive,PR-3386,15,12,421,22,443
hive,PR-3463,1,2,7,3,10
hive,PR-3461,3,15,482,667,1149
hive,PR-3461,4,15,482,668,1150
hive,PR-3137,47,153,8628,1327,9955
hive,PR-3465,1,1,2,1,3
hive,PR-3448,4,8,500,0,500
hive,PR-3444,5,8,328,69,397
hive,PR-3457,3,12,117,1,118
hive,PR-3468,1,3,17,7,24
hive,PR-3448,6,8,575,0,575
hive,PR-3471,1,1,1,3,4
hive,PR-3469,2,4,39,31,70
hive,PR-3296,21,76,151,247,398
hive,PR-3449,7,2,4,5,9
hive,PR-3142,1,2,42,25,67
hive,PR-3449,8,2,4,5,9
hive,PR-3457,4,17,149,35,184
hive,PR-3433,3,4,115,8,123
hive,PR-3474,2,1,2,2,4
hive,PR-3457,6,17,170,31,201
hive,PR-3469,3,4,44,31,75
hive,PR-3451,5,2,25,1,26
hive,PR-3475,1,1,1,1,2
hive,PR-3448,8,8,537,0,537
hive,PR-3469,4,4,44,31,75
hive,PR-3448,9,8,549,0,549
hive,PR-3480,1,12,524,74,598
hive,PR-3481,1,4,155,102,257
hive,PR-3475,2,2,7,2,9
hive,PR-3483,1,7,641,16,657
hive,PR-3475,3,4,18,3,21
hive,PR-3484,1,8,704,51,755
hive,PR-3481,2,4,155,102,257
hive,PR-3279,17,37,234,152,386
hive,PR-3444,7,9,939,576,1515
hive,PR-3480,2,13,519,73,592
hive,PR-3345,5,1,2,4,6
hive,PR-3279,18,37,234,152,386
hive,PR-3484,2,9,706,53,759
hive,PR-3457,8,13,223,0,223
hive,PR-3485,4,3,15,2,17
hive,PR-3279,21,38,236,154,390
hive,PR-3279,22,38,236,154,390
hive,PR-3485,5,2,14,1,15
hive,PR-3315,1,1,1,1,2
hive,PR-3485,6,3,22,1,23
hive,PR-3477,2,25,3790,909,4699
hive,PR-3482,3,1,6,1,7
hive,PR-3489,1,3,43,0,43
hive,PR-3489,2,4,39,0,39
hive,PR-3487,2,1,34,40,74
hive,PR-3482,4,1,6,1,7
hive,PR-3435,5,10,349,91,440
hive,PR-3279,25,38,236,154,390
hive,PR-3482,5,1,6,1,7
hive,PR-3491,1,5,5,0,5
hive,PR-3477,3,25,3850,909,4759
hive,PR-3491,2,5,6,0,6
hive,PR-3477,4,25,3850,909,4759
hive,PR-3492,1,3,38,1,39
hive,PR-3441,3,119,593,408,1001
hive,PR-3435,6,10,349,91,440
hive,PR-3494,1,1,1,1,2
hive,PR-3493,1,1,1,1,2
hive,PR-3496,1,1,1,1,2
hive,PR-3495,1,1,1,1,2
hive,PR-3436,2,1,1,1,2
hive,PR-3497,1,3,3,3,6
hive,PR-3498,1,1,1,1,2
hive,PR-3482,6,1,6,1,7
hive,PR-3435,7,10,349,91,440
hive,PR-3477,6,27,4098,909,5007
hive,PR-3498,2,3,3,20,23
hive,PR-3499,1,2,78,1,79
hive,PR-3498,3,9,32,45,77
hive,PR-3479,4,20,198,29,227
hive,PR-3435,8,10,352,91,443
hive,PR-3499,2,2,78,1,79
hive,PR-3501,1,2,75,3,78
hive,PR-3477,7,27,4098,909,5007
hive,PR-3467,2,3,24,1,25
hive,PR-3503,1,1,1,1,2
hive,PR-3477,8,27,4098,909,5007
hive,PR-3487,4,1,23,40,63
hive,PR-3502,2,2,6,4,10
hive,PR-3504,2,2,32,18,50
hive,PR-3498,5,11,13330,7392,20722
hive,PR-3467,3,3,24,1,25
hive,PR-3477,9,27,4098,909,5007
hive,PR-3502,3,2,6,4,10
hive,PR-3492,2,3,38,1,39
hive,PR-3492,3,3,105,1,106
hive,PR-3504,3,2,39,19,58
hive,PR-3487,5,1,23,40,63
hive,PR-3502,4,2,7,4,11
hive,PR-3487,6,1,23,40,63
hive,PR-3501,2,2,75,3,78
hive,PR-3505,1,2,40,19,59
hive,PR-3498,7,12,13332,7393,20725
hive,PR-3254,39,2,49,0,49
hive,PR-3506,1,10,21,49,70
hive,PR-3507,1,1,1,1,2
hive,PR-3487,7,1,23,40,63
hive,PR-3477,10,27,4101,910,5011
hive,PR-3505,3,2,42,21,63
hive,PR-3505,4,2,42,21,63
hive,PR-3508,1,1,1,1,2
hive,PR-3312,8,9,433,3,436
hive,PR-3505,5,2,42,21,63
hive,PR-3505,6,2,42,21,63
hive,PR-3391,2,1,1,1,2
hive,PR-3477,11,27,4101,910,5011
hive,PR-3312,9,9,433,3,436
hive,PR-3477,12,27,4101,910,5011
hive,PR-3142,2,2,42,25,67
hive,PR-3364,3,5,53,1,54
hive,PR-3489,5,4,73,54,127
hive,PR-3511,1,4,7,9,16
hive,PR-3489,6,5,123,66,189
hive,PR-3254,40,2,45,0,45
hive,PR-3489,7,5,123,66,189
hive,PR-3254,43,2,42,0,42
hive,PR-3512,1,1,39,0,39
hive,PR-3444,10,10,484,55,539
hive,PR-3513,1,69,2220,431,2651
hive,PR-3477,15,27,4094,910,5004
hive,PR-3254,46,2,42,0,42
hive,PR-3499,4,2,78,1,79
hive,PR-3444,11,10,483,53,536
hive,PR-3489,8,5,123,66,189
hive,PR-3254,48,2,42,0,42
hive,PR-3499,5,2,78,1,79
hive,PR-3513,2,70,2224,431,2655
hive,PR-3444,12,10,483,53,536
hive,PR-3513,3,70,2224,431,2655
hive,PR-3511,2,8,74,45,119
hive,PR-3511,3,9,77,48,125
hive,PR-3511,4,9,77,48,125
hive,PR-3499,6,2,78,1,79
hive,PR-3133,4,1,2,1,3
hive,PR-3516,1,2,22,1,23
hive,PR-3518,1,10,41,82,123
hive,PR-3520,1,1,14,0,14
hive,PR-3520,2,1,21,6,27
hive,PR-3477,16,27,4122,910,5032
hive,PR-3521,1,74,2257,443,2700
hive,PR-3477,17,27,4122,910,5032
hive,PR-3433,5,4,117,8,125
hive,PR-3516,2,2,22,1,23
hive,PR-3312,12,9,448,3,451
hive,PR-3522,1,1,1,1,2
hive,PR-3499,7,2,78,1,79
hive,PR-3312,13,9,443,3,446
hive,PR-3477,18,27,4123,910,5033
hive,PR-3516,3,2,22,1,23
hive,PR-3477,19,27,4124,910,5034
hive,PR-3312,14,9,442,3,445
hive,PR-2731,2,19,242,4,246
hive,PR-3516,4,2,22,1,23
hive,PR-3524,2,15,310,49,359
hive,PR-3477,20,27,4124,910,5034
hive,PR-3516,5,2,22,1,23
hive,PR-3525,1,2,26,6,32
hive,PR-3524,3,15,310,49,359
hive,PR-3526,1,8,840,3,843
hive,PR-3477,21,27,4125,910,5035
hive,PR-3435,9,12,366,92,458
hive,PR-3528,1,7,180,8,188
hive,PR-3529,1,1,9,9,18
hive,PR-3516,6,2,22,1,23
hive,PR-3531,1,1,55,45,100
hive,PR-3529,2,2,10,10,20
hive,PR-3532,1,1,31,0,31
hive,PR-3533,1,1,1,1,2
hive,PR-3530,2,2,43,8,51
hive,PR-3477,23,27,4146,910,5056
hive,PR-3477,24,27,4146,910,5056
hive,PR-3477,25,27,4146,910,5056
hive,PR-3435,10,12,367,93,460
hive,PR-3516,7,2,22,1,23
hive,PR-3531,2,1,55,45,100
hive,PR-3533,2,1,2,1,3
hive,PR-3435,11,12,367,93,460
hive,PR-3531,3,1,54,40,94
hive,PR-3532,2,1,31,0,31
hive,PR-3536,1,2,10,5,15
hive,PR-3537,1,3,10,6,16
hive,PR-3535,3,3,3,3,6
hive,PR-3539,1,1,0,1,1
hive,PR-3538,3,3,18,9,27
hive,PR-3531,4,1,54,40,94
hive,PR-3538,4,3,18,9,27
hive,PR-3538,5,3,18,9,27
hive,PR-3540,1,3,9,41,50
hive,PR-3524,6,15,312,49,361
hive,PR-3433,6,4,117,8,125
hive,PR-3531,5,1,54,40,94
hive,PR-3525,2,3,31,11,42
hive,PR-3535,4,3,3,3,6
hive,PR-3537,3,4,17,9,26
hive,PR-3524,7,15,312,49,361
hive,PR-3513,5,64,2105,377,2482
hive,PR-3532,5,1,31,0,31
hive,PR-3534,3,5,3642,2,3644
hive,PR-3542,1,3,35,2,37
hive,PR-3530,4,4,49,13,62
hive,PR-3531,6,1,54,40,94
hive,PR-3435,12,12,367,93,460
hive,PR-3513,6,65,2106,378,2484
hive,PR-3531,7,2,15,5,20
hive,PR-3537,4,4,17,9,26
hive,PR-3516,8,2,22,1,23
hive,PR-3142,3,2,42,25,67
hive,PR-3532,7,1,41,1,42
hive,PR-3531,8,2,15,5,20
hive,PR-3525,4,3,61,14,75
hive,PR-3544,1,12,369,93,462
hive,PR-3530,5,4,49,13,62
hive,PR-3528,3,10,212,19,231
hive,PR-3544,2,12,369,93,462
hive,PR-3525,5,3,63,14,77
hive,PR-3531,9,2,15,5,20
hive,PR-3545,1,3,128,1,129
hive,PR-3444,13,10,461,75,536
hive,PR-3546,1,1,1,1,2
hive,PR-3549,1,1,11,2,13
hive,PR-3550,1,7,486,2,488
hive,PR-3513,10,65,2108,380,2488
hive,PR-3537,6,4,17,9,26
hive,PR-3544,3,12,377,93,470
hive,PR-3531,12,3,46,4,50
hive,PR-3599,1,279,87439,56714,144153
hive,PR-3599,2,279,87439,56714,144153
hive,PR-3599,3,279,87439,56714,144153
hive,PR-3599,4,279,87439,56714,144153
hive,PR-3599,5,279,87439,56714,144153
hive,PR-3599,6,279,87439,56714,144153
hive,PR-3599,7,279,87439,56714,144153
hive,PR-3599,11,280,87439,56714,144153
hive,PR-3599,12,283,86581,57430,144011
hive,PR-3599,13,281,86785,57331,144116
hive,PR-3833,1,4,197,113,310
hive,PR-3833,2,4,197,113,310
hive,PR-3833,3,4,197,113,310
hive,PR-3833,4,4,462,126,588
hive,PR-3833,5,20,655,224,879
hive,PR-3845,1,300,21914,3036,24950
hive,PR-3833,6,62,1082,651,1733
hive,PR-3833,7,62,795,364,1159
hive,PR-3833,8,62,795,364,1159
hive,PR-3849,1,4,405,7,412
hive,PR-3833,9,62,795,364,1159
hive,PR-3861,1,177,8570,7795,16365
hive,PR-3833,10,63,799,365,1164
hive,PR-3861,2,177,8570,7795,16365
hive,PR-3833,11,63,800,364,1164
hive,PR-3849,3,4,412,7,419
hive,PR-3849,4,4,411,7,418
hive,PR-3833,12,69,836,400,1236
hive,PR-3845,2,300,21914,3036,24950
hive,PR-3861,3,177,8570,7795,16365
hive,PR-3849,5,4,411,7,418
hive,PR-3845,3,300,21914,3036,24950
hive,PR-3849,6,4,395,7,402
hive,PR-3861,4,177,8570,7795,16365
hive,PR-3861,5,180,9637,10230,19867
hive,PR-3880,2,216,16355,9564,25919
hive,PR-3845,4,300,21914,3036,24950
hive,PR-3880,3,216,16354,9564,25918
hive,PR-3845,5,300,21818,3035,24853
hive,PR-3891,1,7,457,9,466
hive,PR-3891,2,8,469,11,480
hive,PR-3845,7,300,21841,3034,24875
hive,PR-3894,1,4,12,0,12
hive,PR-3845,8,300,21843,3035,24878
hive,PR-3880,4,217,16361,9564,25925
hive,PR-3849,7,6,380,3,383
hive,PR-3891,3,20,516,48,564
hive,PR-3891,4,14,523,44,567
hive,PR-3891,5,15,522,47,569
hive,PR-3907,1,3,279,9,288
hive,PR-3907,2,5,305,9,314
hive,PR-3845,9,300,21843,3035,24878
hive,PR-3907,3,25,505,9,514
hive,PR-3907,4,25,505,9,514
hive,PR-3907,5,25,505,9,514
hive,PR-3833,14,69,836,400,1236
hive,PR-3845,10,300,21843,3035,24878
hive,PR-3833,15,69,836,400,1236
hive,PR-3894,2,4,12,0,12
hive,PR-3845,12,300,21624,3052,24676
hive,PR-3907,6,31,612,52,664
hive,PR-3907,7,33,742,68,810
hive,PR-3845,13,300,21624,3052,24676
hive,PR-3845,14,300,21712,3058,24770
hive,PR-3938,1,3,46,8,54
hive,PR-3833,16,69,836,400,1236
hive,PR-3845,15,300,21712,3058,24770
hive,PR-3907,9,36,839,89,928
hive,PR-3833,17,69,790,400,1190
hive,PR-3833,18,69,790,400,1190
hive,PR-3959,1,1,4,1,5
hive,PR-3845,16,300,21712,3058,24770
hive,PR-3959,2,3,13,1,14
hive,PR-3845,17,300,21712,3058,24770
hive,PR-3907,11,36,839,89,928
hive,PR-3907,12,36,839,89,928
hive,PR-3845,18,300,21712,3058,24770
hive,PR-3907,13,36,839,89,928
hive,PR-3968,1,7,617,44,661
hive,PR-3966,2,1,4,10,14
hive,PR-3845,20,300,21712,3058,24770
hive,PR-3905,4,5,944,15,959
hive,PR-3966,3,1,4,10,14
hive,PR-3973,1,1,3,0,3
hive,PR-3880,7,217,16496,9690,26186
hive,PR-3891,7,15,518,48,566
hive,PR-3891,8,15,521,52,573
hive,PR-3968,2,6,205,77,282
hive,PR-3880,8,217,16490,9690,26180
hive,PR-3968,4,7,624,44,668
hive,PR-3880,9,217,16493,9690,26183
hive,PR-3981,1,1,21,8,29
hive,PR-3982,1,5,264,0,264
hive,PR-3880,10,218,16494,9690,26184
hive,PR-3982,2,6,267,0,267
hive,PR-3983,2,300,480,442,922
hive,PR-3982,3,6,267,0,267
hive,PR-3968,5,8,630,44,674
hive,PR-3982,4,6,267,0,267
hive,PR-3986,1,6,197,50,247
hive,PR-3599,14,281,86785,57331,144116
hive,PR-3987,2,12,65,60,125
hive,PR-3989,2,13,798,115,913
hive,PR-3993,1,3,87,48,135
hive,PR-3989,3,13,800,104,904
hive,PR-3973,2,1,3,0,3
hive,PR-3982,5,6,255,0,255
hive,PR-3982,6,6,255,0,255
hive,PR-3938,3,2,37,3,40
hive,PR-3845,21,300,21712,3058,24770
hive,PR-3779,1,2,4,0,4
hive,PR-3973,3,1,3,0,3
hive,PR-3845,22,300,21712,3058,24770
hive,PR-3993,2,3,92,48,140
hive,PR-3996,1,2,2,2,4
hive,PR-3779,2,2,4,0,4
hive,PR-3994,3,66,280,297,577
hive,PR-3996,2,4,10,10,20
hive,PR-3997,1,24,1631,495,2126
hive,PR-3994,4,66,280,297,577
hive,PR-3998,1,5,443,172,615
hive,PR-3995,3,2,21,13,34
hive,PR-3880,11,218,16494,9690,26184
hive,PR-3997,3,24,1628,495,2123
hive,PR-3999,1,15,174,56,230
hive,PR-3994,5,66,280,297,577
hive,PR-4000,1,3,155,12,167
hive,PR-3983,3,300,476,446,922
hive,PR-4002,1,300,562,444,1006
hive,PR-4004,1,300,19145,63,19208
hive,PR-3968,7,8,626,44,670
hive,PR-4000,3,3,230,11,241
hive,PR-4000,4,3,230,11,241
hive,PR-3968,8,8,626,44,670
hive,PR-3994,6,66,280,297,577
hive,PR-3998,2,52,2119,3895,6014
hive,PR-3845,23,300,21712,3058,24770
hive,PR-3896,5,6,308,0,308
hive,PR-3999,2,17,184,62,246
hive,PR-3986,2,6,197,50,247
hive,PR-3861,6,177,8576,7796,16372
hive,PR-4000,6,4,233,13,246
hive,PR-4009,1,2,38,1,39
hive,PR-4010,1,1,1,1,2
hive,PR-3999,3,17,186,62,248
hive,PR-3996,3,4,10,10,20
hive,PR-3987,3,12,64,60,124
hive,PR-3994,7,66,280,297,577
hive,PR-4009,2,3,43,8,51
hive,PR-4010,2,1,1,1,2
hive,PR-4013,1,5,254,3,257
hive,PR-4014,1,2,35,2,37
hive,PR-4000,8,3,416,11,427
hive,PR-4013,2,5,255,3,258
hive,PR-3994,8,66,280,297,577
hive,PR-4013,3,5,255,3,258
hive,PR-3994,9,66,280,297,577
hive,PR-4013,4,5,255,3,258
hive,PR-4015,1,2,5,1,6
hive,PR-4013,5,5,259,3,262
hive,PR-4013,6,5,243,3,246
hive,PR-3989,4,13,800,104,904
hive,PR-3994,10,66,280,297,577
hive,PR-4016,1,4,110,7,117
hive,PR-4016,2,4,114,7,121
hive,PR-3989,5,13,800,104,904
hive,PR-4017,1,1,1,1,2
hive,PR-4004,4,300,18126,62,18188
hive,PR-4018,1,7,587,1076,1663
hive,PR-4019,1,12,365,47,412
hive,PR-4016,3,4,114,7,121
hive,PR-4020,1,11,546,294,840
hive,PR-4021,1,3,78,23,101
hive,PR-4022,1,1,1,14,15
hive,PR-3989,6,13,800,104,904
hive,PR-4023,1,12,296,117,413
hive,PR-3576,2,53,4502,1873,6375
hive,PR-4018,2,7,587,1076,1663
hive,PR-3994,11,73,366,383,749
hive,PR-4019,2,14,396,62,458
hive,PR-4024,1,1,3,7,10
hive,PR-4004,6,21,1114,64,1178
hive,PR-4025,1,3,3,3,6
hive,PR-4026,1,5,191,10,201
hive,PR-4027,1,2,6,6,12
hive,PR-4028,1,21,268,84,352
hive,PR-4023,2,15,316,118,434
hive,PR-4029,1,1,1,1,2
hive,PR-3987,4,11,58,60,118
hive,PR-4024,2,1,3,7,10
hive,PR-4030,1,1,1,1,2
hive,PR-4031,1,1,1,1,2
hive,PR-3845,24,300,21712,3058,24770
hive,PR-4033,1,3,3,3,6
hive,PR-4034,1,2,2,2,4
hive,PR-4035,1,94,342,343,685
hive,PR-4036,1,3,58,0,58
hive,PR-3987,5,11,58,60,118
hive,PR-4037,1,2,38,5,43
hive,PR-4032,3,8,978,417,1395
hive,PR-4024,3,1,3,7,10
hive,PR-4038,1,1,1,1,2
hive,PR-4039,1,5,33,2,35
hive,PR-4040,1,11,1436,26,1462
hive,PR-4036,2,23,104,0,104
hive,PR-3986,4,7,197,73,270
hive,PR-4036,3,23,104,0,104
hive,PR-3845,25,300,21715,3058,24773
hive,PR-4036,4,23,104,0,104
hive,PR-4024,4,1,3,7,10
hive,PR-4032,4,8,987,417,1404
hive,PR-4043,1,2,16,11,27
hive,PR-4035,2,94,341,342,683
hive,PR-3891,9,15,522,47,569
hive,PR-4037,2,3,65,5,70
hive,PR-4026,2,5,201,10,211
hive,PR-4032,5,8,994,417,1411
hive,PR-3891,10,15,526,52,578
hive,PR-3845,26,300,21715,3058,24773
hive,PR-4018,3,7,587,1076,1663
hive,PR-4045,1,1,1,0,1
hive,PR-4046,1,1,3,1,4
hive,PR-4044,4,2,9,7,16
hive,PR-4046,2,2,4,1,5
hive,PR-4044,5,2,9,7,16
hive,PR-3959,4,4,191,1,192
hive,PR-4035,3,94,341,342,683
hive,PR-4042,3,20,86,47,133
hive,PR-4032,7,9,1122,417,1539
hive,PR-4047,1,1,12,12,24
hive,PR-3845,27,300,21715,3058,24773
hive,PR-4000,11,5,492,16,508
hive,PR-4000,12,5,490,16,506
hive,PR-4049,1,2,59,1,60
hive,PR-4050,1,1,1,1,2
hive,PR-4048,2,3,7,4,11
hive,PR-4049,2,2,59,1,60
hive,PR-4051,1,2,2,2,4
hive,PR-4052,1,2,18,28,46
hive,PR-4053,1,1,1,1,2
hive,PR-4035,4,94,341,342,683
hive,PR-4032,9,11,1121,428,1549
hive,PR-3986,5,7,197,73,270
hive,PR-4026,3,8,329,20,349
hive,PR-3845,28,300,21715,3058,24773
hive,PR-4026,4,8,354,20,374
hive,PR-4026,5,8,353,20,373
hive,PR-4026,6,8,349,20,369
hive,PR-4035,5,94,341,342,683
hive,PR-3959,5,4,194,1,195
hive,PR-3986,6,7,197,73,270
hive,PR-4026,7,8,349,21,370
hive,PR-4054,1,1,1,1,2
hive,PR-4042,4,24,194,47,241
hive,PR-3986,7,7,197,73,270
hive,PR-4055,1,2,3,1,4
hive,PR-4056,1,2,3,1,4
hive,PR-4032,11,11,1187,465,1652
hive,PR-4057,1,3,123,2,125
hive,PR-4059,1,5,22,8,30
hive,PR-4037,3,4,85,9,94
hive,PR-4032,12,11,1196,471,1667
hive,PR-4004,7,21,1114,64,1178
hive,PR-4035,6,94,341,342,683
hive,PR-4037,4,4,89,9,98
hive,PR-4004,8,215,16569,64,16633
hive,PR-4038,2,1,1,1,2
hive,PR-4058,4,4,3690,0,3690
hive,PR-4061,1,9,19,289,308
hive,PR-4062,1,1,45,6,51
hive,PR-4037,6,4,89,9,98
hive,PR-4037,7,4,89,9,98
hive,PR-4026,11,8,373,21,394
hive,PR-4026,12,8,373,21,394
hive,PR-4032,13,11,1198,471,1669
hive,PR-4004,9,220,16583,78,16661
hive,PR-3907,15,33,809,116,925
hive,PR-4058,5,4,3690,0,3690
hive,PR-4060,2,63,2089,1450,3539
hive,PR-4032,14,11,1198,471,1669
hive,PR-4063,2,6,458,0,458
hive,PR-4004,10,220,16583,78,16661
hive,PR-4032,15,11,1335,470,1805
hive,PR-4043,2,8,507,76,583
hive,PR-4004,11,300,19149,78,19227
hive,PR-4032,16,11,1327,470,1797
hive,PR-4064,2,4,2406,2308,4714
hive,PR-4065,1,47,4275,473,4748
hive,PR-3907,16,37,823,91,914
hive,PR-4054,2,1,1,1,2
hive,PR-4067,1,1,1,1,2
hive,PR-4043,3,48,924,493,1417
hive,PR-4064,3,4,2407,2308,4715
hive,PR-4067,2,1,1,1,2
hive,PR-4068,1,5,14,14,28
hive,PR-4069,1,1,2,2,4
hive,PR-4068,2,5,14,14,28
hive,PR-4070,1,1,5,4,9
hive,PR-4053,2,1,1,1,2
hive,PR-4071,1,1,17,15,32
hive,PR-4069,2,1,2,2,4
hive,PR-4067,3,2,3,3,6
hive,PR-4058,6,4,3690,0,3690
hive,PR-3845,29,300,21715,3058,24773
hive,PR-4072,1,1,1,0,1
hive,PR-4073,1,1,1,1,2
hive,PR-4074,1,2,47,131,178
hive,PR-4074,2,3,149,133,282
hive,PR-4066,2,22,460,38,498
hive,PR-4075,1,1,1,1,2
hive,PR-4065,3,47,4436,632,5068
hive,PR-3907,20,40,829,91,920
hive,PR-3907,21,40,837,91,928
hive,PR-4010,3,3,0,12,12
hive,PR-4016,4,4,109,3,112
hive,PR-4010,4,3,0,12,12
hive,PR-3907,23,40,837,91,928
hive,PR-4032,18,13,1356,492,1848
hive,PR-4035,7,81,280,281,561
hive,PR-4058,7,4,3690,0,3690
hive,PR-4016,5,4,102,3,105
hive,PR-4073,2,1,1,1,2
hive,PR-3907,24,40,837,91,928
hive,PR-4076,1,3,83,42,125
hive,PR-4077,1,40,837,105,942
hive,PR-3907,25,40,837,91,928
hive,PR-4010,5,3,0,12,12
hive,PR-4016,6,4,104,3,107
hive,PR-4070,2,3,646,4,650
hive,PR-4077,2,41,844,108,952
hive,PR-4070,3,3,646,4,650
hive,PR-4016,7,4,104,3,107
hive,PR-4070,4,3,646,4,650
hive,PR-4035,8,84,285,287,572
hive,PR-4066,3,23,478,39,517
hive,PR-4035,9,86,290,292,582
hive,PR-4066,4,23,480,39,519
hive,PR-4078,1,1,1,1,2
hive,PR-4079,1,26,772,43,815
hive,PR-4075,2,1,1,1,2
hive,PR-4075,3,1,1,1,2
hive,PR-4080,1,1,1,1,2
hive,PR-4070,5,3,646,4,650
hive,PR-4079,2,27,773,43,816
hive,PR-4032,19,12,1095,499,1594
hive,PR-4070,6,3,646,4,650
hive,PR-4078,2,1,1,1,2
hive,PR-4081,1,25,0,652,652
hive,PR-4079,3,27,796,44,840
hive,PR-4070,7,3,646,4,650
hive,PR-4032,20,12,1105,499,1604
hive,PR-3576,4,54,6876,4160,11036
hive,PR-4078,3,1,1,1,2
hive,PR-4076,2,4,219,151,370
hive,PR-3576,5,55,4561,1875,6436
hive,PR-4082,1,6,12,9,21
hive,PR-4081,2,25,0,652,652
hive,PR-3576,6,55,4562,1876,6438
hive,PR-3576,7,55,4561,1877,6438
hive,PR-4082,3,7,31,9,40
hive,PR-4058,8,4,3690,0,3690
hive,PR-4082,4,7,13,10,23
hive,PR-4078,4,1,7,2,9
hive,PR-4083,1,1,1,1,2
hive,PR-4032,21,12,1102,505,1607
hive,PR-4078,5,2,13,2,15
hive,PR-4079,4,27,793,44,837
hive,PR-4084,1,2,29,1,30
hive,PR-4085,1,15,997,30,1027
hive,PR-4028,2,24,418,106,524
hive,PR-4082,5,7,13,10,23
hive,PR-4087,1,2,2,2,4
hive,PR-4088,1,4,35,6,41
hive,PR-3576,8,55,4566,1882,6448
hive,PR-4028,3,25,427,114,541
hive,PR-4082,6,7,13,10,23
hive,PR-4087,2,2,2,2,4
hive,PR-4028,4,25,427,114,541
hive,PR-3576,9,55,4566,1882,6448
hive,PR-4082,7,7,13,10,23
hive,PR-4028,5,24,401,99,500
hive,PR-4032,22,12,1107,507,1614
hive,PR-4070,8,3,646,4,650
hive,PR-4085,2,16,1047,30,1077
hive,PR-4032,23,12,1107,507,1614
hive,PR-4085,3,13,390,30,420
hive,PR-4089,2,3,494,1,495
hive,PR-4085,4,13,396,30,426
hive,PR-4090,1,6,444,0,444
hive,PR-4085,5,13,396,30,426
hive,PR-4091,1,17,1522,536,2058
hive,PR-4087,3,2,2,2,4
hive,PR-4070,10,4,647,4,651
hive,PR-4089,3,3,494,1,495
hive,PR-4077,3,41,840,108,948
hive,PR-3576,10,55,4571,1883,6454
hive,PR-4085,6,13,404,27,431
hive,PR-4092,1,7,61,47,108
hive,PR-4088,2,4,43,9,52
hive,PR-4080,2,6,55,50,105
hive,PR-4070,11,4,647,4,651
hive,PR-3576,12,55,4571,1883,6454
hive,PR-4070,12,4,647,4,651
hive,PR-4093,1,1,25,24,49
hive,PR-4090,2,6,482,0,482
hive,PR-4077,4,41,840,108,948
hive,PR-4070,13,5,1272,4,1276
hive,PR-4094,1,6,443,0,443
hive,PR-4077,5,41,840,108,948
hive,PR-4067,5,9,22,143,165
hive,PR-4088,4,4,43,9,52
hive,PR-4094,2,6,443,0,443
hive,PR-4032,24,12,1088,502,1590
hive,PR-4092,2,7,71,22,93
hive,PR-4070,15,4,647,4,651
hive,PR-4032,25,12,1083,503,1586
hive,PR-4095,1,1,2,2,4
hive,PR-4070,16,3,646,4,650
hive,PR-4088,5,4,41,9,50
hive,PR-4096,1,4,43,22,65
hive,PR-4092,3,7,72,23,95
hive,PR-4088,6,4,42,9,51
hive,PR-4095,2,1,2,2,4
hive,PR-3845,30,300,21715,3058,24773
hive,PR-4070,17,3,683,4,687
hive,PR-4075,4,1,1,1,2
hive,PR-4067,6,9,22,143,165
hive,PR-4095,3,1,2,2,4
hive,PR-4095,4,1,2,2,4
hive,PR-4097,1,2,16,76,92
hive,PR-4091,2,20,650,79,729
hive,PR-4088,7,4,42,9,51
hive,PR-4091,3,20,649,78,727
hive,PR-4088,8,4,42,9,51
hive,PR-4098,1,7,64,38,102
hive,PR-4067,7,9,22,143,165
hive,PR-4077,6,42,813,217,1030
hive,PR-4096,2,4,44,22,66
hive,PR-4097,2,2,16,12,28
hive,PR-4098,2,7,64,45,109
hive,PR-4077,7,42,813,217,1030
hive,PR-4096,3,4,44,22,66
hive,PR-4067,8,10,23,152,175
hive,PR-4098,3,7,71,48,119
hive,PR-4099,3,2,17,3,20
hive,PR-4098,4,7,91,48,139
hive,PR-4077,8,42,813,217,1030
hive,PR-4100,1,5,13,9,22
hive,PR-4096,4,4,46,22,68
hive,PR-3996,4,4,10,10,20
hive,PR-4092,4,7,74,14,88
hive,PR-4079,5,27,803,44,847
hive,PR-4077,9,42,842,217,1059
hive,PR-4098,5,6,45,37,82
hive,PR-4101,1,1,1,1,2
hive,PR-4098,6,6,46,39,85
hive,PR-4098,7,6,46,39,85
hive,PR-4079,6,28,1254,53,1307
hive,PR-4102,1,2,2,2,4
hive,PR-4081,3,22,0,649,649
hive,PR-3845,31,300,21715,3058,24773
hive,PR-4103,1,3,0,127,127
hive,PR-4077,10,42,800,217,1017
hive,PR-4091,5,23,760,93,853
hive,PR-4088,9,4,42,9,51
hive,PR-4101,2,21,1264,1032,2296
hive,PR-4067,9,14,287,153,440
hive,PR-4079,7,28,1255,49,1304
hive,PR-4104,2,3,174,50,224
hive,PR-4105,1,16,328,55,383
hive,PR-4101,3,21,1268,1033,2301
hive,PR-4106,1,1,1,0,1
hive,PR-4067,11,7,18,150,168
hive,PR-4104,4,3,177,30,207
hive,PR-4107,1,2,13,3,16
hive,PR-4108,1,1,34,0,34
hive,PR-4109,1,3,194,3,197
hive,PR-4104,5,3,176,30,206
hive,PR-4110,1,4,891,2,893
hive,PR-4101,4,21,31,6,37
hive,PR-4110,2,4,890,2,892
hive,PR-4111,4,8,54,14,68
hive,PR-4028,6,21,360,114,474
hive,PR-4028,7,21,360,114,474
hive,PR-4091,6,26,881,112,993
hive,PR-4091,7,26,871,112,983
hive,PR-4091,8,26,904,170,1074
hive,PR-4076,3,4,219,151,370
hive,PR-4079,8,30,1421,62,1483
hive,PR-4112,1,3,15,11,26
hive,PR-4091,10,26,919,221,1140
hive,PR-4079,9,32,1481,62,1543
hive,PR-4113,1,3,498,2,500
hive,PR-4114,1,1,3,3,6
hive,PR-4065,4,47,4436,632,5068
hive,PR-4109,3,4,217,6,223
hive,PR-4091,11,26,919,221,1140
hive,PR-4102,4,2,2,2,4
hive,PR-4114,2,1,3,4,7
hive,PR-4115,1,8,586,4,590
hive,PR-4116,1,2,12,1,13
hive,PR-4117,1,1,4,0,4
hive,PR-4118,1,5,1,17,18
hive,PR-4102,6,2,2,2,4
hive,PR-4116,2,2,12,1,13
hive,PR-4116,3,2,12,1,13
hive,PR-4119,1,7,648,19,667
hive,PR-4117,2,1,0,1,1
hive,PR-4119,2,7,646,19,665
hive,PR-4091,12,28,1015,268,1283
hive,PR-4120,1,4,624,12,636
hive,PR-4119,3,7,646,19,665
hive,PR-4114,3,1,33,26,59
hive,PR-4120,2,4,624,12,636
hive,PR-4115,2,8,924,4,928
hive,PR-4121,1,8,173,139,312
hive,PR-4067,12,8,31,150,181
hive,PR-4122,1,21,101,89,190
hive,PR-4114,4,2,39,26,65
hive,PR-4118,2,5,0,27,27
hive,PR-4119,7,7,644,19,663
hive,PR-4028,8,21,360,114,474
hive,PR-4004,12,300,19135,64,19199
hive,PR-4065,5,55,4525,689,5214
hive,PR-4121,2,72,447,408,855
hive,PR-4109,5,4,215,7,222
hive,PR-4113,3,7,677,8,685
hive,PR-4119,8,7,644,19,663
hive,PR-4113,5,7,677,8,685
hive,PR-3845,32,300,21715,3058,24773
hive,PR-3989,7,13,792,104,896
hive,PR-4113,6,8,681,9,690
hive,PR-4113,7,8,410,9,419
hive,PR-4113,9,8,402,9,411
hive,PR-4113,11,11,459,11,470
hive,PR-4113,12,11,463,11,474
hive,PR-4076,4,4,222,151,373
hive,PR-4123,2,10,33,98,131
hive,PR-4125,1,4,0,54,54
hive,PR-4126,1,5,33,84,117
hive,PR-4125,2,4,0,54,54
hive,PR-4126,2,5,33,84,117
hive,PR-4127,1,2,4,6,10
hive,PR-4125,3,4,0,54,54
hive,PR-4129,1,1,2,0,2
hive,PR-4114,5,3,48,26,74
hive,PR-4076,5,4,214,151,365
hive,PR-4130,1,2,3,3,6
hive,PR-4112,2,3,13,11,24
hive,PR-4131,1,6,542,2,544
hive,PR-4076,6,4,214,151,365
hive,PR-4130,2,2,3,3,6
hive,PR-4132,1,7,68,19,87
hive,PR-4130,3,3,4,4,8
hive,PR-4133,1,7,519,0,519
hive,PR-4076,7,4,214,151,365
hive,PR-4130,4,3,4,4,8
hive,PR-3845,33,300,21715,3058,24773
hive,PR-4134,1,69,790,400,1190
hive,PR-4130,5,3,4,4,8
hive,PR-4135,1,3,105,14,119
hive,PR-4137,1,4,8,8,16
hive,PR-4136,2,1,1,0,1
hive,PR-4130,6,3,4,4,8
hive,PR-4138,1,69,547,397,944
hive,PR-4132,3,7,69,19,88
hive,PR-4138,2,69,449,397,846
hive,PR-4139,1,1,2,0,2
hive,PR-4135,2,5,111,20,131
hive,PR-4130,7,3,4,4,8
hive,PR-4125,4,4,0,54,54
hive,PR-3845,34,300,21715,3058,24773
hive,PR-4042,5,24,194,47,241
hive,PR-4130,8,3,4,4,8
hive,PR-3845,35,300,21715,3058,24773
hive,PR-4140,1,1,1,1,2
hive,PR-4132,4,7,111,44,155
hive,PR-4141,1,2,6,2,8
hive,PR-4143,1,3,4,4,8
hive,PR-3845,36,300,21715,3058,24773
hive,PR-4144,1,2,8,2,10
hive,PR-4131,2,8,546,2,548
hive,PR-4121,4,75,739,711,1450
hive,PR-4146,1,4,80,5,85
hive,PR-4132,5,7,621,43,664
hive,PR-4144,2,4,19,4,23
hive,PR-4131,3,8,545,2,547
hive,PR-4146,2,4,80,5,85
hive,PR-4147,1,6,238,11,249
hive,PR-4148,1,5,135,1,136
hive,PR-4144,3,4,19,4,23
hive,PR-4144,4,3,4,4,8
hive,PR-4111,5,8,54,14,68
hive,PR-4149,1,2,103,10,113
hive,PR-4137,3,4,10,10,20
hive,PR-4150,1,6,57,26,83
hive,PR-3845,37,300,21718,3058,24776
hive,PR-4151,1,2,103,10,113
hive,PR-4027,2,2,6,6,12
hive,PR-4131,5,7,549,2,551
hive,PR-3845,38,300,21718,3058,24776
hive,PR-4146,3,4,80,5,85
hive,PR-4123,3,10,90,20,110
hive,PR-4152,2,1,1,0,1
hive,PR-4131,6,7,549,2,551
hive,PR-4153,1,4,14,7,21
hive,PR-4146,4,4,80,5,85
hive,PR-3845,39,300,21718,3058,24776
hive,PR-4152,3,1,1,0,1
hive,PR-4155,1,9,274,10,284
hive,PR-4131,7,7,549,2,551
hive,PR-4156,1,16,8,1726,1734
hive,PR-4157,1,2,8,9,17
hive,PR-4158,1,5,49,4,53
hive,PR-4155,2,11,277,10,287
hive,PR-4114,6,4,88,28,116
hive,PR-4114,7,4,87,26,113
hive,PR-4159,1,26,40,686,726
hive,PR-4111,6,8,53,14,67
hive,PR-4161,1,1,4,14,18
hive,PR-4162,2,6,1050,14,1064
hive,PR-4163,1,1,6,0,6
hive,PR-4164,1,3,10,6,16
hive,PR-4132,6,6,167,43,210
hive,PR-4165,1,1,1,2,3
hive,PR-4141,2,10,40,10,50
hive,PR-4159,2,26,40,686,726
hive,PR-3845,40,300,21718,3058,24776
hive,PR-3981,2,3,599,8,607
hive,PR-4165,2,3,17,16,33
hive,PR-4164,2,3,10,6,16
hive,PR-4121,5,73,750,722,1472
hive,PR-3845,41,300,21718,3058,24776
hive,PR-3989,8,13,792,104,896
hive,PR-4027,3,2,6,6,12
hive,PR-4123,4,13,111,33,144
hive,PR-4162,3,6,1061,18,1079
hive,PR-4132,7,6,199,43,242
hive,PR-4021,3,3,78,23,101
hive,PR-4161,2,1,4,14,18
hive,PR-4132,8,6,199,43,242
hive,PR-4161,3,1,6,4,10
hive,PR-4166,2,9,551,161,712
hive,PR-4121,6,72,749,721,1470
hive,PR-4167,1,1,0,1,1
hive,PR-4166,3,15,1288,481,1769
hive,PR-4169,1,1,1,1,2
hive,PR-4170,1,8,193,6,199
hive,PR-4171,1,2,55,15,70
hive,PR-4172,1,12,750,70,820
hive,PR-4169,2,1,1,1,2
hive,PR-4173,1,4,60,15,75
hive,PR-4169,3,1,1,1,2
hive,PR-4174,1,1,1,1,2
hive,PR-4170,2,8,245,8,253
hive,PR-4175,1,7,169,82,251
hive,PR-4172,2,12,750,71,821
hive,PR-4176,1,2,139,0,139
hive,PR-4177,1,1,115,110,225
hive,PR-4175,2,7,168,81,249
hive,PR-4173,2,4,60,15,75
hive,PR-4176,2,2,139,0,139
hive,PR-4172,3,12,750,71,821
hive,PR-4167,2,1,0,1,1
hive,PR-4169,4,1,1,1,2
hive,PR-4176,3,2,139,0,139
hive,PR-4172,4,12,750,71,821
hive,PR-4179,1,1,2,0,2
hive,PR-4180,1,1,13,5,18
hive,PR-4181,1,17,1939,1,1940
hive,PR-4169,5,1,1,1,2
hive,PR-4182,1,1,11,9,20
hive,PR-4183,1,3,184,37,221
hive,PR-4180,2,1,13,5,18
hive,PR-4176,5,2,139,0,139
hive,PR-4175,3,7,169,81,250
hive,PR-4180,3,2,14,10,24
hive,PR-4182,2,1,11,9,20
hive,PR-4180,4,2,14,10,24
hive,PR-4182,3,1,11,9,20
hive,PR-4176,6,2,139,0,139
hive,PR-4185,1,10,294,10,304
hive,PR-4180,5,2,14,10,24
hive,PR-4183,2,3,184,37,221
hive,PR-4185,2,10,294,10,304
hive,PR-4186,1,0,0,0,0
hive,PR-4180,6,2,14,10,24
hive,PR-4187,1,2,56,16,72
hive,PR-4188,1,2,56,15,71
hive,PR-4176,7,2,139,0,139
hive,PR-4176,8,2,139,0,139
hive,PR-4189,1,2,14,10,24
hive,PR-4182,4,1,11,9,20
hive,PR-4176,9,2,139,0,139
hive,PR-4190,1,4,185,5,190
hive,PR-4188,2,2,56,15,71
hive,PR-4191,1,1,26,24,50
hive,PR-4192,1,1,1,1,2
hive,PR-4193,1,7,195,374,569
hive,PR-4182,5,1,11,9,20
hive,PR-4185,3,10,356,10,366
hive,PR-4176,10,2,139,0,139
hive,PR-4180,8,2,16,10,26
hive,PR-4176,11,2,139,0,139
hive,PR-4191,2,1,26,24,50
hive,PR-4193,2,7,195,374,569
hive,PR-4195,1,4,14,8,22
hive,PR-4193,3,7,195,374,569
hive,PR-4169,6,2,3,1,4
hive,PR-4176,12,2,139,0,139
hive,PR-4193,4,7,195,374,569
hive,PR-4196,1,1,11,2,13
hive,PR-4197,1,1,4,0,4
hive,PR-4195,2,4,14,8,22
hive,PR-4198,1,2,36,4,40
hive,PR-4184,2,1,1,1,2
hive,PR-4167,3,1,0,1,1
hive,PR-4193,5,7,195,374,569
hive,PR-4181,2,17,1939,1,1940
hive,PR-4199,1,6,458,0,458
hive,PR-4185,4,10,369,10,379
hive,PR-4193,6,7,195,374,569
hive,PR-4200,1,2,50,3,53
hive,PR-4201,1,3,132,0,132
hive,PR-4202,1,2,104,12,116
hive,PR-4203,1,2,7,7,14
hive,PR-4198,2,2,36,4,40
hive,PR-4182,6,1,11,9,20
hive,PR-4184,3,1,1,1,2
hive,PR-4182,7,1,11,9,20
hive,PR-4184,4,1,1,1,2
hive,PR-4193,7,7,195,374,569
hive,PR-4204,1,1,1,1,2
hive,PR-4182,8,1,11,9,20
hive,PR-4193,8,7,195,374,569
hive,PR-4203,2,2,7,7,14
hive,PR-4194,7,300,19513,13422,32935
hive,PR-4206,1,3,282,2,284
hive,PR-4202,2,2,104,12,116
hive,PR-4205,2,1,21,13,34
hive,PR-4207,1,1,0,480,480
hive,PR-4208,1,3,0,585,585
hive,PR-4209,1,2,125,1,126
hive,PR-4210,1,1,1,1,2
hive,PR-4211,1,1,53,18,71
hive,PR-4182,9,1,11,9,20
hive,PR-4208,2,3,0,585,585
hive,PR-4182,10,1,11,9,20
hive,PR-4208,3,3,0,585,585
hive,PR-4210,2,1,1,1,2
hive,PR-4209,3,2,125,1,126
hive,PR-4211,3,1,53,18,71
hive,PR-4193,9,7,195,374,569
hive,PR-4173,3,4,60,15,75
hive,PR-4212,1,2,39,4,43
hive,PR-4185,5,10,369,10,379
hive,PR-4203,4,4,8,8,16
hive,PR-4204,2,1,1,1,2
hive,PR-4212,2,2,38,6,44
hive,PR-4176,13,4,142,2,144
hive,PR-3561,1,3,156,1,157
hive,PR-4176,14,4,142,2,144
hive,PR-4213,1,5,474,317,791
hive,PR-4214,1,1,17,5,22
hive,PR-4215,1,1,1,1,2
hive,PR-4207,2,1,0,480,480
hive,PR-4192,2,1,1,1,2
hive,PR-4216,1,17,472,2,474
hive,PR-4214,2,1,17,5,22
hive,PR-4185,6,10,400,10,410
hive,PR-3561,2,3,156,1,157
hive,PR-4176,21,4,144,2,146
hive,PR-4216,3,17,473,2,475
hive,PR-4219,1,1,10,11,21
hive,PR-4184,5,1,1,1,2
hive,PR-4220,1,4,267,2,269
hive,PR-4221,1,1,0,2,2
hive,PR-4222,1,3,379,16,395
hive,PR-4223,1,3,71,0,71
hive,PR-4220,2,4,267,2,269
hive,PR-4224,1,1,1,1,2
hive,PR-4226,1,2,131,14,145
hive,PR-4257,1,11,238,145,383
hive,PR-4257,2,12,241,148,389
hive,PR-4257,3,12,257,148,405
hive,PR-4276,1,1,1,2,3
hive,PR-4257,4,12,257,146,403
hive,PR-4288,1,3,76,2,78
hive,PR-4290,1,3,3,3,6
hive,PR-4293,1,2,76,0,76
hive,PR-4292,2,21,132,26,158
hive,PR-4290,3,5,11,6,17
hive,PR-4293,2,2,76,0,76
hive,PR-4290,4,5,12,7,19
hive,PR-4290,5,6,13,8,21
hive,PR-4293,3,2,76,0,76
hive,PR-4298,2,3,85,7,92
hive,PR-4291,2,21,1151,175,1326
hive,PR-4292,3,22,134,27,161
hive,PR-4292,4,22,134,27,161
hive,PR-4292,5,21,131,26,157
hive,PR-4292,6,19,132,25,157
hive,PR-4298,3,3,85,7,92
hive,PR-4293,4,2,76,0,76
hive,PR-4286,2,19,207,600,807
hive,PR-4286,3,19,207,600,807
hive,PR-4313,1,20,558,47,605
hive,PR-4292,8,24,168,61,229
hive,PR-4314,1,21,218,602,820
hive,PR-4315,1,9,34,15,49
hive,PR-4316,1,2,5,2,7
hive,PR-4313,2,20,558,47,605
hive,PR-4292,11,26,170,63,233
hive,PR-4292,12,26,170,63,233
hive,PR-4292,13,26,170,63,233
hive,PR-4323,1,1,3,1,4
hive,PR-4316,2,6,131,9,140
hive,PR-4316,3,6,131,9,140
hive,PR-4326,1,1,1,1,2
hive,PR-4292,14,30,1145,63,1208
hive,PR-4330,1,3,75,59,134
hive,PR-4292,15,30,1145,63,1208
hive,PR-4329,3,3,373,372,745
hive,PR-4291,5,31,2340,500,2840
hive,PR-4329,4,5,392,373,765
hive,PR-4334,1,18,123,103,226
hive,PR-4313,3,20,563,51,614
hive,PR-4333,2,18,187,594,781
hive,PR-4330,2,3,75,59,134
hive,PR-4316,4,21,255,72,327
hive,PR-4313,4,22,567,54,621
hive,PR-4334,2,18,123,103,226
hive,PR-4336,1,3,210,50,260
hive,PR-4313,5,22,567,54,621
hive,PR-4334,3,18,146,118,264
hive,PR-4291,6,31,2340,500,2840
hive,PR-4286,4,19,207,600,807
hive,PR-4330,3,4,81,58,139
hive,PR-4341,1,3,78,5,83
hive,PR-4314,3,22,1081,1458,2539
hive,PR-4334,4,20,148,118,266
hive,PR-4336,2,3,207,50,257
hive,PR-4329,5,5,392,373,765
hive,PR-4292,17,30,1146,64,1210
hive,PR-4344,1,10,602,12,614
hive,PR-4346,1,7,404,3,407
hive,PR-4286,5,19,207,600,807
hive,PR-4314,4,22,1081,1458,2539
hive,PR-4341,3,3,86,0,86
hive,PR-4346,2,7,404,3,407
hive,PR-4341,4,3,87,0,87
hive,PR-4298,5,4,169,7,176
hive,PR-4348,1,2,59,4,63
hive,PR-4334,5,20,148,118,266
hive,PR-4313,6,22,567,54,621
hive,PR-4341,5,3,72,0,72
hive,PR-4329,6,5,392,373,765
hive,PR-4350,1,4,852,2,854
hive,PR-4291,7,31,2340,500,2840
hive,PR-4344,2,13,597,51,648
hive,PR-4352,2,1,2,1,3
hive,PR-4313,8,22,645,49,694
hive,PR-4350,2,4,852,2,854
hive,PR-4344,3,13,597,51,648
hive,PR-4314,5,21,218,602,820
hive,PR-4313,9,22,657,49,706
hive,PR-4350,3,4,852,2,854
hive,PR-4313,10,22,657,49,706
hive,PR-4292,18,31,1148,76,1224
hive,PR-4292,19,31,1146,66,1212
hive,PR-4346,5,7,405,3,408
hive,PR-4292,20,31,1146,66,1212
hive,PR-4344,4,13,597,51,648
hive,PR-4292,21,31,1146,66,1212
hive,PR-4314,6,21,218,602,820
hive,PR-4313,12,21,737,34,771
hive,PR-4344,5,13,597,51,648
hive,PR-4356,2,4,96,2,98
hive,PR-4352,3,1,2,1,3
hive,PR-4355,3,44,3970,125,4095
hive,PR-4314,7,28,371,619,990
hive,PR-4358,1,42,451,641,1092
hive,PR-4359,1,44,590,625,1215
hive,PR-4360,1,1,47,17,64
hive,PR-4355,4,44,4106,125,4231
hive,PR-4286,7,27,361,617,978
hive,PR-4357,2,37,693,619,1312
hive,PR-4363,1,7,364,34,398
hive,PR-4348,6,4,107,3,110
hive,PR-4292,22,31,1159,76,1235
hive,PR-4364,1,37,734,617,1351
hive,PR-4286,8,27,361,617,978
hive,PR-4292,23,31,1159,76,1235
hive,PR-4341,6,3,70,0,70
hive,PR-4291,8,31,2340,500,2840
hive,PR-4365,1,62,661,758,1419
hive,PR-4291,9,31,2340,500,2840
hive,PR-4366,1,1,5,2,7
hive,PR-4356,3,4,96,2,98
hive,PR-4367,1,38,540,628,1168
hive,PR-4368,1,38,597,636,1233
hive,PR-4358,3,44,554,651,1205
hive,PR-4359,3,45,693,635,1328
hive,PR-4370,1,39,48,930,978
hive,PR-4371,1,8,628,164,792
hive,PR-4373,1,1,1,1,2
hive,PR-4374,1,3,175,33,208
hive,PR-4372,2,22,634,7,641
hive,PR-4373,2,1,1,1,2
hive,PR-4350,4,4,860,13,873
hive,PR-4356,5,3,246,64,310
hive,PR-4372,3,22,634,7,641
hive,PR-4366,2,1,1,1,2
hive,PR-4341,7,3,48,0,48
hive,PR-4379,1,4,220,2,222
hive,PR-4374,2,3,175,33,208
hive,PR-4372,4,22,634,7,641
hive,PR-4341,8,3,48,0,48
hive,PR-4348,8,6,153,2,155
hive,PR-4376,2,1,1,1,2
hive,PR-4377,2,2,5,5,10
hive,PR-4359,4,45,693,635,1328
hive,PR-4378,2,8,636,165,801
hive,PR-4372,5,22,634,7,641
hive,PR-4374,3,3,175,33,208
hive,PR-4366,3,1,6,4,10
hive,PR-4341,9,3,51,0,51
hive,PR-4356,6,3,264,85,349
hive,PR-4313,13,19,677,47,724
hive,PR-4360,2,2,183,57,240
hive,PR-4348,9,6,153,2,155
hive,PR-4376,3,1,1,1,2
hive,PR-4291,10,31,2350,504,2854
hive,PR-4366,4,1,6,4,10
hive,PR-4378,3,8,636,165,801
hive,PR-4382,1,39,2334,1603,3937
hive,PR-4313,14,19,677,47,724
hive,PR-4381,2,1,1,1,2
hive,PR-4291,11,31,2352,504,2856
hive,PR-4330,4,4,85,59,144
hive,PR-4341,10,3,51,0,51
hive,PR-4348,10,6,153,2,155
hive,PR-4360,3,2,183,57,240
hive,PR-4366,5,1,6,4,10
hive,PR-4356,7,3,264,85,349
hive,PR-4383,1,2,4,4,8
hive,PR-4291,12,31,2370,504,2874
hive,PR-4341,11,3,51,0,51
hive,PR-4385,1,11,520,133,653
hive,PR-4356,8,3,295,86,381
hive,PR-4348,11,6,152,2,154
hive,PR-4380,4,10,78,63,141
hive,PR-4386,1,3,5,67,72
hive,PR-4381,3,3,67,1,68
hive,PR-4291,13,31,2370,504,2874
hive,PR-4383,2,2,4,4,8
hive,PR-4384,2,15,1000,368,1368
hive,PR-4344,6,11,905,12,917
hive,PR-4344,7,11,920,12,932
hive,PR-4364,2,37,734,617,1351
hive,PR-4368,2,38,597,636,1233
hive,PR-4378,4,9,703,165,868
hive,PR-4348,12,6,152,2,154
hive,PR-4378,5,9,703,165,868
hive,PR-4387,1,1,1,2,3
hive,PR-4387,2,1,1,2,3
hive,PR-4388,1,1,3,2,5
hive,PR-4388,2,3,68,4,72
hive,PR-4387,3,1,2,2,4
hive,PR-4360,4,2,183,57,240
hive,PR-4388,3,4,77,14,91
hive,PR-4384,3,17,1024,377,1401
hive,PR-4292,24,31,1171,75,1246
hive,PR-4334,6,20,149,118,267
hive,PR-4388,4,4,78,13,91
hive,PR-4366,6,1,6,4,10
hive,PR-4381,5,5,75,9,84
hive,PR-4385,2,12,526,134,660
hive,PR-4292,25,31,1172,75,1247
hive,PR-4344,8,11,918,12,930
hive,PR-4380,5,10,80,64,144
hive,PR-4348,13,12,226,22,248
hive,PR-4316,5,9,193,10,203
hive,PR-4389,1,1,14,8,22
hive,PR-4330,5,5,103,59,162
hive,PR-4293,7,2,106,17,123
hive,PR-4292,26,31,1172,75,1247
hive,PR-4348,14,12,226,22,248
hive,PR-4292,27,31,1172,75,1247
hive,PR-4388,5,6,92,25,117
hive,PR-4334,7,21,157,126,283
hive,PR-4356,9,3,295,88,383
hive,PR-4313,16,26,698,109,807
hive,PR-4380,6,25,145,128,273
hive,PR-4385,3,12,526,134,660
hive,PR-4348,15,6,152,2,154
hive,PR-4356,10,3,295,88,383
hive,PR-4390,1,1,1,0,1
hive,PR-4313,17,26,698,109,807
hive,PR-4388,6,8,98,31,129
hive,PR-4344,9,11,892,12,904
hive,PR-4316,6,21,255,72,327
hive,PR-4293,9,2,113,16,129
hive,PR-4391,1,4,79,3,82
hive,PR-4380,8,29,152,128,280
hive,PR-4348,16,6,152,2,154
hive,PR-4389,2,1,15,9,24
hive,PR-4316,7,21,255,72,327
hive,PR-4356,11,3,295,88,383
hive,PR-4356,12,2,242,88,330
hive,PR-4329,7,5,392,373,765
hive,PR-4392,1,7,119,92,211
hive,PR-4393,1,1,3,0,3
hive,PR-4386,2,3,5,67,72
hive,PR-4292,28,31,1172,75,1247
hive,PR-4348,17,6,152,2,154
hive,PR-4394,1,8,12,826,838
hive,PR-4341,12,10,145,90,235
hive,PR-4395,1,1,3,2,5
hive,PR-4292,29,31,1172,75,1247
hive,PR-4391,4,5,117,5,122
hive,PR-4382,2,49,2623,1798,4421
hive,PR-4352,4,1,2,1,3
hive,PR-4378,6,9,704,165,869
hive,PR-4292,30,31,1172,75,1247
hive,PR-4395,2,9,19,18,37
hive,PR-4396,1,1,6,0,6
hive,PR-4392,2,9,223,57,280
hive,PR-4313,18,26,705,111,816
hive,PR-4395,3,9,19,19,38
hive,PR-4391,5,5,117,5,122
hive,PR-4384,4,16,1012,369,1381
hive,PR-4397,1,3,280,1,281
hive,PR-4391,6,5,117,5,122
hive,PR-4346,6,9,404,5,409
hive,PR-4257,5,12,258,141,399
hive,PR-4382,3,47,2591,1762,4353
hive,PR-4352,5,1,2,1,3
hive,PR-4315,2,9,34,15,49
hive,PR-4398,1,6,335,18,353
hive,PR-4348,18,6,164,2,166
hive,PR-4382,4,48,2574,1745,4319
hive,PR-4348,19,6,176,2,178
hive,PR-4399,1,2,16,113,129
hive,PR-4400,1,2,2,2,4
hive,PR-4372,6,29,681,119,800
hive,PR-4401,1,2,6,6,12
hive,PR-4341,13,10,149,59,208
hive,PR-4399,2,2,16,113,129
hive,PR-4382,5,48,2594,1745,4339
hive,PR-4291,22,41,2750,771,3521
hive,PR-4382,6,48,2621,1781,4402
hive,PR-4402,2,6,21,21,42
hive,PR-4402,3,6,21,21,42
hive,PR-4341,14,9,100,10,110
hive,PR-4372,7,29,681,119,800
hive,PR-4402,4,6,21,21,42
hive,PR-4360,5,2,184,55,239
hive,PR-4382,7,48,2620,1781,4401
hive,PR-4402,5,6,21,21,42
hive,PR-4403,1,2,118,16,134
hive,PR-4382,8,48,2621,1781,4402
hive,PR-4341,15,9,100,10,110
hive,PR-4372,8,29,681,119,800
hive,PR-4341,16,9,100,10,110
hive,PR-4402,6,6,21,21,42
hive,PR-4372,9,29,681,119,800
hive,PR-4372,10,29,681,119,800
hive,PR-4404,1,6,60,10,70
hive,PR-4346,7,10,413,6,419
hive,PR-4372,11,29,681,119,800
hive,PR-4404,2,6,60,10,70
hive,PR-4360,6,2,184,55,239
hive,PR-4405,1,1,2,0,2
hive,PR-4372,12,29,681,119,800
hive,PR-4406,1,3,395,1,396
hive,PR-4407,1,3,5,4,9
hive,PR-4346,8,10,413,6,419
hive,PR-4405,2,1,2,0,2
hive,PR-4394,2,8,15,829,844
hive,PR-4291,23,41,2750,771,3521
hive,PR-4408,1,9,1,170,171
hive,PR-4409,1,4,79,31,110
hive,PR-4400,2,2,2,2,4
hive,PR-4384,5,16,1044,399,1443
hive,PR-4346,9,10,412,6,418
hive,PR-4378,7,11,716,168,884
hive,PR-4372,13,29,683,119,802
hive,PR-4403,3,2,128,16,144
hive,PR-4400,3,2,2,2,4
hive,PR-4346,10,10,413,7,420
hive,PR-4348,20,6,196,3,199
hive,PR-4408,2,9,1,170,171
hive,PR-4409,2,4,79,33,112
hive,PR-4403,4,2,128,16,144
hive,PR-4407,2,5,27,13,40
hive,PR-4410,1,1,34,33,67
hive,PR-4346,11,10,413,7,420
hive,PR-4370,3,10,20,270,290
hive,PR-4408,4,9,1,170,171
hive,PR-4403,5,2,128,16,144
hive,PR-4409,3,4,79,33,112
hive,PR-4378,8,11,716,168,884
hive,PR-4411,1,98,126,126,252
hive,PR-4407,3,5,38,14,52
hive,PR-4409,4,4,79,33,112
hive,PR-4403,6,2,128,16,144
hive,PR-4291,25,48,2833,972,3805
hive,PR-4410,3,2,46,42,88
hive,PR-4412,1,1,1,1,2
hive,PR-4414,1,1,1,1,2
hive,PR-4415,1,1,1,0,1
hive,PR-4408,5,9,1,170,171
hive,PR-4403,7,2,128,16,144
hive,PR-4416,1,8,178,44,222
hive,PR-4409,6,4,79,33,112
hive,PR-4410,4,3,59,46,105
hive,PR-4417,1,2,4,2,6
hive,PR-4407,4,5,33,15,48
hive,PR-4372,15,27,621,78,699
hive,PR-4418,1,2,48,21,69
hive,PR-4410,5,3,59,46,105
hive,PR-4409,7,4,79,33,112
hive,PR-4348,21,6,199,3,202
hive,PR-4291,27,48,2838,972,3810
hive,PR-4348,22,6,200,3,203
hive,PR-4416,2,8,178,44,222
hive,PR-4417,2,2,6,2,8
hive,PR-4348,23,6,200,3,203
hive,PR-4407,5,5,33,15,48
hive,PR-4409,8,4,79,33,112
hive,PR-4330,6,5,102,60,162
hive,PR-4419,2,3,6,0,6
hive,PR-4410,6,4,59,48,107
hive,PR-4418,2,2,49,21,70
hive,PR-4416,3,11,185,45,230
hive,PR-4392,3,9,316,56,372
hive,PR-4415,2,1,1,0,1
hive,PR-4420,1,1,0,4,4
hive,PR-4330,7,5,102,60,162
hive,PR-4346,12,10,412,12,424
hive,PR-4410,7,4,59,48,107
hive,PR-4348,24,6,200,3,203
hive,PR-4421,1,3,50,16,66
hive,PR-4291,29,48,2839,961,3800
hive,PR-4422,1,1,1,1,2
hive,PR-4419,3,3,6,0,6
hive,PR-4415,3,1,1,0,1
hive,PR-4423,1,74,3513,1639,5152
hive,PR-4412,2,1,1,1,2
hive,PR-4346,13,10,412,12,424
hive,PR-4416,4,11,185,45,230
hive,PR-4372,16,27,621,78,699
hive,PR-4424,1,1,7,1,8
hive,PR-4407,6,5,33,15,48
hive,PR-4409,9,4,79,33,112
hive,PR-4425,1,2,5,2,7
hive,PR-4426,1,3,52,0,52
hive,PR-4416,5,11,185,45,230
hive,PR-4427,1,3,43,26,69
hive,PR-4423,2,74,3591,1639,5230
hive,PR-4407,7,5,33,15,48
hive,PR-4424,2,1,11,2,13
hive,PR-4428,1,6,317,9,326
hive,PR-4424,3,1,11,2,13
hive,PR-4429,1,1,5,3,8
hive,PR-4429,2,1,5,3,8
hive,PR-4420,2,1,0,4,4
hive,PR-4430,1,5,158,21,179
hive,PR-4431,1,3,60,19,79
hive,PR-4432,2,2,5,2,7
hive,PR-4433,1,1,1,3,4
hive,PR-4434,1,1,1,1,2
hive,PR-4433,2,1,1,3,4
hive,PR-4430,2,5,158,21,179
hive,PR-4427,2,9,437,108,545
hive,PR-4323,2,1,3,1,4
hive,PR-4415,4,1,1,0,1
hive,PR-4436,1,1,1,1,2
hive,PR-4427,3,9,439,110,549
hive,PR-4426,2,4,56,5,61
hive,PR-4421,2,3,87,17,104
hive,PR-4437,1,1,10,0,10
hive,PR-4348,25,6,202,3,205
hive,PR-4438,2,300,5917,5999,11916
hive,PR-4348,26,6,202,3,205
hive,PR-4426,3,4,56,5,61
hive,PR-4437,2,1,10,0,10
hive,PR-4438,3,300,5917,5999,11916
hive,PR-4439,1,3,367,4,371
hive,PR-4440,1,3,43,3,46
hive,PR-4438,4,300,5917,5999,11916
hive,PR-4437,3,1,10,0,10
hive,PR-4348,27,6,202,3,205
hive,PR-4417,3,2,6,2,8
hive,PR-4439,2,3,363,0,363
hive,PR-4370,4,10,20,270,290
hive,PR-4440,2,3,43,3,46
hive,PR-4441,1,4,77,5,82
hive,PR-4392,5,9,316,57,373
hive,PR-4438,5,300,5917,5999,11916
hive,PR-4439,3,3,363,0,363
hive,PR-4346,14,9,413,11,424
hive,PR-4442,1,74,3588,1642,5230
hive,PR-4431,3,6,444,23,467
hive,PR-4291,32,47,2840,976,3816
hive,PR-4372,17,27,621,78,699
hive,PR-4438,6,300,5917,5999,11916
hive,PR-4415,6,2,27,0,27
hive,PR-4370,5,10,20,270,290
hive,PR-4346,15,9,413,11,424
hive,PR-4431,4,9,471,50,521
hive,PR-4443,1,64,835,732,1567
hive,PR-4384,7,39,3109,1750,4859
hive,PR-4428,2,7,318,9,327
hive,PR-4438,7,300,5917,5999,11916
hive,PR-4392,6,9,305,59,364
hive,PR-4370,6,10,20,270,290
hive,PR-4291,34,48,2817,978,3795
hive,PR-4346,16,9,413,11,424
hive,PR-4444,1,5,173,6,179
hive,PR-4323,3,1,3,1,4
hive,PR-4431,5,9,477,50,527
hive,PR-4438,8,300,5917,5999,11916
hive,PR-4445,1,5,85,0,85
hive,PR-4446,1,1,13,0,13
hive,PR-4348,28,9,189,9,198
hive,PR-4440,3,4,44,4,48
hive,PR-4444,2,5,173,6,179
hive,PR-4408,6,8,0,169,169
hive,PR-4431,6,9,477,50,527
hive,PR-4440,4,4,44,4,48
hive,PR-4440,5,4,46,5,51
hive,PR-4408,7,8,0,169,169
hive,PR-4447,1,3,152,78,230
hive,PR-4346,18,9,413,11,424
hive,PR-4291,35,48,2815,980,3795
hive,PR-4446,2,1,14,0,14
hive,PR-4415,7,2,27,0,27
hive,PR-4432,3,2,6,2,8
hive,PR-4348,29,7,164,8,172
hive,PR-4430,4,5,159,23,182
hive,PR-4440,6,4,46,5,51
hive,PR-4417,4,2,7,2,9
hive,PR-4408,8,8,0,169,169
hive,PR-4372,18,27,578,95,673
hive,PR-4431,8,11,481,56,537
hive,PR-4291,36,48,2815,980,3795
hive,PR-4447,2,3,152,78,230
hive,PR-4346,19,9,411,11,422
hive,PR-4291,37,49,2813,1401,4214
hive,PR-4448,2,2,27,8,35
hive,PR-4421,3,3,87,17,104
hive,PR-4440,7,49,345,138,483
hive,PR-4346,20,9,411,11,422
hive,PR-4348,32,8,171,9,180
hive,PR-4447,3,3,152,78,230
hive,PR-4239,1,1,45,6,51
hive,PR-4449,1,1,1,0,1
hive,PR-4432,4,2,6,2,8
hive,PR-4450,1,300,8790,5183,13973
hive,PR-4451,1,2,243,232,475
hive,PR-4450,2,300,8824,5212,14036
hive,PR-4348,33,8,171,9,180
hive,PR-4450,3,300,8824,5212,14036
hive,PR-4440,8,52,402,109,511
hive,PR-4450,4,300,8824,5212,14036
hive,PR-4421,4,4,124,20,144
hive,PR-4440,9,52,402,109,511
hive,PR-4431,9,11,427,57,484
hive,PR-4421,5,3,111,20,131
hive,PR-4348,34,8,171,9,180
hive,PR-4291,39,47,2813,980,3793
hive,PR-4384,11,47,3629,1995,5624
hive,PR-4450,5,300,8824,5212,14036
hive,PR-4291,40,47,2813,980,3793
hive,PR-4416,6,12,196,48,244
hive,PR-4452,1,4,1396,27,1423
hive,PR-4440,10,52,403,109,512
hive,PR-4453,1,9,291,24,315
hive,PR-4454,1,1,0,2,2
hive,PR-4431,10,11,437,80,517
hive,PR-4455,1,2,115,4,119
hive,PR-4447,4,3,158,82,240
hive,PR-4454,2,3,6,10,16
hive,PR-4384,13,48,3628,2002,5630
hive,PR-4291,43,47,2813,980,3793
hive,PR-4442,2,80,3664,1654,5318
hive,PR-4291,44,51,2875,1018,3893
hive,PR-4428,3,7,318,9,327
hive,PR-4428,4,7,321,9,330
hive,PR-4453,2,9,297,25,322
hive,PR-4304,7,300,1435,9,1444
hive,PR-4453,3,9,243,41,284
hive,PR-4384,14,49,3674,2020,5694
hive,PR-4442,3,74,3596,1642,5238
hive,PR-4384,15,49,3676,2021,5697
hive,PR-4384,16,49,3676,2021,5697
hive,PR-4442,5,75,3597,1643,5240
hive,PR-4453,4,9,202,23,225
hive,PR-4452,4,4,1396,27,1423
hive,PR-4384,17,49,3664,2036,5700
hive,PR-4453,5,9,202,23,225
hive,PR-4442,6,75,3597,1643,5240
hive,PR-4452,5,5,1401,32,1433
hive,PR-4384,18,49,3662,2036,5698
hive,PR-4416,7,12,210,51,261
hive,PR-4428,5,7,321,9,330
hive,PR-4458,3,1,4,4,8
hive,PR-4440,12,8,62,9,71
hive,PR-4372,20,27,517,92,609
hive,PR-4456,6,2,20,2,22
hive,PR-4442,7,75,3597,1643,5240
hive,PR-4459,1,5,32,1401,1433
hive,PR-4304,8,300,1372,46,1418
hive,PR-4460,1,2,3,3,6
hive,PR-4456,7,2,20,2,22
hive,PR-4440,14,4,54,4,58
hive,PR-4442,8,75,3597,1643,5240
hive,PR-4462,1,3,56,115,171
hive,PR-4463,1,2,37,17,54
hive,PR-4458,4,1,21,0,21
hive,PR-4384,20,51,3916,2062,5978
hive,PR-4440,15,4,54,4,58
hive,PR-4464,2,5,18,14,32
hive,PR-4460,2,2,3,3,6
hive,PR-4384,21,51,3922,2062,5984
hive,PR-4466,1,5,1401,32,1433
hive,PR-4467,1,2,1404,0,1404
hive,PR-4384,22,52,3935,2065,6000
hive,PR-4467,2,8,1641,13,1654
hive,PR-4384,23,52,3940,2065,6005
hive,PR-4467,3,13,1980,211,2191
hive,PR-4384,24,52,3940,2065,6005
hive,PR-4464,3,4,10,10,20
hive,PR-4372,21,27,491,96,587
hive,PR-4304,9,300,1399,44,1443
hive,PR-4372,22,27,491,96,587
hive,PR-4304,10,300,1399,44,1443
hive,PR-4468,1,68,1212,732,1944
hive,PR-4401,2,2,6,6,12
hive,PR-4336,3,3,207,50,257
hive,PR-4468,2,68,1212,732,1944
hive,PR-4445,2,5,80,0,80
hive,PR-4384,25,53,4001,2064,6065
hive,PR-4445,3,5,80,0,80
hive,PR-4469,1,4,73,41,114
hive,PR-4468,3,68,1207,732,1939
hive,PR-4468,4,68,1207,732,1939
hive,PR-4384,26,53,3999,2061,6060
hive,PR-4304,11,300,1402,44,1446
hive,PR-4468,5,68,1207,732,1939
hive,PR-4384,27,53,3980,2063,6043
hive,PR-4468,6,68,1207,732,1939
hive,PR-4470,1,1,16,4,20
hive,PR-4468,7,68,1207,732,1939
hive,PR-4445,4,5,80,0,80
hive,PR-4468,8,68,1207,732,1939
hive,PR-4471,2,2,93,74,167
hive,PR-4384,28,53,3980,2063,6043
hive,PR-4471,3,2,86,74,160
hive,PR-3633,1,2,9,2,11
hive,PR-4384,29,53,3980,2063,6043
hive,PR-4384,30,53,3980,2063,6043
hive,PR-4469,2,4,73,41,114
hive,PR-4471,5,2,91,80,171
hive,PR-4473,1,300,6997,6375,13372
hive,PR-4447,5,3,153,82,235
hive,PR-3633,2,2,9,2,11
hive,PR-4470,2,1,16,4,20
hive,PR-4445,5,5,80,0,80
hive,PR-4474,1,5,7,0,7
hive,PR-4475,1,3,100,74,174
hive,PR-4472,3,2,80,0,80
hive,PR-3633,3,2,9,2,11
hive,PR-4470,3,1,56,28,84
hive,PR-4469,3,4,77,46,123
hive,PR-4472,4,300,6306,5913,12219
hive,PR-4456,8,2,20,2,22
hive,PR-4476,1,4,15,3,18
hive,PR-4372,23,27,491,96,587
hive,PR-4440,16,7,65,6,71
hive,PR-4469,4,4,77,46,123
hive,PR-4372,24,27,491,96,587
hive,PR-4475,2,3,100,74,174
hive,PR-4476,2,4,15,3,18
hive,PR-4431,11,11,438,80,518
hive,PR-4440,17,5,55,6,61
hive,PR-4431,12,11,438,80,518
hive,PR-4440,18,5,55,6,61
hive,PR-4477,1,1,1,0,1
hive,PR-4445,6,5,80,0,80
hive,PR-4477,2,1,1,0,1
hive,PR-4473,2,300,7077,6375,13452
hive,PR-4478,1,3,1788,0,1788
hive,PR-4440,20,5,54,6,60
hive,PR-4479,1,3,93,18,111
hive,PR-4440,21,5,54,6,60
hive,PR-4441,3,4,101,14,115
hive,PR-4478,2,3,1788,0,1788
hive,PR-4304,16,300,1414,18,1432
hive,PR-4421,8,3,111,20,131
hive,PR-4431,13,11,438,80,518
hive,PR-4421,9,3,111,20,131
hive,PR-4326,3,2,12,1,13
hive,PR-4480,1,3,53,117,170
hive,PR-4326,4,2,12,1,13
hive,PR-4478,3,3,1788,0,1788
hive,PR-4326,5,2,12,1,13
hive,PR-4304,17,300,1414,18,1432
hive,PR-4446,3,18,390,98,488
hive,PR-4304,18,300,1414,18,1432
hive,PR-4481,1,1,1,1,2
hive,PR-4483,1,1,0,1,1
hive,PR-3798,3,28,736,459,1195
hive,PR-4421,10,3,111,20,131
hive,PR-4475,3,3,100,74,174
hive,PR-4480,2,3,59,121,180
hive,PR-4482,2,20,251,61,312
hive,PR-4473,3,300,7077,6375,13452
hive,PR-4483,2,1,0,1,1
hive,PR-4477,3,1,8,0,8
hive,PR-4484,2,37,789,1806,2595
hive,PR-4326,6,2,12,1,13
hive,PR-4446,5,20,386,101,487
hive,PR-4483,3,1,0,1,1
hive,PR-4482,3,20,251,61,312
hive,PR-4480,3,3,59,121,180
hive,PR-4450,6,300,8824,5212,14036
hive,PR-3798,4,28,736,459,1195
hive,PR-4483,4,1,0,1,1
hive,PR-3798,5,28,731,459,1190
hive,PR-3602,1,1,8,6,14
hive,PR-4483,5,1,0,1,1
hive,PR-4415,8,4,36,4,40
hive,PR-4483,6,1,0,1,1
hive,PR-4486,1,4,23,18,41
hive,PR-4487,2,2,1,9,10
hive,PR-3066,1,300,9584,9875,19459
hive,PR-3066,2,300,9584,9875,19459
hive,PR-4488,1,300,6307,5914,12221
hive,PR-4489,1,1,1,1,2
hive,PR-4441,4,4,105,19,124
hive,PR-4431,14,11,443,81,524
hive,PR-4488,2,300,6307,5914,12221
hive,PR-4326,7,2,12,1,13
hive,PR-4490,1,17,1031,253,1284
hive,PR-4441,5,4,105,19,124
hive,PR-4476,3,4,56,5,61
hive,PR-4491,1,5,99,21,120
hive,PR-4441,6,4,105,19,124
hive,PR-4326,8,2,12,1,13
hive,PR-4476,4,4,56,5,61
hive,PR-4492,1,1,0,1,1
hive,PR-4450,7,300,8942,5216,14158
hive,PR-4493,1,14,386,210,596
hive,PR-4489,2,1,1,1,2
hive,PR-4494,1,1,1,0,1
hive,PR-4450,8,300,8942,5216,14158
hive,PR-4495,1,300,6206,5754,11960
hive,PR-4341,17,9,90,10,100
hive,PR-4304,19,300,1476,18,1494
hive,PR-4491,3,5,106,6,112
hive,PR-4485,4,3,47,18,65
hive,PR-4497,1,4,593,220,813
hive,PR-4495,2,300,6206,5754,11960
hive,PR-4496,2,2,44,22,66
hive,PR-4304,20,300,1476,18,1494
hive,PR-4431,15,11,439,82,521
hive,PR-4478,4,5,1853,0,1853
hive,PR-4477,5,2,39,2,41
hive,PR-4492,3,2,72,2,74
hive,PR-4497,2,4,593,220,813
hive,PR-4495,3,300,6206,5754,11960
hive,PR-4478,5,5,1853,0,1853
hive,PR-4498,1,3,44,2,46
hive,PR-4304,21,300,1476,18,1494
hive,PR-4500,1,1,27,3,30
hive,PR-4431,16,11,439,82,521
hive,PR-4501,1,4,281,12,293
hive,PR-4502,1,2,2,2,4
hive,PR-4480,5,3,60,121,181
hive,PR-3798,6,28,731,459,1190
hive,PR-4501,2,5,282,13,295
hive,PR-4478,6,6,449,0,449
hive,PR-4421,12,3,108,20,128
hive,PR-3798,7,28,731,459,1190
hive,PR-4415,10,4,41,4,45
hive,PR-4504,1,2,7,0,7
hive,PR-4497,3,4,509,325,834
hive,PR-4450,9,300,8942,5216,14158
hive,PR-4497,4,4,413,229,642
hive,PR-4415,11,4,41,4,45
hive,PR-4498,2,4,47,2,49
hive,PR-4421,13,3,108,20,128
hive,PR-4502,2,2,2,2,4
hive,PR-4471,6,2,93,80,173
hive,PR-4428,6,10,435,11,446
hive,PR-4341,19,9,73,12,85
hive,PR-4503,4,3,129,17,146
hive,PR-4505,1,6,33,34,67
hive,PR-4482,5,20,254,62,316
hive,PR-4506,1,7,33,33,66
hive,PR-4502,3,2,2,2,4
hive,PR-4507,1,3,68,1,69
hive,PR-4498,3,4,47,2,49
hive,PR-4478,7,6,449,0,449
hive,PR-4341,20,10,72,17,89
hive,PR-4428,9,10,435,11,446
hive,PR-4415,12,4,41,4,45
hive,PR-4341,21,10,72,17,89
hive,PR-4482,6,20,254,62,316
hive,PR-4341,22,10,72,17,89
hive,PR-4450,12,300,8206,5203,13409
hive,PR-4428,10,10,435,11,446
hive,PR-4508,1,1,1,1,2
hive,PR-4507,2,3,68,1,69
hive,PR-4326,9,2,15,1,16
hive,PR-4421,14,3,108,20,128
hive,PR-4450,13,300,8206,5203,13409
hive,PR-4341,23,10,72,17,89
hive,PR-4509,1,1,2,1,3
hive,PR-4428,11,10,435,11,446
hive,PR-4510,1,21,275,21,296
hive,PR-4304,22,300,1580,18,1598
hive,PR-4491,4,5,109,6,115
hive,PR-4511,1,2,1404,0,1404
hive,PR-4498,4,5,70,2,72
hive,PR-4512,1,1,0,1,1
hive,PR-4507,3,3,68,1,69
hive,PR-4428,12,10,435,11,446
hive,PR-4513,1,6,478,0,478
hive,PR-4477,6,1,30,0,30
hive,PR-4511,2,2,1404,0,1404
hive,PR-4498,5,5,70,2,72
hive,PR-4341,24,10,73,17,90
hive,PR-4511,3,13,1994,125,2119
hive,PR-4341,25,10,72,17,89
hive,PR-4304,23,300,1556,18,1574
hive,PR-4492,4,2,72,2,74
hive,PR-4450,14,300,8212,5203,13415
hive,PR-4491,5,5,109,6,115
hive,PR-4450,15,300,8212,5203,13415
hive,PR-4333,3,18,187,594,781
hive,PR-4507,5,3,78,12,90
hive,PR-4431,17,11,440,82,522
hive,PR-4514,1,13,147,33,180
hive,PR-4431,18,11,440,82,522
hive,PR-4480,6,3,64,121,185
hive,PR-4431,19,11,440,82,522
hive,PR-4333,4,18,187,594,781
hive,PR-4477,7,1,23,0,23
hive,PR-4501,3,6,320,52,372
hive,PR-4478,8,6,449,0,449
hive,PR-4515,1,3,182,0,182
hive,PR-4501,4,6,320,52,372
hive,PR-4514,2,14,156,42,198
hive,PR-4515,2,4,182,0,182
hive,PR-4501,5,6,321,53,374
hive,PR-4431,20,11,439,82,521
hive,PR-4514,3,14,156,42,198
hive,PR-4491,6,6,109,10,119
hive,PR-4515,3,4,182,0,182
hive,PR-4477,8,1,23,0,23
hive,PR-4516,1,6,321,53,374
hive,PR-4304,24,300,1556,18,1574
hive,PR-4501,6,6,321,53,374
hive,PR-4480,7,3,61,113,174
hive,PR-4478,9,6,449,0,449
hive,PR-4501,7,6,321,53,374
hive,PR-4515,4,4,182,0,182
hive,PR-4450,16,300,8219,5203,13422
hive,PR-4515,5,4,182,0,182
hive,PR-4491,7,5,107,7,114
hive,PR-4501,9,7,412,114,526
hive,PR-4428,13,10,440,11,451
hive,PR-4480,8,2,61,110,171
hive,PR-4428,14,10,440,11,451
hive,PR-4501,10,7,412,114,526
hive,PR-4478,10,6,449,0,449
hive,PR-4517,1,9,1771,824,2595
hive,PR-4478,11,6,449,0,449
hive,PR-4484,3,37,789,1806,2595
hive,PR-4515,7,4,154,0,154
hive,PR-4518,1,1,78,72,150
hive,PR-4484,4,37,789,1806,2595
hive,PR-4484,5,37,789,1806,2595
hive,PR-4484,6,37,789,1806,2595
hive,PR-4519,1,11,448,152,600
hive,PR-4520,1,4,961,9,970
hive,PR-4517,2,9,1771,824,2595
hive,PR-3066,4,300,9592,9876,19468
hive,PR-4520,2,4,959,10,969
hive,PR-4450,17,300,8220,5203,13423
hive,PR-4517,3,9,1771,824,2595
hive,PR-4477,9,1,15,0,15
hive,PR-4484,7,37,789,1806,2595
hive,PR-4521,1,300,6119,5521,11640
hive,PR-4495,4,300,6296,5755,12051
hive,PR-4501,12,7,412,113,525
hive,PR-4477,10,1,15,0,15
hive,PR-4477,11,1,15,0,15
hive,PR-4521,2,300,6119,5521,11640
hive,PR-4501,13,7,412,113,525
hive,PR-4478,13,8,524,0,524
hive,PR-4522,1,14,386,210,596
hive,PR-4478,14,8,524,0,524
jackrabbit-oak,PR-321,1,1,1,1,2
jackrabbit-oak,PR-293,1,2,202,124,326
jackrabbit-oak,PR-275,1,1,2,2,4
jackrabbit-oak,PR-342,1,2,85,19,104
jackrabbit-oak,PR-347,1,1,20,0,20
jackrabbit-oak,PR-348,1,1,2,1,3
jackrabbit-oak,PR-161,2,1,1,0,1
jackrabbit-oak,PR-161,3,1,1,0,1
jackrabbit-oak,PR-161,4,1,1,0,1
jackrabbit-oak,PR-161,5,1,2,0,2
jackrabbit-oak,PR-347,2,1,45,0,45
jackrabbit-oak,PR-359,1,8,295,11,306
jackrabbit-oak,PR-362,1,1,3,3,6
jackrabbit-oak,PR-362,2,1,3,3,6
jackrabbit-oak,PR-359,3,4,234,33,267
jackrabbit-oak,PR-407,1,1,1,1,2
jackrabbit-oak,PR-407,2,1,1,1,2
jackrabbit-oak,PR-407,3,0,0,0,0
jackrabbit-oak,PR-407,4,1,1,1,2
jackrabbit-oak,PR-414,2,1,41,0,41
jackrabbit-oak,PR-414,3,1,79,0,79
jackrabbit-oak,PR-414,4,1,67,0,67
jackrabbit-oak,PR-407,5,1,1,1,2
jackrabbit-oak,PR-407,6,1,1,1,2
jackrabbit-oak,PR-424,1,5,94,1,95
jackrabbit-oak,PR-427,5,17,514,12,526
jackrabbit-oak,PR-428,1,4,25,5,30
jackrabbit-oak,PR-429,1,4,118,65,183
jackrabbit-oak,PR-429,2,5,138,65,203
jackrabbit-oak,PR-427,6,17,514,12,526
jackrabbit-oak,PR-424,3,5,93,1,94
jackrabbit-oak,PR-414,5,1,67,0,67
jackrabbit-oak,PR-407,7,1,1,1,2
jackrabbit-oak,PR-362,4,1,3,3,6
jackrabbit-oak,PR-359,4,4,234,33,267
jackrabbit-oak,PR-347,3,1,45,0,45
jackrabbit-oak,PR-342,2,2,85,19,104
jackrabbit-oak,PR-275,2,1,2,2,4
jackrabbit-oak,PR-226,2,1,2,2,4
jackrabbit-oak,PR-218,2,6,11,11,22
jackrabbit-oak,PR-216,2,3,4,4,8
jackrabbit-oak,PR-209,2,2,5,1,6
jackrabbit-oak,PR-208,2,1,0,1,1
jackrabbit-oak,PR-192,2,1,1,1,2
jackrabbit-oak,PR-191,2,1,1,1,2
jackrabbit-oak,PR-180,2,1,6,2,8
jackrabbit-oak,PR-165,2,1,1,1,2
jackrabbit-oak,PR-161,6,1,2,0,2
jackrabbit-oak,PR-160,2,2,150,9,159
jackrabbit-oak,PR-431,1,19,193,274,467
jackrabbit-oak,PR-427,7,23,537,21,558
jackrabbit-oak,PR-433,1,3,12,9,21
jackrabbit-oak,PR-424,4,2,37,1,38
jackrabbit-oak,PR-436,1,1,0,63,63
jackrabbit-oak,PR-439,1,1,1,1,2
jackrabbit-oak,PR-431,3,19,195,276,471
jackrabbit-oak,PR-424,6,3,68,4,72
jackrabbit-oak,PR-424,7,2,65,4,69
jackrabbit-oak,PR-424,9,2,61,4,65
jackrabbit-oak,PR-446,2,5,179,2,181
jackrabbit-oak,PR-446,3,5,182,2,184
jackrabbit-oak,PR-448,1,1,19,0,19
jackrabbit-oak,PR-359,5,5,244,34,278
jackrabbit-oak,PR-453,2,4,123,7,130
jackrabbit-oak,PR-453,4,7,142,11,153
jackrabbit-oak,PR-453,5,7,141,11,152
jackrabbit-oak,PR-450,2,17,621,190,811
jackrabbit-oak,PR-459,1,1,1,1,2
jackrabbit-oak,PR-464,1,5,229,36,265
jackrabbit-oak,PR-465,2,7,166,82,248
jackrabbit-oak,PR-465,3,7,188,105,293
jackrabbit-oak,PR-466,2,5,107,16,123
jackrabbit-oak,PR-465,4,8,126,43,169
jackrabbit-oak,PR-465,5,7,123,18,141
jackrabbit-oak,PR-465,6,7,118,14,132
jackrabbit-oak,PR-466,3,6,86,16,102
jackrabbit-oak,PR-466,5,7,95,15,110
jackrabbit-oak,PR-465,7,9,221,31,252
jackrabbit-oak,PR-465,11,9,264,12,276
jackrabbit-oak,PR-471,1,5,175,3,178
jackrabbit-oak,PR-472,1,2,51,13,64
jackrabbit-oak,PR-443,7,35,1189,136,1325
jackrabbit-oak,PR-478,1,2,3,3,6
jackrabbit-oak,PR-469,2,4,419,112,531
jackrabbit-oak,PR-480,1,2,39,4,43
jackrabbit-oak,PR-481,1,8,19,19,38
jackrabbit-oak,PR-481,2,10,24,23,47
jackrabbit-oak,PR-481,3,11,25,24,49
jackrabbit-oak,PR-486,1,5,288,71,359
jackrabbit-oak,PR-488,1,2,22,5,27
jackrabbit-oak,PR-487,2,39,720,570,1290
jackrabbit-oak,PR-489,3,4,80,81,161
jackrabbit-oak,PR-471,3,7,1017,3,1020
jackrabbit-oak,PR-471,4,7,1017,3,1020
jackrabbit-oak,PR-471,5,7,1017,3,1020
jackrabbit-oak,PR-494,1,5,58,5,63
jackrabbit-oak,PR-494,4,5,56,7,63
jackrabbit-oak,PR-492,4,8,242,22,264
jackrabbit-oak,PR-492,6,11,330,59,389
jackrabbit-oak,PR-492,8,11,334,62,396
jackrabbit-oak,PR-498,1,13,657,182,839
jackrabbit-oak,PR-497,2,1,1,2,3
jackrabbit-oak,PR-497,3,2,49,2,51
jackrabbit-oak,PR-497,6,2,51,2,53
jackrabbit-oak,PR-499,1,2,4,3,7
jackrabbit-oak,PR-499,2,3,74,3,77
jackrabbit-oak,PR-501,1,5,367,15,382
jackrabbit-oak,PR-503,1,3,126,0,126
jackrabbit-oak,PR-504,1,2,18,8,26
jackrabbit-oak,PR-504,2,2,21,10,31
jackrabbit-oak,PR-504,3,2,21,10,31
jackrabbit-oak,PR-505,1,2,48,3,51
jackrabbit-oak,PR-506,1,3,65,1,66
jackrabbit-oak,PR-508,3,3,140,36,176
jackrabbit-oak,PR-508,5,4,189,38,227
jackrabbit-oak,PR-514,1,8,93,7,100
jackrabbit-oak,PR-515,1,3,22,3,25
jackrabbit-oak,PR-513,5,19,1439,599,2038
jackrabbit-oak,PR-508,8,4,274,38,312
jackrabbit-oak,PR-516,1,2,74,17,91
jackrabbit-oak,PR-517,1,5,456,32,488
jackrabbit-oak,PR-518,1,3,56,5,61
jackrabbit-oak,PR-520,1,24,1709,116,1825
jackrabbit-oak,PR-521,1,1,2,2,4
jackrabbit-oak,PR-518,2,3,68,5,73
jackrabbit-oak,PR-514,3,9,93,8,101
jackrabbit-oak,PR-520,2,3,74,41,115
jackrabbit-oak,PR-520,3,3,76,43,119
jackrabbit-oak,PR-517,2,5,456,32,488
jackrabbit-oak,PR-508,10,7,550,47,597
jackrabbit-oak,PR-510,1,6,189,3,192
jackrabbit-oak,PR-524,1,6,191,151,342
jackrabbit-oak,PR-524,2,6,182,147,329
jackrabbit-oak,PR-508,11,7,565,51,616
jackrabbit-oak,PR-508,12,7,663,50,713
jackrabbit-oak,PR-525,2,4,173,59,232
jackrabbit-oak,PR-526,1,2,38,1,39
jackrabbit-oak,PR-510,2,6,191,3,194
jackrabbit-oak,PR-527,1,5,529,66,595
jackrabbit-oak,PR-527,2,6,533,66,599
jackrabbit-oak,PR-528,1,7,65,55,120
jackrabbit-oak,PR-525,5,4,322,225,547
jackrabbit-oak,PR-525,6,4,322,225,547
jackrabbit-oak,PR-527,3,6,533,66,599
jackrabbit-oak,PR-530,1,1,13,8,21
jackrabbit-oak,PR-510,3,7,169,4,173
jackrabbit-oak,PR-531,1,1,5,0,5
jackrabbit-oak,PR-510,4,7,167,6,173
jackrabbit-oak,PR-532,2,2,272,2,274
jackrabbit-oak,PR-536,2,3,33,12,45
jackrabbit-oak,PR-510,5,7,176,10,186
jackrabbit-oak,PR-510,6,7,176,10,186
jackrabbit-oak,PR-510,7,7,176,10,186
jackrabbit-oak,PR-538,1,3,74,9,83
jackrabbit-oak,PR-538,2,3,98,11,109
jackrabbit-oak,PR-510,8,7,176,10,186
jackrabbit-oak,PR-536,4,8,86,25,111
jackrabbit-oak,PR-538,3,3,98,11,109
jackrabbit-oak,PR-540,1,1,1,1,2
jackrabbit-oak,PR-536,7,9,306,61,367
jackrabbit-oak,PR-538,4,3,111,11,122
jackrabbit-oak,PR-536,8,9,310,61,371
jackrabbit-oak,PR-541,1,1,1,1,2
jackrabbit-oak,PR-542,1,1,1,1,2
jackrabbit-oak,PR-543,1,1,1,1,2
jackrabbit-oak,PR-545,1,1,1,1,2
jackrabbit-oak,PR-544,1,1,1,1,2
jackrabbit-oak,PR-546,1,1,1,1,2
jackrabbit-oak,PR-547,1,1,1,1,2
jackrabbit-oak,PR-538,5,3,128,25,153
jackrabbit-oak,PR-548,1,1,0,14,14
jackrabbit-oak,PR-550,1,2,21,0,21
jackrabbit-oak,PR-550,2,2,20,1,21
jackrabbit-oak,PR-552,1,2,119,9,128
jackrabbit-oak,PR-490,41,39,1260,948,2208
jackrabbit-oak,PR-554,1,2,145,70,215
jackrabbit-oak,PR-554,2,2,153,63,216
jackrabbit-oak,PR-535,4,23,377,88,465
jackrabbit-oak,PR-535,6,1,10,21,31
jackrabbit-oak,PR-544,2,1,1,1,2
jackrabbit-oak,PR-555,1,2,4,2,6
jackrabbit-oak,PR-558,1,1,1,1,2
jackrabbit-oak,PR-559,1,2,27,21,48
jackrabbit-oak,PR-559,2,2,25,19,44
jackrabbit-oak,PR-535,7,23,366,88,454
jackrabbit-oak,PR-535,8,23,366,88,454
jackrabbit-oak,PR-490,43,38,1076,972,2048
jackrabbit-oak,PR-535,10,23,374,93,467
jackrabbit-oak,PR-562,2,4,112,37,149
jackrabbit-oak,PR-535,12,23,370,98,468
jackrabbit-oak,PR-490,44,38,943,958,1901
jackrabbit-oak,PR-564,4,4,49,36,85
jackrabbit-oak,PR-564,5,4,52,53,105
jackrabbit-oak,PR-564,6,4,52,53,105
jackrabbit-oak,PR-564,7,6,66,63,129
jackrabbit-oak,PR-565,3,20,602,182,784
jackrabbit-oak,PR-565,4,5,104,21,125
jackrabbit-oak,PR-566,1,6,198,10,208
jackrabbit-oak,PR-490,48,39,957,1037,1994
jackrabbit-oak,PR-570,1,2,16,26,42
jackrabbit-oak,PR-560,20,10,123,21,144
jackrabbit-oak,PR-571,3,20,608,110,718
jackrabbit-oak,PR-571,4,4,296,11,307
jackrabbit-oak,PR-568,10,42,1057,1068,2125
jackrabbit-oak,PR-572,2,4,131,1,132
jackrabbit-oak,PR-571,9,4,342,11,353
jackrabbit-oak,PR-568,11,40,1041,1042,2083
jackrabbit-oak,PR-568,13,40,1043,1044,2087
jackrabbit-oak,PR-575,1,1,1,1,2
jackrabbit-oak,PR-576,1,1,1,1,2
jackrabbit-oak,PR-577,1,1,1,1,2
jackrabbit-oak,PR-560,24,9,109,21,130
jackrabbit-oak,PR-560,25,9,124,21,145
jackrabbit-oak,PR-568,15,41,1044,1045,2089
jackrabbit-oak,PR-574,2,12,565,19,584
jackrabbit-oak,PR-579,2,2,3,0,3
jackrabbit-oak,PR-566,3,9,210,10,220
jackrabbit-oak,PR-580,1,12,466,11,477
jackrabbit-oak,PR-581,1,4,163,54,217
jackrabbit-oak,PR-581,2,5,212,76,288
jackrabbit-oak,PR-582,3,1,50,21,71
jackrabbit-oak,PR-582,6,1,51,22,73
jackrabbit-oak,PR-362,7,0,0,0,0
jackrabbit-oak,PR-567,34,28,19925,101,20026
jackrabbit-oak,PR-567,35,28,19926,101,20027
jackrabbit-oak,PR-567,36,28,9080,101,9181
jackrabbit-oak,PR-567,37,28,9083,101,9184
jackrabbit-oak,PR-567,38,28,9087,101,9188
jackrabbit-oak,PR-567,39,34,9168,134,9302
jackrabbit-oak,PR-567,40,34,9168,134,9302
jackrabbit-oak,PR-567,41,34,9158,119,9277
jackrabbit-oak,PR-567,42,34,9156,115,9271
jackrabbit-oak,PR-567,43,34,9155,114,9269
jackrabbit-oak,PR-587,1,38,9216,123,9339
jackrabbit-oak,PR-581,3,5,219,76,295
jackrabbit-oak,PR-581,4,5,235,81,316
jackrabbit-oak,PR-581,5,7,244,81,325
jackrabbit-oak,PR-581,6,8,263,90,353
jackrabbit-oak,PR-581,7,9,275,94,369
jackrabbit-oak,PR-581,8,9,308,94,402
jackrabbit-oak,PR-593,1,2,5,1,6
jackrabbit-oak,PR-587,2,34,9164,121,9285
jackrabbit-oak,PR-587,3,34,9240,288,9528
jackrabbit-oak,PR-594,1,1,38,37,75
jackrabbit-oak,PR-594,2,1,81,86,167
jackrabbit-oak,PR-581,9,9,304,94,398
jackrabbit-oak,PR-581,10,9,302,94,396
jackrabbit-oak,PR-596,1,1,10,3,13
jackrabbit-oak,PR-593,2,2,17,1,18
jackrabbit-oak,PR-597,1,2,53,15,68
jackrabbit-oak,PR-578,23,10,586,378,964
jackrabbit-oak,PR-578,24,10,586,378,964
jackrabbit-oak,PR-578,25,10,585,375,960
jackrabbit-oak,PR-578,26,10,588,375,963
jackrabbit-oak,PR-578,27,10,588,375,963
jackrabbit-oak,PR-600,1,1,1,1,2
jackrabbit-oak,PR-578,30,9,587,374,961
jackrabbit-oak,PR-601,1,1,1,1,2
jackrabbit-oak,PR-606,1,2,8,4,12
jackrabbit-oak,PR-603,2,6,227,31,258
jackrabbit-oak,PR-609,2,5,172,3,175
jackrabbit-oak,PR-608,3,1,52,30,82
jackrabbit-oak,PR-608,4,1,52,30,82
jackrabbit-oak,PR-605,4,1,1,1,2
jackrabbit-oak,PR-612,1,1,8,1,9
jackrabbit-oak,PR-615,2,38,9361,330,9691
jackrabbit-oak,PR-615,3,38,9361,330,9691
jackrabbit-oak,PR-615,4,38,9364,333,9697
jackrabbit-oak,PR-617,1,1,1,1,2
jackrabbit-oak,PR-615,5,38,9364,333,9697
jackrabbit-oak,PR-615,6,38,9364,333,9697
jackrabbit-oak,PR-615,7,38,9365,333,9698
jackrabbit-oak,PR-615,8,38,9367,333,9700
jackrabbit-oak,PR-619,1,1,4,0,4
jackrabbit-oak,PR-617,2,1,1,1,2
jackrabbit-oak,PR-615,9,38,9411,333,9744
jackrabbit-oak,PR-616,2,13,55,58,113
jackrabbit-oak,PR-592,10,7,22,81,103
jackrabbit-oak,PR-592,11,7,22,81,103
jackrabbit-oak,PR-592,12,8,36,82,118
jackrabbit-oak,PR-624,1,1,1,1,2
jackrabbit-oak,PR-625,1,1,1,1,2
jackrabbit-oak,PR-626,1,15,26,19,45
jackrabbit-oak,PR-623,2,2,26,10,36
jackrabbit-oak,PR-628,1,2,4,6,10
jackrabbit-oak,PR-592,14,8,36,82,118
jackrabbit-oak,PR-342,3,2,85,1,86
jackrabbit-oak,PR-544,3,1,1,1,2
jackrabbit-oak,PR-592,15,8,36,82,118
jackrabbit-oak,PR-645,2,5,131,25,156
jackrabbit-oak,PR-635,7,18,940,4,944
jackrabbit-oak,PR-635,8,18,942,4,946
jackrabbit-oak,PR-635,9,18,942,4,946
jackrabbit-oak,PR-646,2,3,14,6,20
jackrabbit-oak,PR-648,2,32,3188,368,3556
jackrabbit-oak,PR-646,3,3,16,6,22
jackrabbit-oak,PR-650,1,1,47,0,47
jackrabbit-oak,PR-651,1,1,10,12,22
jackrabbit-oak,PR-651,2,1,10,12,22
jackrabbit-oak,PR-652,1,3,42,3,45
jackrabbit-oak,PR-653,2,4,31,12,43
jackrabbit-oak,PR-654,1,1,19,2,21
jackrabbit-oak,PR-646,4,4,93,6,99
jackrabbit-oak,PR-653,3,5,38,13,51
jackrabbit-oak,PR-653,4,5,49,19,68
jackrabbit-oak,PR-653,5,5,50,20,70
jackrabbit-oak,PR-653,6,6,93,69,162
jackrabbit-oak,PR-653,8,6,92,67,159
jackrabbit-oak,PR-652,2,3,42,3,45
jackrabbit-oak,PR-653,11,7,120,67,187
jackrabbit-oak,PR-635,10,18,942,4,946
jackrabbit-oak,PR-657,3,5,109,80,189
jackrabbit-oak,PR-660,1,12,145,24,169
jackrabbit-oak,PR-661,1,1,1,1,2
jackrabbit-oak,PR-662,1,3,53,2,55
jackrabbit-oak,PR-295,9,44,300,305,605
jackrabbit-oak,PR-644,3,3,272,0,272
jackrabbit-oak,PR-663,1,6,190,43,233
jackrabbit-oak,PR-665,1,9,853,13,866
jackrabbit-oak,PR-667,1,2,21,15,36
jackrabbit-oak,PR-667,2,3,22,18,40
jackrabbit-oak,PR-667,4,5,83,54,137
jackrabbit-oak,PR-665,2,9,853,13,866
jackrabbit-oak,PR-669,1,11,529,19,548
jackrabbit-oak,PR-670,1,2,44,18,62
jackrabbit-oak,PR-670,2,2,51,18,69
jackrabbit-oak,PR-670,3,4,95,23,118
jackrabbit-oak,PR-670,4,4,95,23,118
jackrabbit-oak,PR-635,12,27,1078,77,1155
jackrabbit-oak,PR-635,13,27,1090,77,1167
jackrabbit-oak,PR-671,1,9,900,353,1253
jackrabbit-oak,PR-671,2,9,899,353,1252
jackrabbit-oak,PR-671,3,9,903,353,1256
jackrabbit-oak,PR-672,1,2,28,11,39
jackrabbit-oak,PR-671,4,10,904,354,1258
jackrabbit-oak,PR-671,5,10,905,354,1259
jackrabbit-oak,PR-671,6,11,910,354,1264
jackrabbit-oak,PR-665,3,9,853,13,866
jackrabbit-oak,PR-664,2,1,32,0,32
jackrabbit-oak,PR-665,4,9,859,13,872
jackrabbit-oak,PR-295,11,44,302,307,609
jackrabbit-oak,PR-649,10,33,705,114,819
jackrabbit-oak,PR-295,12,44,302,307,609
jackrabbit-oak,PR-651,5,2,295,12,307
jackrabbit-oak,PR-676,2,2,40,2,42
jackrabbit-oak,PR-651,8,4,478,15,493
jackrabbit-oak,PR-677,1,4,24,14,38
jackrabbit-oak,PR-678,2,9,168,2,170
jackrabbit-oak,PR-679,2,9,65,325,390
jackrabbit-oak,PR-649,14,26,651,103,754
jackrabbit-oak,PR-649,16,19,554,82,636
jackrabbit-oak,PR-295,15,62,569,444,1013
jackrabbit-oak,PR-682,1,6,78,3,81
jackrabbit-oak,PR-679,4,10,69,325,394
jackrabbit-oak,PR-690,1,18,1575,52,1627
jackrabbit-oak,PR-691,1,1,14,0,14
jackrabbit-oak,PR-693,1,6,50,22,72
jackrabbit-oak,PR-694,1,1,1,1,2
jackrabbit-oak,PR-693,2,6,50,22,72
jackrabbit-oak,PR-695,1,1,1,1,2
jackrabbit-oak,PR-696,1,2,79,2,81
jackrabbit-oak,PR-697,1,24,336,2670,3006
jackrabbit-oak,PR-698,1,9,293,44,337
jackrabbit-oak,PR-690,5,17,1503,51,1554
jackrabbit-oak,PR-295,17,62,586,422,1008
jackrabbit-oak,PR-698,2,9,293,44,337
jackrabbit-oak,PR-698,3,9,293,44,337
jackrabbit-oak,PR-697,2,12,2477,2318,4795
jackrabbit-oak,PR-703,1,1,1,1,2
jackrabbit-oak,PR-703,2,2,2,2,4
jackrabbit-oak,PR-704,1,2,126,27,153
jackrabbit-oak,PR-692,15,24,1124,641,1765
jackrabbit-oak,PR-704,2,2,127,27,154
jackrabbit-oak,PR-692,16,24,1125,641,1766
jackrabbit-oak,PR-692,18,24,1126,641,1767
jackrabbit-oak,PR-705,2,4,76,37,113
jackrabbit-oak,PR-706,1,1,2,0,2
jackrabbit-oak,PR-705,3,4,76,37,113
jackrabbit-oak,PR-692,19,24,1122,641,1763
jackrabbit-oak,PR-705,4,4,77,37,114
jackrabbit-oak,PR-692,20,24,1123,641,1764
jackrabbit-oak,PR-688,2,2,41,1,42
jackrabbit-oak,PR-295,18,62,586,422,1008
jackrabbit-oak,PR-694,2,1,1,1,2
jackrabbit-oak,PR-694,3,1,1,1,2
jackrabbit-oak,PR-692,21,24,1123,641,1764
jackrabbit-oak,PR-692,22,28,1274,671,1945
jackrabbit-oak,PR-692,23,28,1290,671,1961
jackrabbit-oak,PR-692,24,28,1290,671,1961
jackrabbit-oak,PR-707,1,4,317,148,465
jackrabbit-oak,PR-710,5,29,1431,715,2146
jackrabbit-oak,PR-710,6,29,1432,715,2147
jackrabbit-oak,PR-710,8,29,1430,715,2145
jackrabbit-oak,PR-710,9,29,1430,715,2145
jackrabbit-oak,PR-734,1,1,1,1,2
jackrabbit-oak,PR-710,10,44,2335,867,3202
jackrabbit-oak,PR-734,2,1,1,1,2
jackrabbit-oak,PR-747,1,1,0,5,5
jackrabbit-oak,PR-748,1,1,1,1,2
jackrabbit-oak,PR-748,2,2,2,1,3
jackrabbit-oak,PR-748,3,2,3,1,4
jackrabbit-oak,PR-749,1,2,11,1,12
jackrabbit-oak,PR-750,1,1,8,1,9
jackrabbit-oak,PR-751,1,1,1,0,1
jackrabbit-oak,PR-752,1,1,0,1,1
jackrabbit-oak,PR-751,2,2,6,6,12
jackrabbit-oak,PR-750,2,1,8,1,9
jackrabbit-oak,PR-751,3,3,7,6,13
jackrabbit-oak,PR-750,3,1,9,1,10
jackrabbit-oak,PR-753,1,1,65,1,66
jackrabbit-oak,PR-754,1,1,0,5,5
jackrabbit-oak,PR-755,1,1,1,1,2
jackrabbit-oak,PR-751,4,25,72,6,78
jackrabbit-oak,PR-753,2,1,69,1,70
jackrabbit-oak,PR-756,1,9,26,26,52
jackrabbit-oak,PR-751,5,25,72,6,78
jackrabbit-oak,PR-751,6,25,72,6,78
jackrabbit-oak,PR-757,1,1,1,1,2
jackrabbit-oak,PR-758,1,3,7,6,13
jackrabbit-oak,PR-759,1,4,4,4,8
jackrabbit-oak,PR-759,2,4,4,4,8
jackrabbit-oak,PR-759,3,5,5,5,10
jackrabbit-oak,PR-761,1,1,1,1,2
jackrabbit-oak,PR-762,1,2,38,0,38
jackrabbit-oak,PR-762,2,2,38,0,38
jackrabbit-oak,PR-763,1,1,3,1,4
jackrabbit-oak,PR-765,1,2,89,65,154
jackrabbit-oak,PR-766,1,2,89,64,153
jackrabbit-oak,PR-765,2,2,89,65,154
jackrabbit-oak,PR-766,2,2,89,64,153
jackrabbit-oak,PR-771,1,4,190,30,220
jackrabbit-oak,PR-772,1,1,2,1,3
jackrabbit-oak,PR-772,2,3,4,2,6
jackrabbit-oak,PR-772,3,2,2,1,3
jackrabbit-oak,PR-774,1,3,3,2,5
jackrabbit-oak,PR-775,1,18,62,62,124
jackrabbit-oak,PR-776,1,1,1,1,2
jackrabbit-oak,PR-771,2,4,190,30,220
jackrabbit-oak,PR-773,8,79,3637,1459,5096
jackrabbit-oak,PR-779,1,1,1,1,2
jackrabbit-oak,PR-780,1,1,1,1,2
jackrabbit-oak,PR-780,2,1,1,1,2
jackrabbit-oak,PR-782,1,1,1,1,2
jackrabbit-oak,PR-783,1,2,6,2,8
jackrabbit-oak,PR-783,2,1,5,0,5
jackrabbit-oak,PR-784,1,1,6,0,6
jackrabbit-oak,PR-785,1,3,12,10,22
jackrabbit-oak,PR-785,2,3,12,10,22
jackrabbit-oak,PR-786,1,1,16,0,16
jackrabbit-oak,PR-786,2,1,14,0,14
jackrabbit-oak,PR-787,1,1,9,6,15
jackrabbit-oak,PR-788,1,1,1,1,2
jackrabbit-oak,PR-789,1,1,6,2,8
jackrabbit-oak,PR-790,1,4,23,11,34
jackrabbit-oak,PR-791,1,1,6,2,8
jackrabbit-oak,PR-773,9,79,3697,1467,5164
jackrabbit-oak,PR-792,1,1,1,0,1
jackrabbit-oak,PR-710,12,44,2335,867,3202
jackrabbit-oak,PR-773,11,79,3688,1467,5155
jackrabbit-oak,PR-710,13,44,2335,867,3202
jackrabbit-oak,PR-793,1,1,2,1,3
jackrabbit-oak,PR-794,1,1,2,23,25
jackrabbit-oak,PR-795,1,2,25,2,27
jackrabbit-oak,PR-796,1,4,115,37,152
jackrabbit-oak,PR-794,3,2,5,49,54
jackrabbit-oak,PR-710,14,45,2336,873,3209
jackrabbit-oak,PR-773,12,79,3683,1467,5150
jackrabbit-oak,PR-773,14,79,3683,1467,5150
jackrabbit-oak,PR-797,1,1,5,0,5
jackrabbit-oak,PR-796,2,4,111,22,133
jackrabbit-oak,PR-796,3,4,104,21,125
jackrabbit-oak,PR-800,3,7,93,5,98
jackrabbit-oak,PR-795,2,2,54,2,56
jackrabbit-oak,PR-806,1,1,1,1,2
jackrabbit-oak,PR-773,15,81,3855,1531,5386
jackrabbit-oak,PR-773,16,81,3861,1531,5392
jackrabbit-oak,PR-808,1,5,9,55,64
jackrabbit-oak,PR-808,2,5,4,55,59
jackrabbit-oak,PR-773,17,83,3867,1537,5404
jackrabbit-oak,PR-809,1,1,8,0,8
jackrabbit-oak,PR-809,2,2,20,0,20
jackrabbit-oak,PR-808,3,5,4,55,59
jackrabbit-oak,PR-810,1,2,0,2,2
jackrabbit-oak,PR-811,1,1,1,1,2
jackrabbit-oak,PR-812,1,3,56,10,66
jackrabbit-oak,PR-796,6,4,97,14,111
jackrabbit-oak,PR-813,1,3,61,7,68
jackrabbit-oak,PR-812,2,4,58,12,70
jackrabbit-oak,PR-814,1,1,5,2,7
jackrabbit-oak,PR-813,2,3,61,7,68
jackrabbit-oak,PR-813,3,3,61,7,68
jackrabbit-oak,PR-812,3,4,186,18,204
jackrabbit-oak,PR-813,4,3,62,7,69
jackrabbit-oak,PR-812,4,4,186,18,204
jackrabbit-oak,PR-812,6,5,194,18,212
jackrabbit-oak,PR-816,1,2,2,2,4
jackrabbit-oak,PR-817,1,1,2,2,4
jackrabbit-oak,PR-818,1,4,1,6,7
jackrabbit-oak,PR-819,1,3,18,3,21
jackrabbit-oak,PR-820,1,2,21,2,23
jackrabbit-oak,PR-788,2,1,1,1,2
jackrabbit-oak,PR-809,3,2,20,0,20
jackrabbit-oak,PR-822,1,4,5,2,7
jackrabbit-oak,PR-822,2,5,6,3,9
jackrabbit-oak,PR-825,1,8,291,69,360
jackrabbit-oak,PR-800,4,8,87,4,91
jackrabbit-oak,PR-800,5,8,87,4,91
jackrabbit-oak,PR-800,6,8,87,4,91
jackrabbit-oak,PR-825,2,8,307,69,376
jackrabbit-oak,PR-826,1,5,241,68,309
jackrabbit-oak,PR-800,7,8,87,4,91
jackrabbit-oak,PR-800,8,8,87,4,91
jackrabbit-oak,PR-800,9,8,87,4,91
jackrabbit-oak,PR-826,2,5,238,67,305
jackrabbit-oak,PR-800,11,8,87,4,91
jackrabbit-oak,PR-800,12,8,87,4,91
jackrabbit-oak,PR-827,1,1,2,1,3
jackrabbit-oak,PR-832,1,1,4,2,6
jackrabbit-oak,PR-834,1,4,276,2,278
jackrabbit-oak,PR-835,1,1,7,8,15
jackrabbit-oak,PR-809,4,2,20,0,20
jackrabbit-oak,PR-809,5,2,20,0,20
jackrabbit-oak,PR-838,5,2,22,1,23
jackrabbit-oak,PR-840,1,1,2,1,3
jackrabbit-oak,PR-842,1,1,6,6,12
jackrabbit-oak,PR-843,1,8,7,182,189
jackrabbit-oak,PR-843,2,8,7,182,189
jackrabbit-oak,PR-844,1,1,44,0,44
jackrabbit-oak,PR-845,1,3,0,3,3
jackrabbit-oak,PR-846,1,1,5,5,10
jackrabbit-oak,PR-844,2,4,130,6,136
jackrabbit-oak,PR-844,3,4,130,6,136
jackrabbit-oak,PR-842,2,1,12,6,18
jackrabbit-oak,PR-848,1,2,23,5,28
jackrabbit-oak,PR-848,2,2,22,5,27
jackrabbit-oak,PR-849,1,1,22,0,22
jackrabbit-oak,PR-848,3,3,52,20,72
jackrabbit-oak,PR-850,1,1,1,1,2
jackrabbit-oak,PR-851,1,9,301,38,339
jackrabbit-oak,PR-851,2,9,301,38,339
jackrabbit-oak,PR-851,3,9,301,38,339
jackrabbit-oak,PR-851,4,9,270,38,308
jackrabbit-oak,PR-853,1,5,501,349,850
jackrabbit-oak,PR-853,2,5,501,349,850
jackrabbit-oak,PR-853,3,5,520,349,869
jackrabbit-oak,PR-853,4,5,520,349,869
jackrabbit-oak,PR-853,5,5,520,349,869
jackrabbit-oak,PR-855,1,2,203,27,230
jackrabbit-oak,PR-856,1,1,1,1,2
jackrabbit-oak,PR-857,1,1,1,1,2
jackrabbit-oak,PR-858,1,10,159,5,164
jackrabbit-oak,PR-859,1,1,4,1,5
jackrabbit-oak,PR-860,1,15,652,271,923
jackrabbit-oak,PR-860,2,15,660,271,931
jackrabbit-oak,PR-861,1,5,132,25,157
jackrabbit-oak,PR-862,1,11,172,20,192
jackrabbit-oak,PR-863,1,2,49,0,49
jackrabbit-oak,PR-864,1,1,1,1,2
jackrabbit-oak,PR-858,2,12,227,6,233
jackrabbit-oak,PR-858,3,12,286,6,292
jackrabbit-oak,PR-865,1,4,96,5,101
jackrabbit-oak,PR-866,1,4,103,19,122
jackrabbit-oak,PR-860,3,15,660,271,931
jackrabbit-oak,PR-860,4,15,657,271,928
jackrabbit-oak,PR-860,5,15,692,272,964
jackrabbit-oak,PR-867,1,1,5,4,9
jackrabbit-oak,PR-860,6,15,686,272,958
jackrabbit-oak,PR-860,7,16,690,273,963
jackrabbit-oak,PR-867,2,2,6,5,11
jackrabbit-oak,PR-847,20,31,1306,161,1467
jackrabbit-oak,PR-867,3,1,5,4,9
jackrabbit-oak,PR-847,21,31,1308,161,1469
jackrabbit-oak,PR-858,4,10,216,6,222
jackrabbit-oak,PR-847,22,32,1347,161,1508
jackrabbit-oak,PR-847,23,32,1347,161,1508
jackrabbit-oak,PR-847,24,32,1351,161,1512
jackrabbit-oak,PR-868,1,2,14,1,15
jackrabbit-oak,PR-869,1,19,268,69,337
jackrabbit-oak,PR-868,2,2,14,1,15
jackrabbit-oak,PR-868,3,2,14,1,15
jackrabbit-oak,PR-868,4,2,35,24,59
jackrabbit-oak,PR-847,25,33,1358,161,1519
jackrabbit-oak,PR-863,2,2,178,19,197
jackrabbit-oak,PR-847,26,33,1365,162,1527
jackrabbit-oak,PR-847,27,33,1364,161,1525
jackrabbit-oak,PR-868,5,2,35,24,59
jackrabbit-oak,PR-868,6,2,35,24,59
jackrabbit-oak,PR-870,1,3,34,22,56
jackrabbit-oak,PR-870,2,3,34,22,56
jackrabbit-oak,PR-868,7,2,37,27,64
jackrabbit-oak,PR-847,28,32,1347,161,1508
jackrabbit-oak,PR-847,29,32,1347,161,1508
jackrabbit-oak,PR-858,5,10,204,6,210
jackrabbit-oak,PR-871,1,1,12,3,15
jackrabbit-oak,PR-871,2,1,12,3,15
jackrabbit-oak,PR-872,1,18,1358,1346,2704
jackrabbit-oak,PR-872,2,18,1359,1346,2705
jackrabbit-oak,PR-872,3,18,1359,1346,2705
jackrabbit-oak,PR-873,1,4,106,161,267
jackrabbit-oak,PR-871,3,1,16,3,19
jackrabbit-oak,PR-874,1,3,161,0,161
jackrabbit-oak,PR-875,1,1,61,0,61
jackrabbit-oak,PR-876,1,1,1,1,2
jackrabbit-oak,PR-877,2,28,311,64,375
jackrabbit-oak,PR-877,3,29,313,65,378
jackrabbit-oak,PR-877,4,30,314,65,379
jackrabbit-oak,PR-877,5,28,311,62,373
jackrabbit-oak,PR-877,6,28,311,62,373
jackrabbit-oak,PR-877,7,28,333,62,395
jackrabbit-oak,PR-877,8,27,244,62,306
jackrabbit-oak,PR-874,2,5,264,0,264
jackrabbit-oak,PR-877,9,27,244,62,306
jackrabbit-oak,PR-877,10,27,244,62,306
jackrabbit-oak,PR-877,11,27,244,62,306
jackrabbit-oak,PR-878,1,4,174,0,174
jackrabbit-oak,PR-878,2,4,174,0,174
jackrabbit-oak,PR-878,3,3,149,0,149
jackrabbit-oak,PR-878,4,3,149,0,149
jackrabbit-oak,PR-880,1,3,410,18,428
jackrabbit-oak,PR-881,1,6,149,35,184
jackrabbit-oak,PR-881,2,6,153,36,189
jackrabbit-oak,PR-881,3,6,153,36,189
jackrabbit-oak,PR-882,1,2,119,0,119
jackrabbit-oak,PR-883,1,1,1,1,2
jackrabbit-oak,PR-884,1,3,55,26,81
jackrabbit-oak,PR-883,2,1,1,1,2
jackrabbit-oak,PR-885,1,3,19,17,36
jackrabbit-oak,PR-886,1,3,136,20,156
jackrabbit-oak,PR-880,2,3,421,12,433
jackrabbit-oak,PR-884,2,3,55,25,80
jackrabbit-oak,PR-884,3,3,57,25,82
jackrabbit-oak,PR-880,3,4,453,12,465
jackrabbit-oak,PR-886,2,3,148,24,172
jackrabbit-oak,PR-887,1,2,2,0,2
jackrabbit-oak,PR-889,1,18,94,94,188
jackrabbit-oak,PR-886,3,3,148,24,172
jackrabbit-oak,PR-886,4,3,148,24,172
jackrabbit-oak,PR-890,1,72,311,316,627
jackrabbit-oak,PR-890,2,72,311,316,627
jackrabbit-oak,PR-890,3,72,311,316,627
jackrabbit-oak,PR-892,1,2,45,3,48
jackrabbit-oak,PR-893,1,2,14,13,27
jackrabbit-oak,PR-894,1,4,200,125,325
jackrabbit-oak,PR-894,2,5,272,125,397
jackrabbit-oak,PR-894,3,5,272,125,397
jackrabbit-oak,PR-895,1,15,749,57,806
jackrabbit-oak,PR-890,4,72,311,316,627
jackrabbit-oak,PR-890,5,72,309,316,625
jackrabbit-oak,PR-892,2,2,52,3,55
jackrabbit-oak,PR-890,6,76,326,331,657
jackrabbit-oak,PR-896,1,69,153,153,306
jackrabbit-oak,PR-895,2,19,819,57,876
jackrabbit-oak,PR-937,1,3,142,0,142
jackrabbit-oak,PR-937,2,8,191,10,201
jackrabbit-oak,PR-946,1,7,54,3,57
jackrabbit-oak,PR-937,3,8,194,10,204
jackrabbit-oak,PR-948,1,51,152,46,198
jackrabbit-oak,PR-920,4,16,483,38,521
jackrabbit-oak,PR-950,1,1,813,0,813
jackrabbit-oak,PR-946,2,7,55,3,58
jackrabbit-oak,PR-950,2,1,816,0,816
jackrabbit-oak,PR-950,3,1,816,0,816
jackrabbit-oak,PR-950,4,1,815,0,815
jackrabbit-oak,PR-950,5,1,816,0,816
jackrabbit-oak,PR-951,1,1,19,13,32
jackrabbit-oak,PR-953,1,3,21,3,24
jackrabbit-oak,PR-953,2,2,17,1,18
jackrabbit-oak,PR-954,1,4,112,8,120
jackrabbit-oak,PR-955,1,1,19,4,23
jackrabbit-oak,PR-954,2,5,206,8,214
jackrabbit-oak,PR-955,2,1,19,4,23
jackrabbit-oak,PR-955,3,1,22,4,26
jackrabbit-oak,PR-920,5,18,561,39,600
jackrabbit-oak,PR-920,7,18,560,39,599
jackrabbit-oak,PR-920,8,19,605,42,647
jackrabbit-oak,PR-920,9,19,604,42,646
jackrabbit-oak,PR-920,11,19,612,43,655
jackrabbit-oak,PR-920,12,19,612,43,655
jackrabbit-oak,PR-948,2,51,152,46,198
jackrabbit-oak,PR-937,4,8,194,10,204
jackrabbit-oak,PR-920,13,20,621,43,664
jackrabbit-oak,PR-956,1,24,832,62,894
jackrabbit-oak,PR-956,2,24,837,62,899
jackrabbit-oak,PR-957,1,17,805,134,939
jackrabbit-oak,PR-958,1,2,7,0,7
jackrabbit-oak,PR-957,2,17,821,134,955
jackrabbit-oak,PR-957,3,17,821,134,955
jackrabbit-oak,PR-956,3,24,837,62,899
jackrabbit-oak,PR-958,2,3,22,2,24
jackrabbit-oak,PR-960,1,4,104,4,108
jackrabbit-oak,PR-961,1,2,43,16,59
jackrabbit-oak,PR-962,1,8,599,26,625
jackrabbit-oak,PR-962,2,8,599,26,625
jackrabbit-oak,PR-962,3,9,735,26,761
jackrabbit-oak,PR-962,4,9,735,26,761
jackrabbit-oak,PR-960,2,4,115,9,124
jackrabbit-oak,PR-963,1,2,60,0,60
jackrabbit-oak,PR-962,5,9,735,26,761
jackrabbit-oak,PR-964,1,5,171,16,187
jackrabbit-oak,PR-964,2,6,172,17,189
jackrabbit-oak,PR-965,1,51,109,109,218
jackrabbit-oak,PR-966,1,1,0,17,17
jackrabbit-oak,PR-965,2,51,109,109,218
jackrabbit-oak,PR-967,1,4,8,8,16
jackrabbit-oak,PR-960,3,6,208,47,255
jackrabbit-oak,PR-960,4,6,211,47,258
jackrabbit-oak,PR-960,5,6,207,49,256
jackrabbit-oak,PR-960,6,6,207,49,256
jackrabbit-oak,PR-960,7,6,209,49,258
jackrabbit-oak,PR-960,8,6,211,49,260
jackrabbit-oak,PR-968,1,20,37,37,74
jackrabbit-oak,PR-969,1,27,101,233,334
jackrabbit-oak,PR-970,1,2,4,4,8
jackrabbit-oak,PR-969,2,27,101,233,334
jackrabbit-oak,PR-962,6,10,747,27,774
jackrabbit-oak,PR-971,1,3,120,3,123
jackrabbit-oak,PR-969,3,27,101,233,334
jackrabbit-oak,PR-973,1,11,30,30,60
jackrabbit-oak,PR-975,1,2,9,5,14
jackrabbit-oak,PR-976,1,3,3,3,6
jackrabbit-oak,PR-962,7,10,792,27,819
jackrabbit-oak,PR-975,2,2,9,5,14
jackrabbit-oak,PR-977,1,1,1,1,2
jackrabbit-oak,PR-978,1,1,1,1,2
jackrabbit-oak,PR-980,1,1,2,2,4
jackrabbit-oak,PR-944,1,9,10,496,506
jackrabbit-oak,PR-981,1,1,1,1,2
jackrabbit-oak,PR-983,1,1,2,2,4
jackrabbit-oak,PR-974,1,1,8,2,10
jackrabbit-oak,PR-984,1,1,2,0,2
jackrabbit-oak,PR-984,2,2,12,0,12
jackrabbit-oak,PR-985,1,1,1,2,3
jackrabbit-oak,PR-986,1,5,11,17,28
jackrabbit-oak,PR-988,1,3,49,8,57
jackrabbit-oak,PR-989,1,1,0,1,1
jackrabbit-oak,PR-989,2,1,0,1,1
jackrabbit-oak,PR-990,1,2,8,1,9
jackrabbit-oak,PR-989,3,2,1,1,2
jackrabbit-oak,PR-991,1,5,54,6,60
jackrabbit-oak,PR-992,1,1,1,1,2
jackrabbit-oak,PR-992,2,1,1,1,2
jackrabbit-oak,PR-956,4,26,1093,112,1205
jackrabbit-oak,PR-956,5,26,1092,111,1203
jackrabbit-oak,PR-960,9,6,211,49,260
jackrabbit-oak,PR-960,10,7,213,49,262
jackrabbit-oak,PR-994,1,2,12,2,14
jackrabbit-oak,PR-995,1,6,969,7,976
jackrabbit-oak,PR-996,1,3,101,1,102
jackrabbit-oak,PR-997,1,1,1,0,1
jackrabbit-oak,PR-998,1,1,1,1,2
jackrabbit-oak,PR-999,1,1,1,1,2
jackrabbit-oak,PR-1000,1,2,55,10,65
jackrabbit-oak,PR-1000,2,2,54,10,64
jackrabbit-oak,PR-1001,1,1,2,2,4
jackrabbit-oak,PR-1002,1,2,26,0,26
jackrabbit-oak,PR-1002,2,2,46,26,72
jackrabbit-oak,PR-1003,1,2,78,0,78
jackrabbit-oak,PR-1003,2,2,79,0,79
jackrabbit-oak,PR-1003,3,2,78,0,78
jackrabbit-oak,PR-1002,3,2,48,26,74
jackrabbit-oak,PR-995,2,6,1003,7,1010
jackrabbit-oak,PR-1004,1,1,7,7,14
jackrabbit-oak,PR-1005,1,1,1,0,1
jackrabbit-oak,PR-1005,2,1,1,0,1
jackrabbit-oak,PR-1006,1,3,43,6,49
jackrabbit-oak,PR-995,3,6,1003,7,1010
jackrabbit-oak,PR-1007,1,7,213,49,262
jackrabbit-oak,PR-995,4,6,1015,7,1022
jackrabbit-oak,PR-1003,4,2,77,0,77
jackrabbit-oak,PR-1008,1,1,5,0,5
jackrabbit-oak,PR-1009,1,1,5,0,5
jackrabbit-oak,PR-995,5,6,1015,7,1022
jackrabbit-oak,PR-993,11,36,1944,164,2108
jackrabbit-oak,PR-993,12,26,1720,115,1835
jackrabbit-oak,PR-1003,5,2,80,0,80
jackrabbit-oak,PR-993,13,26,1775,115,1890
jackrabbit-oak,PR-979,19,41,2809,146,2955
jackrabbit-oak,PR-979,20,42,2845,153,2998
jackrabbit-oak,PR-979,21,42,2845,153,2998
jackrabbit-oak,PR-979,22,42,2844,153,2997
jackrabbit-oak,PR-979,23,41,2833,145,2978
jackrabbit-oak,PR-979,24,41,2833,145,2978
jackrabbit-oak,PR-991,2,5,53,6,59
jackrabbit-oak,PR-1010,1,1,3,1,4
jackrabbit-oak,PR-979,25,41,2888,145,3033
jackrabbit-oak,PR-979,26,41,2894,145,3039
jackrabbit-oak,PR-979,27,42,3000,145,3145
jackrabbit-oak,PR-979,28,42,3022,145,3167
jackrabbit-oak,PR-1010,2,1,5,2,7
jackrabbit-oak,PR-1012,1,4,30,9,39
jackrabbit-oak,PR-1011,1,2,52,0,52
jackrabbit-oak,PR-1013,1,1,32,0,32
jackrabbit-oak,PR-1013,2,2,41,9,50
jackrabbit-oak,PR-1014,1,1,20,7,27
jackrabbit-oak,PR-1014,2,3,26,15,41
jackrabbit-oak,PR-1016,1,1,6,13,19
jackrabbit-oak,PR-1017,1,2,38,3,41
jackrabbit-oak,PR-1018,1,6,8,8,16
jackrabbit-oak,PR-1018,2,7,11,10,21
jackrabbit-oak,PR-1019,1,1,1,1,2
jackrabbit-oak,PR-1020,1,6,227,16,243
jackrabbit-oak,PR-1017,2,2,59,3,62
jackrabbit-oak,PR-1007,2,7,213,49,262
jackrabbit-oak,PR-1014,4,2,19,8,27
jackrabbit-oak,PR-1015,1,40,137,208,345
jackrabbit-oak,PR-1013,3,2,34,2,36
jackrabbit-oak,PR-1020,2,11,855,13,868
jackrabbit-oak,PR-1020,3,15,1533,13,1546
jackrabbit-oak,PR-1013,4,2,51,2,53
jackrabbit-oak,PR-1013,5,2,58,2,60
jackrabbit-oak,PR-993,14,89,6186,323,6509
jackrabbit-oak,PR-1022,1,1,1,1,2
jackrabbit-oak,PR-1023,1,1,1,1,2
jackrabbit-oak,PR-1024,1,1,10,0,10
jackrabbit-oak,PR-1024,2,1,11,0,11
jackrabbit-oak,PR-1024,3,1,21,0,21
jackrabbit-oak,PR-1021,6,2,93,1,94
jackrabbit-oak,PR-1021,7,2,93,1,94
jackrabbit-oak,PR-1021,8,4,99,3,102
jackrabbit-oak,PR-993,15,27,1981,134,2115
jackrabbit-oak,PR-1020,4,15,1544,13,1557
jackrabbit-oak,PR-1020,5,15,1554,13,1567
jackrabbit-oak,PR-1020,6,15,1556,13,1569
jackrabbit-oak,PR-1027,1,1,1,1,2
jackrabbit-oak,PR-1028,1,1,2,2,4
jackrabbit-oak,PR-993,16,26,1980,133,2113
jackrabbit-oak,PR-1029,1,3,76,67,143
jackrabbit-oak,PR-1029,2,3,79,67,146
jackrabbit-oak,PR-1017,3,2,59,3,62
jackrabbit-oak,PR-1031,1,3,69,3,72
jackrabbit-oak,PR-1032,1,4,29,22,51
jackrabbit-oak,PR-1032,2,4,30,23,53
jackrabbit-oak,PR-1021,9,4,108,3,111
jackrabbit-oak,PR-1021,11,5,114,4,118
jackrabbit-oak,PR-1021,12,5,120,4,124
jackrabbit-oak,PR-1021,13,5,120,4,124
jackrabbit-oak,PR-1029,3,3,79,67,146
jackrabbit-oak,PR-1033,1,1,1,0,1
jackrabbit-oak,PR-993,17,26,1986,133,2119
jackrabbit-oak,PR-993,18,26,1986,133,2119
jackrabbit-oak,PR-1034,1,2,162,59,221
jackrabbit-oak,PR-1035,1,5,66,1,67
jackrabbit-oak,PR-1035,2,5,69,4,73
jackrabbit-oak,PR-982,2,6,2,154,156
jackrabbit-oak,PR-998,2,1,1,1,2
jackrabbit-oak,PR-999,2,1,1,1,2
jackrabbit-oak,PR-1034,2,2,227,59,286
jackrabbit-oak,PR-1036,1,1,1,1,2
jackrabbit-oak,PR-1037,1,12,9,209,218
jackrabbit-oak,PR-1038,2,22,22,152,174
jackrabbit-oak,PR-1015,2,41,144,220,364
jackrabbit-oak,PR-1015,3,41,144,220,364
jackrabbit-oak,PR-1040,1,3,6,0,6
jackrabbit-oak,PR-1015,4,41,144,220,364
jackrabbit-oak,PR-1015,5,43,153,223,376
jackrabbit-oak,PR-1015,6,43,155,224,379
jackrabbit-oak,PR-993,19,82,2342,722,3064
jackrabbit-oak,PR-1015,7,43,155,224,379
jackrabbit-oak,PR-1015,8,43,155,224,379
jackrabbit-oak,PR-993,20,26,1996,133,2129
james,PR-234,1,56,8115,19,8134
james,PR-205,1,11,412,3,415
james,PR-552,1,3,57,0,57
james,PR-552,2,3,57,0,57
james,PR-552,3,3,57,0,57
james,PR-552,5,3,57,0,57
james,PR-552,10,3,57,0,57
james,PR-552,15,3,57,0,57
james,PR-552,16,3,57,0,57
james,PR-552,17,3,57,0,57
james,PR-552,19,3,57,0,57
james,PR-552,20,3,57,0,57
james,PR-552,21,3,57,0,57
james,PR-552,27,3,57,0,57
james,PR-661,1,85,26,6439,6465
james,PR-661,2,85,26,6439,6465
james,PR-661,3,85,26,6433,6459
james,PR-685,1,2,39,2,41
james,PR-685,2,2,39,2,41
james,PR-685,3,2,39,2,41
james,PR-685,4,3,70,5,75
james,PR-661,4,85,26,6433,6459
james,PR-685,5,3,68,3,71
james,PR-661,5,85,26,6433,6459
james,PR-923,1,300,560,549,1109
james,PR-923,2,300,560,549,1109
james,PR-939,1,300,560,549,1109
james,PR-939,4,300,560,549,1109
james,PR-940,1,1,4,2,6
james,PR-939,5,300,560,549,1109
james,PR-940,2,3,14,0,14
james,PR-940,3,9,33,5,38
james,PR-940,4,9,33,5,38
james,PR-940,5,10,36,5,41
james,PR-940,6,11,39,5,44
james,PR-940,8,11,39,5,44
james,PR-940,9,11,39,5,44
james,PR-940,10,12,42,5,47
james,PR-940,11,12,42,5,47
james,PR-940,12,12,42,5,47
james,PR-940,13,12,42,5,47
james,PR-984,1,5,5,5,10
james,PR-988,1,14,221,658,879
james,PR-988,2,21,298,665,963
james,PR-988,3,23,311,675,986
james,PR-988,4,23,311,675,986
james,PR-988,5,23,311,675,986
james,PR-988,6,23,311,675,986
james,PR-988,7,23,311,675,986
james,PR-988,8,23,311,675,986
james,PR-1065,1,5,0,0,0
james,PR-1065,2,6,28,0,28
james,PR-1065,3,6,28,0,28
james,PR-1065,4,6,28,0,28
james,PR-1065,5,6,28,0,28
james,PR-1065,6,6,28,0,28
james,PR-1065,7,6,28,0,28
james,PR-1062,2,28,830,108,938
james,PR-1049,20,35,237,199,436
james,PR-1065,8,6,28,0,28
james,PR-1067,1,6,24,0,24
james,PR-1062,3,31,870,110,980
james,PR-1065,9,6,28,0,28
james,PR-1049,21,35,237,199,436
james,PR-1065,10,6,28,0,28
james,PR-1067,2,6,24,0,24
james,PR-1049,22,35,237,199,436
james,PR-1065,11,6,28,0,28
james,PR-1065,12,6,28,0,28
james,PR-1049,23,35,237,199,436
james,PR-1069,1,3,340,20,360
james,PR-1070,1,6,12,8,20
james,PR-1069,2,3,337,20,357
james,PR-1049,24,35,237,199,436
james,PR-1065,13,6,28,0,28
james,PR-1070,2,6,12,8,20
james,PR-1049,25,35,237,199,436
james,PR-1065,14,6,28,0,28
james,PR-1069,3,3,337,20,357
james,PR-1070,3,6,12,8,20
james,PR-1062,4,64,1096,305,1401
james,PR-1049,26,33,226,195,421
james,PR-1070,4,6,12,8,20
james,PR-1071,1,1,2,2,4
james,PR-1069,4,3,337,20,357
james,PR-1062,5,64,1096,305,1401
james,PR-1049,27,33,226,195,421
james,PR-1070,5,6,12,8,20
james,PR-1071,2,1,2,2,4
james,PR-1062,6,64,1096,305,1401
james,PR-1071,3,1,2,2,4
james,PR-1049,28,33,226,195,421
james,PR-1069,5,3,337,20,357
james,PR-1071,4,1,2,2,4
james,PR-1070,6,6,12,8,20
james,PR-1067,3,6,24,0,24
james,PR-1062,7,64,1096,305,1401
james,PR-988,9,23,311,675,986
james,PR-552,29,3,57,0,57
james,PR-205,2,11,412,3,415
james,PR-1065,17,10,110,2,112
james,PR-1049,29,33,226,195,421
james,PR-1049,30,33,226,195,421
james,PR-1062,8,64,1096,305,1401
james,PR-1065,18,10,110,2,112
james,PR-1070,7,6,12,8,20
james,PR-1071,5,1,2,2,4
james,PR-1071,6,24,92,117,209
james,PR-1072,1,2,36,17,53
james,PR-1071,8,24,91,117,208
james,PR-1073,1,10,118,6,124
james,PR-1074,1,1,9,18,27
james,PR-1065,19,10,110,2,112
james,PR-1049,31,33,226,195,421
james,PR-1062,9,64,1096,305,1401
james,PR-1070,8,6,12,8,20
james,PR-1073,2,10,118,6,124
james,PR-1074,2,1,9,18,27
james,PR-1065,20,10,110,2,112
james,PR-1049,32,33,226,195,421
james,PR-1062,10,64,1096,305,1401
james,PR-1070,9,6,12,8,20
james,PR-1073,3,10,118,6,124
james,PR-1073,4,9,98,6,104
james,PR-1049,33,33,226,195,421
james,PR-1049,34,33,226,195,421
james,PR-1075,1,1,1,1,2
james,PR-1049,35,33,226,195,421
james,PR-1062,11,64,1096,305,1401
james,PR-1049,36,33,226,195,421
james,PR-1075,2,2,8,5,13
james,PR-1076,1,169,2612,2447,5059
james,PR-1076,4,169,2616,2450,5066
james,PR-1077,1,1,4,3,7
james,PR-1078,1,160,660,946,1606
james,PR-1076,5,169,2615,2449,5064
james,PR-1077,2,1,5,3,8
james,PR-1076,6,169,2640,2450,5090
james,PR-1076,7,169,2641,2451,5092
james,PR-1076,8,169,2642,2451,5093
james,PR-1076,9,169,2616,2450,5066
james,PR-1077,3,1,6,3,9
james,PR-1049,37,33,226,195,421
james,PR-1062,12,64,1096,305,1401
james,PR-1049,38,33,226,195,421
james,PR-1076,10,169,2617,2451,5068
james,PR-1077,4,1,6,3,9
james,PR-1076,11,169,2617,2451,5068
james,PR-1079,1,1,1,1,2
james,PR-1049,39,33,226,195,421
james,PR-1079,2,1,1,1,2
james,PR-1049,40,33,214,188,402
james,PR-1062,13,64,1096,305,1401
james,PR-1070,10,6,12,8,20
james,PR-1077,5,1,2,2,4
james,PR-1077,6,1,2,2,4
james,PR-1077,7,1,2,2,4
james,PR-1077,8,1,2,2,4
james,PR-1077,9,1,2,2,4
james,PR-1049,41,33,215,189,404
james,PR-1077,11,2,6,5,11
james,PR-1082,1,1,20,6,26
james,PR-1077,12,2,7,5,12
james,PR-1077,13,44,78,76,154
james,PR-1049,42,33,215,189,404
james,PR-1078,3,162,716,1005,1721
james,PR-1075,3,3,118,5,123
james,PR-1077,14,35,40,38,78
james,PR-1078,4,162,718,1007,1725
james,PR-1049,43,33,215,189,404
james,PR-1062,14,64,1096,305,1401
james,PR-1078,5,162,718,1007,1725
james,PR-1083,1,2,36,17,53
james,PR-1084,1,7,278,0,278
james,PR-1077,15,42,47,45,92
james,PR-1078,6,162,718,1007,1725
james,PR-1083,2,2,36,17,53
james,PR-1077,16,42,47,45,92
james,PR-1084,2,7,278,0,278
james,PR-1077,17,42,47,45,92
james,PR-1049,44,33,215,189,404
james,PR-1077,19,42,62,45,107
james,PR-1077,20,42,70,45,115
james,PR-1077,21,43,84,45,129
james,PR-1078,7,162,718,1007,1725
james,PR-1077,22,44,87,45,132
james,PR-1084,3,7,278,0,278
james,PR-1084,4,7,278,0,278
james,PR-1077,23,44,85,45,130
james,PR-1077,24,44,86,45,131
james,PR-1085,1,3,65,11,76
james,PR-1077,25,44,86,45,131
james,PR-1076,12,169,2612,2447,5059
james,PR-1085,2,3,65,11,76
james,PR-1077,26,46,91,45,136
james,PR-1077,27,47,94,45,139
james,PR-1077,28,47,92,45,137
james,PR-1084,5,7,278,0,278
james,PR-1049,45,33,215,189,404
james,PR-1084,6,7,278,0,278
james,PR-1086,1,2,98,1,99
james,PR-1084,7,7,278,0,278
james,PR-1086,2,2,98,1,99
james,PR-1087,2,2,60,11,71
james,PR-1087,3,2,60,11,71
james,PR-1086,3,2,98,1,99
james,PR-1062,15,64,1096,305,1401
james,PR-1049,46,33,215,189,404
james,PR-1049,47,33,215,189,404
james,PR-1062,16,64,1096,305,1401
james,PR-1086,4,2,98,1,99
james,PR-1088,1,8,449,1,450
james,PR-1049,48,33,215,189,404
james,PR-1062,17,64,1096,305,1401
james,PR-1088,2,14,979,1,980
james,PR-1088,3,14,979,1,980
james,PR-1088,4,14,979,1,980
james,PR-1089,1,2,25,5,30
james,PR-1090,1,1,1,1,2
james,PR-1089,2,2,25,5,30
james,PR-1091,1,1,1,1,2
james,PR-1088,5,15,1223,1,1224
james,PR-1092,1,20,1631,1,1632
james,PR-1049,49,33,215,189,404
james,PR-1091,2,1,1,1,2
james,PR-1062,18,64,1096,305,1401
james,PR-1088,6,15,1224,1,1225
james,PR-1062,19,31,870,110,980
james,PR-1088,7,15,1218,1,1219
james,PR-1094,1,1,3,6,9
james,PR-1088,8,15,1219,1,1220
james,PR-1062,20,33,882,113,995
james,PR-1093,2,22,1912,3,1915
james,PR-1094,2,1,3,6,9
james,PR-1088,9,15,1219,1,1220
james,PR-1093,3,22,1912,3,1915
james,PR-1088,10,15,1219,1,1220
james,PR-1092,2,13,1621,1,1622
james,PR-1095,2,4,595,0,595
james,PR-1093,4,8,690,4,694
james,PR-1092,3,13,1621,1,1622
james,PR-1096,1,3,0,3,3
james,PR-1096,2,3,0,3,3
james,PR-1097,1,1,7,2,9
james,PR-1093,5,9,719,4,723
james,PR-1098,1,19,2827,1,2828
james,PR-1096,3,3,0,3,3
james,PR-1093,6,9,719,4,723
james,PR-1099,1,3,141,23,164
james,PR-1100,1,3,39,95,134
james,PR-1101,1,1,47,0,47
james,PR-1078,8,160,660,946,1606
james,PR-1095,3,6,564,100,664
james,PR-1093,7,10,393,103,496
james,PR-1078,9,163,732,1001,1733
james,PR-1092,4,15,1718,95,1813
james,PR-1093,8,10,393,103,496
james,PR-1093,9,10,326,99,425
james,PR-1102,1,29,2774,100,2874
james,PR-1099,2,3,141,23,164
james,PR-1103,1,1,1,1,2
james,PR-1095,4,3,525,5,530
james,PR-1078,10,163,732,1001,1733
james,PR-1092,5,13,1678,1,1679
james,PR-1093,10,7,287,4,291
james,PR-1102,2,27,2729,6,2735
james,PR-1078,11,163,733,1002,1735
james,PR-1098,2,19,2984,1,2985
james,PR-1092,6,13,1678,1,1679
james,PR-1098,3,19,2984,1,2985
james,PR-1092,7,13,1678,1,1679
james,PR-1078,12,163,733,1002,1735
james,PR-1092,8,13,1678,1,1679
james,PR-1093,11,7,287,4,291
james,PR-1099,3,3,141,23,164
james,PR-1103,2,1,1,1,2
james,PR-1102,4,28,2734,6,2740
james,PR-1076,13,169,2612,2447,5059
james,PR-1078,13,163,733,1002,1735
james,PR-1061,56,169,2564,2585,5149
james,PR-1104,1,11,202,12,214
james,PR-1099,4,3,141,23,164
james,PR-1103,3,1,1,1,2
james,PR-1093,12,7,287,4,291
james,PR-1092,9,13,1678,1,1679
james,PR-1076,14,169,2612,2447,5059
james,PR-1061,57,169,2564,2585,5149
james,PR-1103,4,1,1,1,2
james,PR-1102,5,28,2734,6,2740
james,PR-1099,5,3,141,23,164
james,PR-1105,1,3,141,0,141
james,PR-1092,10,13,1678,1,1679
james,PR-1093,13,7,287,4,291
james,PR-1099,6,3,141,23,164
james,PR-1102,6,50,4734,16,4750
james,PR-1104,2,10,176,10,186
james,PR-1061,58,55,1635,1387,3022
james,PR-1105,2,3,141,0,141
james,PR-1093,14,7,287,4,291
james,PR-1104,3,12,210,14,224
james,PR-1092,11,13,1678,1,1679
james,PR-1093,15,7,287,4,291
james,PR-1099,7,3,141,23,164
james,PR-1061,59,55,1635,1387,3022
james,PR-1099,8,3,141,23,164
james,PR-1106,1,7,404,4,408
james,PR-1107,1,2,4,4,8
james,PR-1106,2,7,405,4,409
james,PR-1102,7,50,4734,16,4750
james,PR-1099,9,3,141,23,164
james,PR-1106,3,7,405,4,409
james,PR-1061,60,55,1635,1387,3022
james,PR-1093,16,7,287,4,291
james,PR-1104,4,12,213,14,227
james,PR-1109,1,239,1753,1993,3746
james,PR-1093,17,7,300,4,304
james,PR-1102,8,50,4749,16,4765
james,PR-1104,5,12,213,14,227
james,PR-1106,4,7,405,4,409
james,PR-1099,10,3,141,23,164
james,PR-1110,1,257,1877,2123,4000
james,PR-1108,2,62,903,914,1817
james,PR-1108,3,64,910,917,1827
james,PR-1111,1,1,65,2,67
james,PR-1099,11,3,141,23,164
james,PR-1109,2,239,1753,1993,3746
james,PR-1110,2,257,1877,2123,4000
james,PR-1108,4,64,910,917,1827
james,PR-1106,5,7,405,4,409
james,PR-1104,6,12,213,14,227
james,PR-1102,9,50,4749,16,4765
james,PR-1111,2,1,65,2,67
james,PR-1107,2,3,28,4,32
james,PR-1098,4,11,1332,26,1358
james,PR-1109,3,239,1753,1992,3745
james,PR-1106,6,7,418,4,422
james,PR-1110,3,257,1878,2123,4001
james,PR-1093,18,7,301,5,306
james,PR-1104,7,12,213,14,227
james,PR-1095,8,3,493,1,494
james,PR-1112,1,6,63,33,96
james,PR-1111,3,4,140,3,143
james,PR-1108,5,85,963,3601,4564
james,PR-1102,10,46,3170,67,3237
james,PR-1113,1,5,126,10,136
james,PR-1114,1,2,8,2,10
james,PR-1113,2,5,127,10,137
james,PR-1111,4,4,147,11,158
james,PR-1114,2,2,8,2,10
james,PR-1112,2,6,63,33,96
james,PR-1110,4,257,1878,2123,4001
james,PR-1107,3,3,28,4,32
james,PR-1099,12,3,141,23,164
james,PR-1109,4,239,1745,2154,3899
james,PR-1106,7,3,121,3,124
james,PR-1102,11,26,2164,48,2212
james,PR-1108,6,85,960,3602,4562
james,PR-1109,5,239,1745,2154,3899
james,PR-1110,5,257,1878,2123,4001
james,PR-1114,3,2,8,2,10
james,PR-1098,5,11,1332,26,1358
james,PR-1106,8,3,121,3,124
james,PR-1107,4,3,28,4,32
james,PR-1112,3,1,13,13,26
james,PR-1115,1,1,66,0,66
james,PR-1099,13,3,139,22,161
james,PR-1112,4,5,28,14,42
james,PR-1115,2,1,67,0,67
james,PR-1116,1,2,51,50,101
james,PR-1111,5,5,155,11,166
james,PR-1117,1,1,1,1,2
james,PR-1109,6,239,1749,2154,3903
james,PR-1119,1,11,215,2,217
james,PR-1120,1,1,65,0,65
james,PR-1118,2,17,27,149,176
james,PR-1115,3,1,67,0,67
james,PR-1108,7,85,959,3601,4560
james,PR-1119,2,13,265,2,267
james,PR-1111,6,2,92,3,95
james,PR-1121,1,1,8,5,13
james,PR-1122,1,1,5,4,9
james,PR-1121,2,1,8,5,13
james,PR-1121,3,1,8,5,13
james,PR-1112,5,5,28,14,42
james,PR-1114,4,2,8,2,10
james,PR-1098,6,11,1332,26,1358
james,PR-1116,2,2,51,50,101
james,PR-1115,4,1,67,0,67
james,PR-1119,3,13,265,2,267
james,PR-1111,7,2,92,3,95
james,PR-1099,14,3,139,22,161
james,PR-1112,6,5,28,14,42
james,PR-1121,4,1,8,5,13
james,PR-1099,15,3,139,22,161
james,PR-1102,12,26,2164,48,2212
james,PR-1106,9,3,121,3,124
james,PR-1107,5,3,28,4,32
james,PR-1109,7,239,1749,2154,3903
james,PR-1110,6,257,1878,2123,4001
james,PR-1111,8,2,92,3,95
james,PR-1112,7,5,28,14,42
james,PR-1114,5,2,8,2,10
james,PR-1119,4,13,265,2,267
james,PR-1121,5,1,8,5,13
james,PR-1108,8,85,959,3601,4560
james,PR-1118,3,17,27,166,193
james,PR-1123,1,1,2,2,4
james,PR-1111,9,2,92,3,95
james,PR-1099,16,3,139,22,161
james,PR-1112,8,5,28,14,42
james,PR-1119,5,13,265,2,267
james,PR-1121,6,1,8,5,13
james,PR-1118,4,17,27,166,193
james,PR-1098,7,11,1332,26,1358
james,PR-1110,7,257,1878,2123,4001
james,PR-1124,1,1,4,1,5
james,PR-1125,1,2,10,4,14
james,PR-1108,9,85,959,3601,4560
james,PR-1109,8,239,1749,2154,3903
james,PR-1126,1,13,495,5,500
james,PR-1127,1,29,225,225,450
james,PR-1099,17,3,139,22,161
james,PR-1124,2,1,4,1,5
james,PR-1125,2,2,10,4,14
james,PR-1121,7,1,8,5,13
james,PR-1119,6,13,265,2,267
james,PR-1118,5,17,27,166,193
james,PR-1111,10,2,92,3,95
james,PR-1110,8,257,1878,2123,4001
james,PR-1109,9,239,1749,2154,3903
james,PR-1108,10,85,959,3601,4560
james,PR-1098,8,11,1332,26,1358
james,PR-1112,9,5,28,13,41
james,PR-1128,1,17,262,44,306
james,PR-1130,1,1,12,0,12
james,PR-1129,2,4,1,67,68
james,PR-1126,2,19,1023,14,1037
james,PR-1099,18,3,139,22,161
james,PR-1098,9,11,1332,26,1358
james,PR-1108,11,85,959,3601,4560
james,PR-1109,10,239,1749,2154,3903
james,PR-1119,7,13,265,2,267
james,PR-1121,8,1,8,5,13
james,PR-1127,4,30,261,261,522
james,PR-1125,3,2,10,4,14
james,PR-1128,2,17,262,44,306
james,PR-1129,3,4,1,67,68
james,PR-1124,3,1,5,1,6
james,PR-1126,4,19,1028,26,1054
james,PR-1131,1,16,154,68,222
james,PR-1119,8,13,265,2,267
james,PR-1129,4,4,1,67,68
james,PR-1126,5,19,1028,26,1054
james,PR-1128,3,17,262,44,306
james,PR-1121,9,1,8,5,13
james,PR-1108,12,85,959,3601,4560
james,PR-1109,11,239,1749,2154,3903
james,PR-1132,1,19,313,17,330
james,PR-1125,4,2,10,4,14
james,PR-1099,19,3,139,22,161
james,PR-1098,10,11,1332,26,1358
james,PR-1133,1,1,3,3,6
james,PR-1134,1,6,329,216,545
james,PR-1131,2,48,724,389,1113
james,PR-1132,2,26,471,20,491
james,PR-1135,1,2,8,2,10
james,PR-1132,3,27,521,20,541
james,PR-1099,20,3,139,22,161
james,PR-1098,11,11,1332,26,1358
james,PR-1108,13,85,959,3601,4560
james,PR-1109,12,239,1749,2154,3903
james,PR-1121,10,1,8,5,13
james,PR-1128,4,17,262,44,306
james,PR-1129,5,4,1,67,68
james,PR-1132,4,37,811,23,834
james,PR-1131,4,52,1331,366,1697
james,PR-1134,3,6,329,216,545
james,PR-1099,21,3,139,22,161
james,PR-1108,14,85,959,3601,4560
james,PR-1119,10,13,265,2,267
james,PR-1132,5,37,811,23,834
james,PR-1133,3,1,3,3,6
james,PR-1128,6,17,263,44,307
james,PR-1128,7,18,267,46,313
james,PR-1136,1,1,1,0,1
james,PR-1132,6,37,832,23,855
james,PR-1098,12,11,1332,26,1358
james,PR-1099,22,3,139,22,161
james,PR-1119,11,13,265,2,267
james,PR-1131,6,52,1336,367,1703
james,PR-1108,15,85,959,3601,4560
james,PR-1098,13,11,1332,26,1358
james,PR-1108,16,85,959,3601,4560
james,PR-1119,12,13,265,2,267
james,PR-1121,12,1,8,5,13
james,PR-1125,8,2,10,4,14
james,PR-1133,4,1,3,3,6
james,PR-1134,5,6,329,216,545
james,PR-1136,2,1,1,0,1
james,PR-1137,1,3,9,2,11
james,PR-1128,8,20,272,46,318
james,PR-1108,17,85,959,3601,4560
james,PR-1109,15,239,1749,2154,3903
james,PR-1136,3,1,1,0,1
james,PR-1138,1,7,34,2,36
james,PR-1098,14,11,1332,26,1358
james,PR-1133,5,1,3,3,6
james,PR-1134,7,11,678,217,895
james,PR-1109,16,239,1749,2154,3903
james,PR-1119,13,13,265,2,267
james,PR-1125,9,2,10,4,14
james,PR-1128,9,20,272,85,357
james,PR-1137,2,3,9,2,11
james,PR-1136,4,1,1,0,1
james,PR-1134,8,11,678,217,895
james,PR-1137,3,5,20,8,28
james,PR-1131,8,52,1338,368,1706
james,PR-1098,15,11,1332,26,1358
james,PR-1108,18,85,959,3601,4560
james,PR-1109,17,239,1749,2154,3903
james,PR-1119,14,13,265,2,267
james,PR-1125,10,2,10,4,14
james,PR-1128,10,20,272,85,357
james,PR-1131,9,52,1338,368,1706
james,PR-1136,5,1,1,0,1
james,PR-1134,9,11,678,217,895
james,PR-1102,13,13,393,34,427
james,PR-1136,6,1,1,0,1
james,PR-1134,10,11,678,217,895
james,PR-1128,11,20,272,85,357
james,PR-1125,11,2,10,4,14
james,PR-1119,15,13,265,2,267
james,PR-1109,18,239,1749,2154,3903
james,PR-1108,19,85,959,3601,4560
james,PR-1136,7,1,1,0,1
james,PR-1134,11,11,678,217,895
james,PR-1128,12,20,272,85,357
james,PR-1119,16,13,265,2,267
james,PR-1109,19,239,1749,2154,3903
james,PR-1108,20,85,959,3601,4560
james,PR-1102,14,13,393,34,427
james,PR-1136,8,1,1,0,1
james,PR-1134,12,11,678,217,895
james,PR-1119,17,13,265,2,267
james,PR-1102,15,13,393,34,427
james,PR-1125,12,2,10,4,14
james,PR-1140,1,6,36,75,111
james,PR-1109,21,239,1749,2154,3903
james,PR-1140,2,6,36,75,111
james,PR-1119,18,13,265,2,267
james,PR-1102,16,13,393,34,427
james,PR-1109,22,239,1749,2154,3903
james,PR-1136,9,1,1,0,1
james,PR-1139,7,5,20,24,44
james,PR-1134,13,11,678,217,895
james,PR-1125,15,8,84,12,96
james,PR-1141,1,1,9,0,9
james,PR-1102,17,13,393,34,427
james,PR-1141,2,1,9,0,9
james,PR-1136,10,1,1,0,1
james,PR-1134,14,11,678,217,895
james,PR-1119,19,13,265,2,267
james,PR-1142,1,2,10,3,13
james,PR-1143,1,1,4,4,8
james,PR-1142,2,2,10,3,13
james,PR-1136,11,1,1,0,1
james,PR-1134,15,11,678,217,895
james,PR-1119,20,13,265,2,267
james,PR-1144,1,1,1,1,2
james,PR-1145,1,6,92,2,94
james,PR-1143,2,1,4,4,8
james,PR-1109,25,238,1748,2151,3899
james,PR-1142,3,2,10,3,13
james,PR-1143,3,1,4,4,8
james,PR-1145,2,6,92,2,94
james,PR-1061,61,55,1635,1387,3022
james,PR-1146,1,1,34,25,59
james,PR-1147,1,1,1,1,2
james,PR-1127,7,44,462,464,926
james,PR-1148,1,16,80,75,155
james,PR-1143,4,1,4,4,8
james,PR-1142,4,2,10,3,13
james,PR-1127,8,44,462,464,926
james,PR-1147,2,1,1,1,2
james,PR-1142,5,5,93,3,96
james,PR-1147,3,1,1,1,2
james,PR-1143,5,1,4,4,8
james,PR-1142,6,11,202,9,211
james,PR-1146,2,6,67,53,120
james,PR-1146,3,6,67,53,120
james,PR-1143,6,1,4,4,8
james,PR-1147,4,1,1,1,2
james,PR-1149,1,9,124,43,167
james,PR-1150,1,1,4,1,5
james,PR-1142,7,11,200,9,209
james,PR-1151,1,7,80,36,116
james,PR-1147,5,1,1,1,2
james,PR-1149,2,9,131,44,175
james,PR-1152,1,2,71,18,89
james,PR-1118,25,18,28,177,205
james,PR-1153,1,3,43,45,88
james,PR-1149,3,9,131,44,175
james,PR-1152,2,2,71,18,89
james,PR-1147,6,1,1,1,2
james,PR-1149,4,9,136,44,180
james,PR-1154,1,6,90,5,95
james,PR-1155,1,2,21,1,22
james,PR-1149,5,9,136,44,180
james,PR-1156,1,3,128,2,130
james,PR-1152,6,2,70,17,87
james,PR-1149,6,9,136,44,180
james,PR-1147,9,1,1,1,2
james,PR-1154,2,6,86,5,91
james,PR-1155,2,2,35,1,36
james,PR-1156,2,3,128,2,130
james,PR-1155,3,2,35,1,36
james,PR-1154,3,6,86,5,91
james,PR-1152,7,2,70,17,87
james,PR-1149,7,9,136,44,180
james,PR-1147,10,1,1,1,2
james,PR-1147,11,1,1,1,2
james,PR-1147,12,1,1,1,2
james,PR-1158,1,8,65,6,71
james,PR-1149,8,9,135,44,179
james,PR-1159,1,3,5,7,12
james,PR-1160,1,1,171,1,172
james,PR-1147,13,1,1,1,2
james,PR-1161,1,22,303,98,401
james,PR-1158,2,8,65,6,71
james,PR-1147,14,1,1,1,2
james,PR-1157,3,17,708,105,813
james,PR-1149,9,9,142,44,186
james,PR-1147,15,1,1,1,2
james,PR-1158,3,8,65,6,71
james,PR-1162,1,1,4,1,5
james,PR-1149,10,9,142,44,186
james,PR-1159,2,7,153,32,185
james,PR-1149,11,9,142,44,186
james,PR-1157,4,17,708,105,813
james,PR-1157,5,17,708,105,813
james,PR-1164,1,4,19,18,37
james,PR-1163,2,1,28,16,44
james,PR-1165,1,1,1,1,2
james,PR-1163,3,1,28,16,44
james,PR-1163,4,1,28,16,44
james,PR-1163,5,1,28,16,44
james,PR-1159,4,7,150,32,182
james,PR-1163,6,1,28,16,44
james,PR-1159,5,7,150,32,182
james,PR-1166,1,1,19,7,26
james,PR-1166,2,1,26,13,39
james,PR-1157,6,17,583,106,689
james,PR-1158,5,8,65,6,71
james,PR-1168,1,2,10,3,13
james,PR-1169,1,7,149,3,152
james,PR-1158,6,8,65,6,71
james,PR-1157,9,17,583,107,690
james,PR-1169,2,7,149,3,152
james,PR-1168,2,2,10,3,13
james,PR-1158,7,8,65,6,71
james,PR-1170,1,5,5,5,10
james,PR-1171,1,13,155,372,527
james,PR-1171,2,13,153,377,530
james,PR-1171,3,13,153,377,530
james,PR-1168,3,2,10,3,13
james,PR-1172,1,16,745,416,1161
james,PR-1170,2,18,160,377,537
james,PR-1173,1,6,12,2,14
james,PR-1174,1,2,51,1,52
james,PR-1175,1,5,307,2,309
james,PR-1176,1,12,701,6,707
james,PR-1170,3,18,160,377,537
james,PR-1176,2,12,720,6,726
james,PR-1175,3,5,308,5,313
james,PR-1176,3,14,720,97,817
james,PR-1175,4,5,308,5,313
james,PR-1177,1,1,2,2,4
james,PR-1176,4,14,750,97,847
james,PR-1178,1,1,1,1,2
james,PR-1178,2,1,1,1,2
james,PR-1178,3,1,1,1,2
james,PR-1175,5,5,308,5,313
james,PR-1161,2,22,133,98,231
james,PR-1179,1,1,1,1,2
james,PR-1180,1,3,24,1,25
james,PR-1178,4,1,1,1,2
james,PR-1179,2,1,1,1,2
james,PR-1177,2,1,2,2,4
james,PR-1172,2,14,597,44,641
james,PR-1179,3,1,1,1,2
james,PR-1181,1,1,94,0,94
james,PR-1172,3,14,597,44,641
james,PR-1179,4,1,1,1,2
james,PR-1175,6,5,308,5,313
james,PR-1172,4,14,597,44,641
james,PR-1172,5,14,597,44,641
james,PR-1182,1,4,129,2,131
james,PR-1182,2,4,133,6,139
james,PR-1183,1,2,6,6,12
james,PR-1184,1,2,5,5,10
james,PR-1179,5,1,1,1,2
james,PR-1184,2,2,5,5,10
james,PR-1185,1,11,337,53,390
james,PR-1186,1,1,4,3,7
james,PR-1172,6,15,601,44,645
james,PR-1157,10,17,585,107,692
james,PR-1176,5,14,762,97,859
james,PR-1172,7,15,601,44,645
james,PR-1185,2,11,337,53,390
james,PR-1176,6,14,779,97,876
james,PR-1185,3,11,376,53,429
james,PR-1186,2,1,4,3,7
james,PR-1188,1,1,4,0,4
james,PR-1175,7,5,308,5,313
james,PR-1185,4,11,376,53,429
james,PR-1176,7,18,791,104,895
james,PR-1185,5,11,376,53,429
james,PR-1189,1,1,3,7,10
james,PR-1185,6,11,376,53,429
james,PR-1189,2,6,83,9,92
james,PR-1175,8,5,308,5,313
james,PR-1185,7,11,376,53,429
james,PR-1187,3,12,107,117,224
james,PR-1189,3,7,141,56,197
james,PR-1190,1,8,92,78,170
james,PR-1190,2,8,92,78,170
james,PR-1176,8,18,805,104,909
james,PR-1176,9,18,805,104,909
james,PR-1191,1,30,785,249,1034
james,PR-1175,9,5,308,5,313
james,PR-1176,10,18,805,104,909
james,PR-1185,8,11,376,53,429
james,PR-1189,4,7,141,56,197
james,PR-1190,3,8,92,78,170
james,PR-1187,4,13,126,136,262
james,PR-1187,5,13,126,136,262
james,PR-1190,4,8,92,78,170
james,PR-1176,11,18,805,104,909
james,PR-1192,1,2,13,15,28
james,PR-1185,9,11,376,53,429
james,PR-1187,6,13,126,136,262
james,PR-1189,5,7,141,56,197
james,PR-1175,10,5,308,5,313
james,PR-1193,1,2,3,3,6
james,PR-1193,2,2,3,3,6
james,PR-1192,2,2,13,15,28
james,PR-1191,2,30,785,249,1034
james,PR-1175,11,5,308,5,313
james,PR-1185,10,11,373,53,426
james,PR-1195,1,19,182,30,212
james,PR-1196,1,9,469,2,471
james,PR-1192,3,2,13,15,28
james,PR-1187,7,13,126,136,262
james,PR-1175,12,5,308,5,313
james,PR-1196,2,9,469,2,471
james,PR-1195,2,19,182,30,212
james,PR-1187,8,13,126,136,262
james,PR-1185,11,11,373,53,426
james,PR-1192,4,2,13,15,28
james,PR-1193,4,2,3,3,6
james,PR-1196,3,9,469,2,471
james,PR-1195,3,19,182,30,212
james,PR-1194,4,4,9,9,18
james,PR-1189,6,7,141,56,197
james,PR-1189,7,7,141,56,197
james,PR-1189,8,7,141,56,197
james,PR-1196,4,9,469,2,471
james,PR-1196,5,9,469,2,471
james,PR-1189,9,7,141,56,197
james,PR-1175,13,5,308,5,313
james,PR-1197,1,9,405,41,446
james,PR-1198,1,61,1386,403,1789
james,PR-1198,2,61,1386,403,1789
james,PR-1198,3,61,1386,403,1789
james,PR-1199,1,3,7,7,14
james,PR-1201,1,2,0,8,8
james,PR-1202,1,1,12,4,16
james,PR-1195,4,20,182,33,215
james,PR-1199,2,3,7,7,14
james,PR-1197,3,9,405,41,446
james,PR-1199,3,3,7,7,14
james,PR-1199,4,3,7,7,14
james,PR-1203,1,1,1,1,2
james,PR-1201,2,2,0,8,8
james,PR-1200,2,13,647,3,650
james,PR-1195,5,21,184,33,217
james,PR-1190,5,8,92,78,170
james,PR-1200,3,13,647,3,650
james,PR-1199,5,3,7,7,14
james,PR-1197,4,9,405,41,446
james,PR-1195,6,23,188,33,221
james,PR-1204,1,9,70,46,116
james,PR-1205,1,8,70,34,104
james,PR-1199,6,3,7,7,14
james,PR-1195,7,23,188,33,221
james,PR-1200,4,12,505,3,508
james,PR-1199,7,3,7,7,14
james,PR-1200,5,12,505,3,508
james,PR-1206,1,1,7,5,12
james,PR-1199,8,3,6,6,12
james,PR-1195,8,23,188,33,221
james,PR-1199,9,4,8,8,16
james,PR-1199,10,4,8,8,16
james,PR-1207,2,2,16,11,27
james,PR-1195,9,23,188,33,221
james,PR-1199,11,4,8,8,16
james,PR-1207,6,12,51,76,127
james,PR-1199,12,4,8,8,16
james,PR-1209,1,1,2,2,4
james,PR-1210,1,1,2,2,4
james,PR-1211,1,3,18,6,24
james,PR-1195,10,23,188,33,221
james,PR-1211,2,3,18,6,24
james,PR-1207,7,13,209,193,402
james,PR-1208,2,24,734,52,786
james,PR-1199,13,4,8,8,16
james,PR-1208,3,21,1022,7,1029
james,PR-1212,1,18,153,50,203
james,PR-1207,8,14,212,196,408
james,PR-1199,14,3,7,7,14
james,PR-1212,2,18,153,50,203
james,PR-1213,1,3,109,3,112
james,PR-1214,1,2,8,0,8
james,PR-1215,1,1,20,22,42
james,PR-1208,5,24,1128,20,1148
james,PR-1216,1,6,7,7,14
james,PR-1218,1,2,20,0,20
james,PR-1219,1,4,48,48,96
james,PR-1199,15,6,16,48,64
james,PR-1220,1,21,497,5,502
james,PR-1212,3,18,153,50,203
james,PR-1219,2,4,58,58,116
james,PR-1221,1,6,50,6,56
james,PR-1220,2,22,502,5,507
james,PR-1219,3,4,58,58,116
james,PR-1215,2,1,20,22,42
james,PR-1213,2,15,318,174,492
james,PR-1220,3,22,502,5,507
james,PR-1215,3,1,20,22,42
james,PR-1213,3,17,335,216,551
james,PR-1208,6,24,1128,20,1148
james,PR-1207,9,14,212,196,408
james,PR-1208,7,22,1111,19,1130
james,PR-1213,4,17,335,216,551
james,PR-1219,4,4,58,58,116
james,PR-1223,1,1,1,1,2
james,PR-1223,2,2,2,2,4
james,PR-1208,8,22,1111,19,1130
james,PR-1224,1,1,8,5,13
james,PR-1222,4,19,162,112,274
james,PR-1224,2,1,8,5,13
james,PR-1208,9,22,1111,19,1130
james,PR-1213,7,20,350,237,587
james,PR-1222,5,19,162,112,274
james,PR-1220,4,22,502,5,507
james,PR-1224,3,1,8,5,13
james,PR-1222,6,19,162,112,274
james,PR-1208,10,22,1111,19,1130
james,PR-1225,1,3,83,48,131
james,PR-1208,11,22,1111,19,1130
james,PR-1224,4,1,8,5,13
james,PR-1222,7,19,162,112,274
james,PR-1222,8,19,162,112,274
james,PR-1224,5,1,8,5,13
james,PR-1225,2,3,83,48,131
james,PR-1225,3,3,83,48,131
james,PR-1222,9,19,162,112,274
james,PR-1224,7,1,4,1,5
james,PR-1226,1,6,29,3,32
james,PR-1227,1,2,56,0,56
james,PR-1225,4,3,83,48,131
james,PR-1222,10,19,162,112,274
james,PR-1228,1,1,20,0,20
james,PR-1229,1,1,3,3,6
james,PR-1222,11,19,162,112,274
james,PR-1225,5,3,83,48,131
james,PR-1229,2,1,3,3,6
james,PR-1230,1,2,24,28,52
james,PR-1229,3,1,3,3,6
james,PR-1226,2,6,29,3,32
james,PR-1229,4,1,3,3,6
james,PR-1231,1,3,104,0,104
james,PR-1232,1,1,1,1,2
james,PR-1231,2,16,192,5,197
james,PR-1233,1,7,13,7,20
james,PR-1232,2,1,1,1,2
james,PR-1226,3,6,29,3,32
james,PR-1222,12,19,162,112,274
james,PR-1234,1,18,147,87,234
james,PR-1231,3,17,203,7,210
james,PR-1235,1,21,419,61,480
james,PR-1232,3,5,68,1,69
james,PR-1222,13,19,162,112,274
james,PR-1226,4,6,29,3,32
james,PR-1231,4,17,203,7,210
james,PR-1232,4,5,68,1,69
james,PR-1233,2,7,13,7,20
james,PR-1234,2,18,147,87,234
james,PR-1235,2,21,419,61,480
james,PR-1236,1,4,12,0,12
james,PR-1237,1,5,11,1,12
james,PR-1238,1,2,30,8,38
james,PR-1232,5,6,92,14,106
james,PR-1234,3,18,148,88,236
james,PR-1231,5,17,203,7,210
james,PR-1226,5,6,29,3,32
james,PR-1238,2,2,30,8,38
james,PR-1235,3,21,419,61,480
james,PR-1240,1,1,1,1,2
james,PR-1232,6,6,98,14,112
james,PR-1235,4,21,418,61,479
james,PR-1241,1,7,301,1,302
james,PR-1242,1,8,1493,2,1495
james,PR-1232,7,6,98,14,112
james,PR-1240,2,1,1,1,2
james,PR-1232,8,6,98,14,112
james,PR-1232,9,6,98,14,112
james,PR-1222,14,19,162,112,274
james,PR-1238,3,2,30,8,38
james,PR-1243,2,4,55,7,62
james,PR-1244,1,2,24,4,28
james,PR-1245,1,3,3,0,3
james,PR-1232,10,6,98,14,112
james,PR-1241,2,7,302,1,303
james,PR-1242,2,10,1582,3,1585
james,PR-1245,2,3,3,0,3
james,PR-1222,15,19,162,112,274
james,PR-1246,1,2,16,0,16
james,PR-1247,1,6,99,16,115
james,PR-1247,2,6,99,16,115
james,PR-1247,3,6,99,16,115
james,PR-1248,1,1,1,13,14
james,PR-1249,1,21,218,27,245
james,PR-1250,1,1,6,0,6
james,PR-1251,1,1,6,0,6
james,PR-1250,2,1,6,0,6
james,PR-1249,2,22,219,28,247
james,PR-1246,2,13,1920,6,1926
james,PR-1249,3,22,219,28,247
james,PR-1246,3,13,1921,6,1927
james,PR-1252,1,7,44,56,100
james,PR-1244,2,2,25,7,32
james,PR-1252,2,7,41,53,94
james,PR-1246,4,13,1931,6,1937
james,PR-1253,1,9,0,1025,1025
james,PR-1252,3,10,83,54,137
james,PR-1254,1,1,1,1,2
james,PR-1222,16,19,162,112,274
james,PR-1255,1,18,215,33,248
james,PR-1255,2,18,207,33,240
james,PR-1239,2,2,17,5,22
james,PR-1252,4,10,82,53,135
james,PR-1255,3,18,207,33,240
james,PR-1255,4,18,207,33,240
james,PR-1239,3,2,17,5,22
james,PR-1255,5,18,207,33,240
james,PR-1256,1,1,4,11,15
james,PR-1255,6,18,207,33,240
james,PR-1246,5,6,372,36,408
james,PR-1259,1,2,21,0,21
james,PR-1257,4,33,704,46,750
james,PR-1257,5,32,772,46,818
james,PR-1258,2,1,1,1,2
james,PR-1258,3,1,1,1,2
james,PR-1260,1,1,17,5,22
james,PR-1260,2,1,17,5,22
james,PR-1257,8,32,747,42,789
james,PR-1257,9,32,747,42,789
james,PR-1261,1,1,3,1,4
james,PR-1262,1,1,7,4,11
james,PR-1263,1,5,158,9,167
james,PR-1257,11,32,752,42,794
james,PR-1258,4,1,1,1,2
james,PR-1263,2,5,158,9,167
james,PR-1257,12,32,752,42,794
james,PR-1264,1,11,77,69,146
james,PR-1265,1,3,12,0,12
james,PR-1263,3,5,158,9,167
james,PR-1258,5,1,1,1,2
james,PR-1264,2,9,198,1,199
james,PR-1266,1,2,96,3,99
james,PR-1267,1,2,13,1,14
james,PR-1268,1,4,42,13,55
james,PR-1191,3,21,608,91,699
james,PR-1269,1,21,608,91,699
james,PR-1270,1,3,37,4,41
james,PR-1271,1,2,13,0,13
james,PR-1263,5,5,156,9,165
james,PR-1268,2,5,59,13,72
james,PR-1263,7,5,156,9,165
james,PR-1272,1,1,14,2,16
james,PR-1272,2,2,12,3,15
james,PR-1272,3,3,13,10,23
james,PR-1269,2,28,826,158,984
james,PR-1270,2,3,37,4,41
james,PR-1272,4,4,41,17,58
james,PR-1273,1,1,1,1,2
james,PR-1272,5,4,41,17,58
james,PR-1272,6,4,41,17,58
james,PR-1274,1,6,48,0,48
james,PR-1275,1,7,825,3,828
james,PR-1274,2,9,76,0,76
james,PR-1274,3,9,76,0,76
james,PR-1274,4,9,76,0,76
james,PR-1276,1,4,233,9,242
james,PR-1275,2,29,1014,270,1284
james,PR-1275,3,29,970,270,1240
james,PR-1278,1,2,6,6,12
james,PR-1279,1,4,15,6,21
james,PR-1280,1,1,16,16,32
james,PR-1281,1,1,12,12,24
james,PR-1272,7,4,41,17,58
james,PR-1274,5,9,76,0,76
james,PR-1282,1,1,8,8,16
james,PR-1280,2,2,34,16,50
james,PR-1282,2,2,30,8,38
james,PR-1281,2,2,30,12,42
james,PR-1277,2,13,1959,7,1966
james,PR-1284,1,1,2,2,4
james,PR-1275,4,29,970,270,1240
james,PR-1284,2,1,2,2,4
james,PR-1277,3,13,2076,7,2083
james,PR-1275,5,29,969,270,1239
james,PR-1284,3,4,12,12,24
james,PR-1284,4,4,12,12,24
james,PR-1277,4,15,2118,47,2165
james,PR-1275,6,30,971,272,1243
james,PR-1278,2,3,13,6,19
james,PR-1284,5,4,12,12,24
james,PR-1277,5,15,2118,47,2165
james,PR-1286,1,2,63,5,68
james,PR-1279,2,4,15,6,21
james,PR-1277,6,15,2120,44,2164
james,PR-1277,7,15,2121,44,2165
james,PR-1286,2,2,61,5,66
james,PR-1287,1,10,161,19,180
james,PR-1284,6,4,12,12,24
james,PR-1277,8,15,2121,44,2165
james,PR-1287,2,10,161,19,180
james,PR-1284,7,4,12,12,24
james,PR-1287,3,10,161,19,180
james,PR-1275,7,30,973,272,1245
james,PR-1277,9,36,2233,278,2511
james,PR-1288,1,2,19,3,22
james,PR-1277,10,36,2234,278,2512
james,PR-1289,1,2,23,13,36
james,PR-1289,2,2,23,13,36
james,PR-1290,1,4,325,6,331
james,PR-1289,3,2,23,13,36
james,PR-1291,2,1,1,1,2
james,PR-1292,2,8,47,11,58
james,PR-1293,1,1,7,7,14
james,PR-1289,4,2,23,13,36
james,PR-1292,3,9,51,33,84
james,PR-1296,1,2,66,0,66
james,PR-1289,5,2,23,13,36
james,PR-1283,3,3,10,17,27
james,PR-1296,2,2,66,0,66
james,PR-1286,3,2,61,5,66
james,PR-1298,1,1,3,3,6
james,PR-1299,1,1,3,3,6
james,PR-1298,2,1,3,3,6
james,PR-1300,1,3,8,26,34
james,PR-1294,3,4,6,22,28
james,PR-1298,3,1,3,3,6
james,PR-1299,2,1,3,3,6
james,PR-1300,2,3,4,21,25
james,PR-1300,3,3,4,21,25
james,PR-1298,4,1,3,3,6
james,PR-1299,3,1,3,3,6
james,PR-1301,1,7,100,5,105
james,PR-1300,4,5,5,27,32
james,PR-1301,2,7,100,5,105
james,PR-1300,5,5,5,27,32
james,PR-1302,1,2,80,2,82
james,PR-1301,3,7,100,5,105
james,PR-1302,2,2,80,2,82
james,PR-1304,1,1,11,2,13
james,PR-1301,4,7,100,5,105
james,PR-1302,3,2,80,2,82
james,PR-1292,6,9,53,56,109
james,PR-1305,1,1,2,2,4
james,PR-1303,3,7,43,8,51
james,PR-1301,5,7,100,5,105
james,PR-1303,4,7,43,8,51
james,PR-1302,4,2,80,2,82
james,PR-1301,6,7,100,5,105
james,PR-1300,6,5,5,27,32
james,PR-1292,7,9,53,56,109
james,PR-1307,1,6,102,6,108
james,PR-1308,1,11,110,42,152
james,PR-1306,3,28,289,122,411
james,PR-1308,2,11,110,42,152
james,PR-1283,6,24,202,162,364
james,PR-1283,7,25,210,170,380
james,PR-1309,1,1,11,2,13
james,PR-1283,8,25,210,170,380
james,PR-1285,17,85,605,614,1219
james,PR-1310,1,1,48,0,48
james,PR-1312,1,1,1,1,2
james,PR-1311,2,16,231,17,248
james,PR-1313,2,17,136,126,262
james,PR-1314,2,13,158,13,171
james,PR-1285,18,85,605,614,1219
james,PR-1283,9,25,210,170,380
james,PR-1315,1,1,0,1,1
james,PR-1311,3,16,231,17,248
james,PR-1285,19,85,605,614,1219
james,PR-1313,3,21,147,138,285
james,PR-1314,4,13,158,13,171
james,PR-1285,20,85,605,614,1219
james,PR-1313,4,21,147,138,285
james,PR-1311,4,16,231,17,248
james,PR-1314,5,13,161,13,174
james,PR-1317,1,1,1,1,2
james,PR-1313,5,21,147,138,285
james,PR-1317,2,1,1,1,2
james,PR-1285,21,85,605,614,1219
james,PR-1285,22,85,605,614,1219
james,PR-1319,1,1,4,0,4
james,PR-1313,6,21,147,138,285
james,PR-1314,7,13,160,13,173
james,PR-1318,2,6,270,14,284
james,PR-1316,5,109,677,211,888
james,PR-1320,1,23,514,47,561
james,PR-1318,3,6,270,14,284
james,PR-1314,8,13,160,13,173
james,PR-1313,7,21,147,138,285
james,PR-1285,23,85,605,614,1219
james,PR-1316,6,115,922,211,1133
james,PR-1318,4,7,282,58,340
james,PR-1321,3,2,102,29,131
james,PR-1285,24,85,605,614,1219
james,PR-1313,8,21,147,138,285
james,PR-1316,7,116,924,211,1135
james,PR-1316,8,116,924,211,1135
james,PR-1313,9,21,147,138,285
james,PR-1285,25,85,605,614,1219
james,PR-1322,2,7,20,32,52
james,PR-1318,7,17,302,98,400
james,PR-1285,26,85,605,614,1219
james,PR-1316,10,116,926,212,1138
james,PR-1322,3,7,20,32,52
james,PR-1310,3,1,50,0,50
james,PR-1320,2,27,717,59,776
james,PR-1310,4,1,48,0,48
james,PR-1316,11,115,922,212,1134
james,PR-1320,3,27,717,59,776
james,PR-1324,1,3,55,20,75
james,PR-1316,12,115,922,212,1134
james,PR-1285,27,85,605,614,1219
james,PR-1320,4,27,723,61,784
james,PR-1325,1,7,20,32,52
james,PR-1326,1,8,283,59,342
james,PR-1326,2,8,283,59,342
james,PR-1325,2,7,20,32,52
james,PR-1320,5,27,700,38,738
james,PR-1327,1,19,111,25,136
james,PR-1320,6,27,700,38,738
james,PR-1328,1,13,233,44,277
james,PR-1285,29,85,605,614,1219
james,PR-1325,4,7,20,32,52
james,PR-1326,4,8,283,59,342
james,PR-1327,2,25,674,45,719
james,PR-1329,1,10,291,28,319
james,PR-1285,30,85,605,614,1219
james,PR-1326,5,8,283,59,342
james,PR-1285,31,86,605,620,1225
james,PR-1330,1,1,2,2,4
james,PR-1329,2,12,408,30,438
james,PR-1331,2,16,398,69,467
james,PR-1332,1,3,173,3,176
james,PR-1331,3,17,443,69,512
james,PR-1333,1,3,36,7,43
james,PR-1330,2,1,2,2,4
james,PR-1285,32,86,605,620,1225
james,PR-1331,4,17,443,69,512
james,PR-1330,3,1,2,2,4
james,PR-1334,1,1,46,14,60
james,PR-1330,5,1,2,2,4
james,PR-1335,2,3,37,8,45
james,PR-1334,2,1,53,14,67
james,PR-1285,34,87,606,620,1226
james,PR-1336,1,1,1,1,2
james,PR-1283,11,25,210,170,380
james,PR-1330,6,1,2,2,4
james,PR-1285,35,87,606,620,1226
james,PR-1334,3,1,53,14,67
james,PR-1283,12,25,210,170,380
james,PR-1290,2,14,717,6,723
james,PR-1285,36,87,606,620,1226
james,PR-1334,4,1,53,14,67
james,PR-1335,3,3,37,8,45
james,PR-1325,6,7,20,32,52
james,PR-1326,6,8,283,59,342
james,PR-1330,7,1,2,2,4
james,PR-1329,5,18,773,93,866
james,PR-1332,2,3,174,3,177
james,PR-1336,2,3,3,3,6
james,PR-1320,7,27,700,38,738
james,PR-1337,1,5,11,5,16
james,PR-1330,8,1,2,2,4
james,PR-1334,6,1,52,13,65
james,PR-1329,6,14,718,62,780
james,PR-1290,4,16,628,6,634
james,PR-1336,3,3,3,3,6
james,PR-1334,7,1,52,13,65
james,PR-1330,9,1,2,2,4
james,PR-1329,7,14,727,62,789
james,PR-1332,3,3,178,3,181
james,PR-1334,8,1,52,13,65
james,PR-1336,4,3,3,3,6
james,PR-1330,10,1,2,2,4
james,PR-1320,8,27,700,38,738
james,PR-1337,2,5,11,5,16
james,PR-1338,1,29,392,111,503
james,PR-1340,1,13,480,37,517
james,PR-1290,5,19,850,6,856
james,PR-1330,11,1,2,2,4
james,PR-1329,8,14,737,62,799
james,PR-1290,6,20,922,6,928
james,PR-1320,9,29,704,38,742
james,PR-1340,2,16,675,40,715
james,PR-1290,7,23,1015,6,1021
james,PR-1339,2,13,298,0,298
james,PR-1338,2,57,540,105,645
james,PR-1338,3,57,540,105,645
james,PR-1339,3,13,298,0,298
james,PR-1340,3,16,675,40,715
james,PR-1340,4,16,675,40,715
james,PR-1285,37,87,606,620,1226
james,PR-1325,7,7,20,32,52
james,PR-1326,7,8,283,59,342
james,PR-1335,4,3,37,8,45
james,PR-1337,3,5,11,5,16
james,PR-1330,13,1,2,2,4
james,PR-1330,14,1,2,2,4
james,PR-1341,1,1,6,2,8
james,PR-1338,4,82,946,170,1116
james,PR-1330,15,1,2,2,4
james,PR-1330,16,1,2,2,4
james,PR-1338,5,82,946,170,1116
james,PR-1320,10,29,704,38,742
james,PR-1329,9,14,737,62,799
james,PR-1337,4,5,11,5,16
james,PR-1338,6,82,940,170,1110
james,PR-1342,1,27,937,111,1048
james,PR-1340,5,16,670,40,710
james,PR-1285,38,76,491,542,1033
james,PR-1335,5,3,37,8,45
james,PR-1283,13,25,210,170,380
james,PR-1330,17,2,3,3,6
james,PR-1337,5,5,11,5,16
james,PR-1285,39,76,491,542,1033
james,PR-1344,2,11,47,164,211
james,PR-1330,18,2,3,3,6
james,PR-1337,6,5,11,5,16
james,PR-1340,6,16,670,40,710
james,PR-1344,3,11,47,164,211
james,PR-1338,7,82,940,170,1110
james,PR-1337,7,5,11,5,16
james,PR-1344,4,11,47,164,211
james,PR-1340,7,16,670,40,710
james,PR-1338,8,82,940,170,1110
james,PR-1337,8,5,11,5,16
james,PR-1330,19,2,3,3,6
james,PR-1342,4,28,1013,126,1139
james,PR-1285,40,77,494,544,1038
james,PR-1330,20,2,3,3,6
james,PR-1285,41,78,494,545,1039
james,PR-1285,42,89,609,623,1232
james,PR-1330,21,2,3,3,6
james,PR-1345,1,1,25,5,30
james,PR-1330,22,2,3,3,6
james,PR-1330,23,2,3,3,6
james,PR-1285,43,89,609,623,1232
james,PR-1325,8,7,20,32,52
james,PR-1326,8,8,283,59,342
james,PR-1335,6,3,37,8,45
james,PR-1338,9,82,947,170,1117
james,PR-1346,1,2,10,4,14
james,PR-1285,44,89,609,623,1232
james,PR-1347,1,11,96,87,183
james,PR-1348,1,2,13,4,17
james,PR-1330,24,2,3,3,6
james,PR-1342,5,24,328,116,444
james,PR-1285,45,93,736,664,1400
james,PR-1349,1,6,54,11,65
james,PR-1350,1,102,1285,174,1459
james,PR-1338,10,82,940,170,1110
james,PR-1348,2,2,13,4,17
james,PR-1285,46,93,736,664,1400
james,PR-1342,6,29,384,136,520
james,PR-1350,2,102,1278,174,1452
james,PR-1330,25,2,3,3,6
james,PR-1351,1,1,1,1,2
james,PR-1349,2,6,54,11,65
james,PR-1330,26,2,3,3,6
james,PR-1342,7,29,384,136,520
james,PR-1338,11,82,939,170,1109
james,PR-1349,3,6,54,11,65
james,PR-1350,3,104,1358,174,1532
james,PR-1326,9,8,283,59,342
james,PR-1325,9,7,20,32,52
james,PR-1338,12,82,939,170,1109
james,PR-1342,8,29,384,136,520
james,PR-1338,13,82,939,170,1109
james,PR-1325,10,7,20,32,52
james,PR-1335,7,3,37,8,45
james,PR-1352,1,85,969,184,1153
james,PR-1338,14,82,939,170,1109
james,PR-1338,15,82,939,170,1109
james,PR-1342,9,29,384,136,520
james,PR-1352,2,85,969,184,1153
james,PR-1335,8,3,37,8,45
james,PR-1338,16,84,950,171,1121
james,PR-1352,3,87,980,185,1165
james,PR-1335,9,3,37,8,45
james,PR-1338,17,84,950,171,1121
james,PR-1061,62,42,1569,1298,2867
james,PR-1350,5,106,1368,175,1543
james,PR-1343,5,121,2068,78,2146
james,PR-1352,4,87,980,185,1165
james,PR-1295,3,5,16,209,225
james,PR-1353,1,132,1732,196,1928
james,PR-1338,18,84,950,171,1121
james,PR-1061,63,42,1569,1298,2867
james,PR-1353,2,132,1733,196,1929
james,PR-1343,6,122,2070,78,2148
james,PR-1343,7,123,2073,78,2151
james,PR-1061,64,44,1580,1309,2889
james,PR-1061,65,44,1597,1336,2933
james,PR-1343,8,124,2082,78,2160
james,PR-1354,1,11,564,0,564
james,PR-1338,19,84,950,171,1121
james,PR-1343,9,124,2082,78,2160
james,PR-1354,2,19,615,23,638
james,PR-1355,1,6,14,17,31
james,PR-1354,3,17,578,17,595
james,PR-1355,2,8,16,17,33
james,PR-1354,4,13,566,12,578
james,PR-1356,1,2,2,12,14
james,PR-1357,1,6,14,5,19
james,PR-1353,3,49,783,25,808
james,PR-1350,6,23,418,4,422
james,PR-1352,5,3,30,14,44
james,PR-1358,1,2,2,2,4
james,PR-1357,2,6,14,5,19
james,PR-1352,6,3,30,14,44
james,PR-1350,7,23,418,4,422
james,PR-1358,2,2,2,2,4
james,PR-1356,2,2,2,12,14
james,PR-1358,3,2,2,2,4
james,PR-1357,3,6,14,5,19
james,PR-1356,3,2,2,12,14
james,PR-1350,8,23,418,4,422
james,PR-1359,1,2,24,13,37
james,PR-1359,2,2,24,13,37
james,PR-1356,4,2,2,12,14
james,PR-1350,9,23,418,4,422
james,PR-1358,4,2,2,2,4
james,PR-1359,3,2,24,13,37
james,PR-1350,10,23,418,4,422
james,PR-1360,1,2,5,5,10
james,PR-1359,4,4,99,66,165
james,PR-1061,67,44,1585,1309,2894
james,PR-1350,11,23,418,4,422
james,PR-1359,5,4,99,66,165
james,PR-1061,68,44,1585,1309,2894
james,PR-1061,71,56,3673,1309,4982
james,PR-1353,4,26,365,21,386
james,PR-1061,72,43,1589,1313,2902
james,PR-1061,73,43,1589,1313,2902
james,PR-1361,2,1,32,4,36
james,PR-1362,1,4,36,30,66
james,PR-1359,6,4,99,66,165
james,PR-1363,1,3,110,56,166
james,PR-1360,2,2,5,5,10
james,PR-1360,3,2,7,7,14
james,PR-1359,7,4,99,66,165
james,PR-1061,74,43,1595,1316,2911
james,PR-1357,4,6,14,5,19
james,PR-1357,5,7,15,6,21
james,PR-1364,1,5,37,14,51
james,PR-1361,4,3,251,6,257
james,PR-1365,1,18,239,36,275
james,PR-1366,1,11,263,14,277
james,PR-1359,8,4,99,66,165
james,PR-1061,75,43,1595,1316,2911
james,PR-1365,2,18,239,36,275
james,PR-1357,6,8,16,7,23
james,PR-1359,9,4,99,66,165
james,PR-1365,3,18,238,35,273
james,PR-1364,2,6,36,14,50
james,PR-1365,4,18,238,35,273
james,PR-1367,1,1,7,6,13
james,PR-1061,76,43,1595,1316,2911
james,PR-1354,5,11,542,0,542
james,PR-1368,1,1,92,2,94
james,PR-1369,1,1,4,9,13
james,PR-1354,6,11,542,0,542
james,PR-1370,1,1,18,0,18
james,PR-1363,4,2,37,5,42
james,PR-1368,2,18,209,87,296
james,PR-1370,2,2,34,16,50
james,PR-1363,5,2,37,5,42
james,PR-1369,2,2,12,17,29
james,PR-1061,77,43,1595,1316,2911
james,PR-1061,78,43,1595,1316,2911
james,PR-1363,6,2,37,5,42
james,PR-1061,79,55,3683,1316,4999
james,PR-1061,80,55,3683,1316,4999
james,PR-1061,81,55,3691,1323,5014
james,PR-1366,2,17,617,19,636
james,PR-1363,7,2,37,5,42
james,PR-1366,3,17,616,19,635
james,PR-1363,8,3,38,6,44
james,PR-1061,82,55,3691,1323,5014
james,PR-1363,9,3,38,6,44
james,PR-1061,83,55,3691,1323,5014
james,PR-1371,1,6,27,1,28
james,PR-1372,1,9,184,6,190
james,PR-1373,1,12,43,15,58
james,PR-1363,10,3,38,6,44
james,PR-1061,84,55,3691,1323,5014
james,PR-1372,2,10,275,11,286
james,PR-1373,2,15,48,17,65
james,PR-1374,1,34,312,75,387
james,PR-1061,85,55,3691,1323,5014
james,PR-1363,11,3,38,6,44
james,PR-1375,1,16,580,3,583
james,PR-1376,1,34,408,38,446
james,PR-1375,2,16,582,3,585
james,PR-1363,12,3,38,6,44
james,PR-1377,3,36,136,107,243
james,PR-1376,2,21,367,32,399
james,PR-1363,13,3,38,6,44
james,PR-1375,3,11,958,3,961
james,PR-1378,1,2,17,1,18
james,PR-1376,3,20,374,38,412
james,PR-1377,4,36,135,106,241
james,PR-1372,3,10,274,11,285
james,PR-1377,5,37,137,106,243
james,PR-1363,14,4,40,6,46
james,PR-1379,1,1,1,1,2
james,PR-1363,15,4,45,6,51
james,PR-1295,9,6,22,217,239
james,PR-1379,2,2,9,13,22
james,PR-1376,4,8,216,28,244
james,PR-1295,10,5,22,216,238
james,PR-1380,1,43,1303,80,1383
james,PR-1375,4,12,978,3,981
james,PR-1379,3,3,17,19,36
james,PR-1381,1,3,96,4,100
james,PR-1377,6,37,140,110,250
james,PR-1382,1,39,539,142,681
james,PR-1380,2,44,1397,80,1477
james,PR-1383,1,2,9,13,22
james,PR-1375,5,12,978,3,981
james,PR-1383,2,2,9,13,22
james,PR-1381,2,3,96,4,100
james,PR-1379,4,3,17,19,36
james,PR-1380,3,43,1393,78,1471
james,PR-1375,6,11,974,1,975
james,PR-1382,2,30,296,117,413
james,PR-1384,1,2,5,21,26
james,PR-1383,3,2,9,13,22
james,PR-1382,3,30,296,117,413
james,PR-1379,5,3,17,19,36
james,PR-1375,7,11,974,1,975
james,PR-1385,1,16,1891,1,1892
james,PR-1386,1,49,1540,92,1632
james,PR-1375,8,11,974,1,975
james,PR-1380,4,38,453,88,541
james,PR-1385,2,10,934,7,941
james,PR-1382,4,4,163,45,208
james,PR-1387,1,15,1827,7,1834
james,PR-1386,2,10,421,28,449
james,PR-1385,3,10,938,7,945
james,PR-1384,3,2,7,21,28
james,PR-1295,11,6,32,223,255
james,PR-1388,1,4,13,3,16
james,PR-1379,6,11,37,55,92
james,PR-1387,2,15,1831,7,1838
james,PR-1382,5,4,163,45,208
james,PR-1390,1,33,142,235,377
james,PR-1295,12,7,32,226,258
james,PR-1379,8,17,174,165,339
james,PR-1390,2,33,142,235,377
james,PR-1386,3,10,422,28,450
james,PR-1391,1,9,54,52,106
james,PR-1386,4,10,422,28,450
james,PR-1391,2,9,54,52,106
james,PR-1392,1,6,58,19,77
james,PR-1392,2,6,52,19,71
james,PR-1393,2,9,88,12,100
james,PR-1394,1,6,380,10,390
james,PR-1395,1,7,38,48,86
james,PR-1396,1,1,1,1,2
james,PR-1392,4,12,124,19,143
james,PR-1397,4,12,57,1,58
james,PR-1394,2,6,380,10,390
james,PR-1398,1,10,676,6,682
james,PR-1395,2,7,36,44,80
james,PR-1394,3,6,380,10,390
james,PR-1392,5,12,124,19,143
james,PR-1395,3,7,36,46,82
james,PR-1392,6,12,124,20,144
james,PR-1399,3,8,99,17,116
james,PR-1400,1,1,1,1,2
james,PR-1394,4,6,369,10,379
james,PR-1400,2,1,1,1,2
james,PR-1392,7,13,154,29,183
james,PR-1400,3,1,1,1,2
james,PR-1399,4,8,99,17,116
james,PR-1400,4,1,1,1,2
james,PR-1397,5,12,57,1,58
james,PR-1379,9,22,210,176,386
james,PR-1392,8,13,154,29,183
james,PR-1379,10,22,210,176,386
james,PR-1401,1,2,13,7,20
james,PR-1397,6,13,59,3,62
james,PR-1402,1,1,11,3,14
james,PR-1403,1,3,28,1,29
james,PR-1404,1,1,11,3,14
james,PR-1401,2,2,13,7,20
james,PR-1403,2,3,20,0,20
james,PR-1405,1,2,24,1,25
james,PR-1405,2,2,24,1,25
james,PR-1404,2,1,11,3,14
james,PR-1405,3,2,24,1,25
james,PR-1403,3,4,21,0,21
james,PR-1405,4,2,24,1,25
james,PR-1404,3,1,11,3,14
james,PR-1403,4,4,21,0,21
james,PR-1406,4,5,23,30,53
james,PR-1404,4,1,11,3,14
james,PR-1404,5,1,11,3,14
james,PR-1404,6,1,11,3,14
james,PR-1407,1,2,25,14,39
james,PR-1409,1,6,221,44,265
james,PR-1408,3,4,2,0,2
james,PR-1409,2,6,225,45,270
james,PR-1407,2,3,31,15,46
james,PR-1411,1,11,191,35,226
james,PR-1404,7,1,11,3,14
james,PR-1412,1,2,157,12,169
james,PR-1413,1,2,16,11,27
james,PR-1410,3,14,121,88,209
james,PR-1414,1,1,8,2,10
james,PR-1408,4,5,54,0,54
james,PR-1409,3,6,224,44,268
james,PR-1414,2,1,8,3,11
james,PR-1412,2,2,157,12,169
james,PR-1411,2,11,191,35,226
james,PR-1404,8,1,11,3,14
james,PR-1415,1,5,38,7,45
james,PR-1408,5,5,54,0,54
james,PR-1414,3,1,8,3,11
james,PR-1408,6,5,54,0,54
james,PR-1415,2,5,38,7,45
james,PR-1414,4,1,8,3,11
james,PR-1412,3,2,157,12,169
james,PR-1415,3,5,38,7,45
james,PR-1415,4,5,38,7,45
james,PR-1416,1,7,254,15,269
james,PR-1411,3,11,196,35,231
james,PR-1416,2,7,254,15,269
james,PR-1415,5,7,48,6,54
james,PR-1416,3,7,254,15,269
james,PR-1417,1,6,62,61,123
james,PR-1418,1,1,15,15,30
james,PR-1419,1,2,74,1,75
james,PR-1417,2,6,65,64,129
james,PR-1409,7,10,367,50,417
james,PR-1420,4,5,119,22,141
james,PR-1421,1,1,40,26,66
james,PR-1423,1,10,50,44,94
james,PR-1423,2,10,50,44,94
james,PR-1421,2,2,41,27,68
james,PR-1422,2,2,48,15,63
james,PR-1422,3,2,50,17,67
james,PR-1423,3,10,50,44,94
james,PR-1422,4,2,50,17,67
james,PR-1424,1,4,12,8,20
james,PR-1425,1,21,614,7,621
james,PR-1404,9,1,11,3,14
james,PR-1424,2,5,14,10,24
james,PR-1426,1,4,102,18,120
james,PR-1409,8,10,367,50,417
james,PR-1426,2,7,142,33,175
james,PR-1426,3,7,142,33,175
james,PR-1427,2,3,69,2,71
james,PR-1426,4,7,142,33,175
james,PR-1428,1,2,4,2,6
james,PR-1429,1,1,1,1,2
james,PR-1428,2,2,4,2,6
james,PR-1427,3,3,69,2,71
james,PR-1430,1,1,11,10,21
james,PR-1430,2,1,11,10,21
james,PR-1428,3,2,4,2,6
james,PR-1433,1,7,110,36,146
james,PR-1434,1,1,0,4,4
james,PR-1432,4,14,83,31,114
james,PR-1409,9,10,363,47,410
james,PR-1435,1,1,7,0,7
james,PR-1433,2,7,115,41,156
james,PR-1433,3,7,115,41,156
james,PR-1432,5,30,155,34,189
james,PR-1436,3,23,228,94,322
james,PR-1432,6,30,155,34,189
james,PR-1436,4,23,229,94,323
james,PR-1432,7,31,159,37,196
james,PR-1437,1,5,98,6,104
james,PR-1432,8,33,161,40,201
james,PR-1438,1,2,13,1,14
james,PR-1439,1,2,10,4,14
james,PR-1431,2,10,155,198,353
james,PR-1440,1,3,8,8,16
james,PR-1438,2,2,13,1,14
james,PR-1439,2,2,10,4,14
james,PR-1441,1,1,1,1,2
james,PR-1438,3,2,14,3,17
james,PR-1437,2,9,357,8,365
james,PR-1438,4,2,14,3,17
james,PR-1440,3,3,9,8,17
james,PR-1440,4,3,9,8,17
james,PR-1442,1,4,74,30,104
james,PR-1442,2,4,74,30,104
james,PR-1442,3,5,80,30,110
james,PR-1442,4,6,81,31,112
james,PR-1437,3,16,407,10,417
james,PR-1437,4,18,409,10,419
james,PR-1442,5,5,79,31,110
james,PR-1442,6,5,79,31,110
james,PR-1442,7,5,79,31,110
james,PR-1443,2,13,1119,0,1119
james,PR-1440,5,3,9,8,17
james,PR-1437,5,19,420,12,432
james,PR-1443,5,16,1469,1,1470
james,PR-1444,3,13,93,25,118
james,PR-1445,1,2,69,10,79
james,PR-1445,2,2,69,10,79
james,PR-1444,4,16,99,44,143
james,PR-1443,6,16,1469,1,1470
james,PR-1446,1,33,1769,20,1789
james,PR-1447,1,9,658,57,715
james,PR-1448,3,5,198,1,199
james,PR-1449,1,2,69,10,79
james,PR-1449,2,2,69,10,79
james,PR-1448,4,5,198,1,199
james,PR-1446,4,21,313,31,344
james,PR-1450,1,13,625,37,662
james,PR-1448,5,5,198,1,199
james,PR-1440,7,3,9,8,17
james,PR-1449,3,2,69,10,79
james,PR-1379,11,17,174,165,339
james,PR-1451,1,2,14,10,24
james,PR-1452,1,5,134,29,163
james,PR-1453,2,3,82,0,82
james,PR-1454,1,8,30,4,34
james,PR-1450,3,13,625,37,662
james,PR-1455,1,1,12,0,12
james,PR-1456,1,7,250,3,253
james,PR-1457,1,7,18,6,24
james,PR-1455,2,1,12,0,12
james,PR-1458,1,2,22,1,23
james,PR-1459,1,2,22,1,23
james,PR-1460,1,8,31,5,36
james,PR-1451,4,2,14,10,24
james,PR-1448,9,5,198,1,199
james,PR-1440,9,3,9,8,17
james,PR-1457,2,23,99,6,105
james,PR-1461,1,1,1,1,2
james,PR-1450,4,13,625,37,662
james,PR-1452,2,6,137,32,169
james,PR-1448,10,5,198,1,199
james,PR-1455,3,1,12,0,12
james,PR-1462,1,1,1,1,2
james,PR-1457,3,27,118,10,128
james,PR-1463,1,5,110,119,229
james,PR-1462,2,1,1,1,2
james,PR-1450,5,13,625,33,658
james,PR-1455,4,5,31,4,35
james,PR-1448,11,5,198,1,199
james,PR-1455,5,5,31,4,35
james,PR-1450,7,13,630,33,663
james,PR-1453,7,3,137,0,137
james,PR-1455,6,5,31,4,35
james,PR-1452,3,6,184,32,216
james,PR-1452,4,6,189,32,221
james,PR-1464,1,2,26,8,34
james,PR-1465,1,2,26,8,34
james,PR-1466,1,2,9,4,13
james,PR-1448,12,5,198,1,199
james,PR-1450,8,13,634,36,670
james,PR-1458,2,2,22,0,22
james,PR-1460,2,8,31,5,36
james,PR-1458,3,2,22,0,22
james,PR-1448,13,5,198,1,199
james,PR-1450,9,13,634,36,670
james,PR-1465,2,2,26,8,34
james,PR-1466,2,4,15,6,21
james,PR-1450,10,13,634,36,670
james,PR-1460,3,8,31,5,36
james,PR-1466,3,4,15,6,21
james,PR-1448,14,5,198,1,199
james,PR-1452,5,6,189,32,221
james,PR-1463,2,5,111,119,230
james,PR-1460,4,8,31,5,36
james,PR-1450,11,13,634,36,670
james,PR-1465,3,2,26,8,34
james,PR-1463,3,5,113,121,234
james,PR-1466,5,4,15,6,21
james,PR-1465,4,2,26,8,34
james,PR-1460,5,8,31,5,36
james,PR-1460,6,8,31,5,36
james,PR-1465,5,2,26,8,34
james,PR-1467,2,4,107,19,126
james,PR-1468,1,5,178,17,195
james,PR-1467,3,4,107,19,126
james,PR-1469,1,4,107,19,126
james,PR-1467,4,4,107,19,126
james,PR-1470,1,7,632,0,632
james,PR-1470,2,8,680,0,680
james,PR-1468,2,5,178,17,195
james,PR-1470,3,9,687,2,689
james,PR-1471,1,9,1164,2,1166
james,PR-1471,2,9,1303,2,1305
james,PR-1470,4,9,687,2,689
james,PR-1472,1,2,13,1,14
james,PR-1472,3,2,51,9,60
james,PR-1471,3,9,1284,2,1286
james,PR-1470,5,10,733,2,735
james,PR-1470,7,10,733,2,735
james,PR-1471,5,9,787,69,856
james,PR-1473,1,3,51,9,60
james,PR-1473,2,3,51,9,60
james,PR-1474,1,7,55,3,58
james,PR-1467,5,4,110,19,129
james,PR-1469,2,4,110,19,129
james,PR-1474,2,7,63,4,67
james,PR-1473,3,6,55,13,68
james,PR-1474,4,7,63,4,67
james,PR-1473,4,6,55,13,68
james,PR-1473,5,6,55,13,68
james,PR-1474,5,7,63,4,67
james,PR-1473,6,6,55,13,68
james,PR-1473,7,6,55,13,68
james,PR-1475,1,5,23,30,53
james,PR-1476,1,6,78,10,88
james,PR-1477,1,2,64,4,68
james,PR-1478,1,19,524,10,534
james,PR-1478,2,19,524,10,534
james,PR-1479,1,5,35,4,39
james,PR-1479,2,7,194,6,200
james,PR-1476,2,6,82,10,92
james,PR-1476,3,8,88,13,101
james,PR-1480,3,4,165,3,168
james,PR-1481,3,3,0,112,112
james,PR-1485,1,1,0,4,4
james,PR-1485,2,1,0,4,4
james,PR-1484,3,1,2,5,7
james,PR-1483,5,11,113,21,134
james,PR-1486,3,2,24,9,33
james,PR-1480,7,4,165,3,168
james,PR-1479,4,7,194,6,200
james,PR-1476,4,8,88,13,101
james,PR-1487,1,1,93,0,93
james,PR-1479,5,7,194,6,200
james,PR-1476,5,8,88,13,101
james,PR-1477,6,3,124,3,127
james,PR-1483,6,11,113,21,134
james,PR-1486,4,2,24,9,33
james,PR-1488,1,1,22,2,24
james,PR-1479,7,7,204,6,210
james,PR-1483,7,11,116,19,135
james,PR-1486,5,2,24,9,33
james,PR-1476,6,12,94,19,113
james,PR-1479,8,7,204,6,210
james,PR-1483,8,11,110,13,123
james,PR-1489,1,2,60,2,62
james,PR-1490,1,3,32,8,40
james,PR-1489,2,2,53,2,55
james,PR-1491,1,3,74,40,114
james,PR-1476,7,13,112,26,138
james,PR-1476,8,15,126,34,160
james,PR-1491,2,3,74,40,114
james,PR-1488,4,1,22,2,24
james,PR-1483,9,11,110,13,123
james,PR-1479,9,7,204,6,210
james,PR-1476,9,15,126,34,160
james,PR-1479,10,7,204,6,210
james,PR-1488,5,1,22,2,24
james,PR-1492,1,2,79,3,82
james,PR-1492,2,2,81,2,83
james,PR-1491,3,3,232,40,272
james,PR-1493,1,15,88,31,119
james,PR-1492,3,2,81,2,83
james,PR-1494,1,4,11,11,22
james,PR-1495,1,2,83,1,84
james,PR-1493,2,15,88,31,119
james,PR-1493,3,15,88,31,119
james,PR-1495,2,2,83,1,84
james,PR-1493,4,15,88,31,119
james,PR-1496,1,1,12,0,12
james,PR-1495,3,2,154,1,155
james,PR-1497,1,48,118,121,239
james,PR-1496,2,1,12,0,12
james,PR-1497,2,48,118,121,239
james,PR-1495,4,2,154,1,155
james,PR-1499,1,4,30,8,38
james,PR-1498,4,2,42,3,45
james,PR-1498,5,2,42,3,45
james,PR-1498,6,2,42,3,45
james,PR-1500,2,10,382,4,386
james,PR-1500,3,10,473,4,477
james,PR-1498,7,5,51,48,99
james,PR-1493,5,16,141,84,225
james,PR-1498,8,5,51,48,99
james,PR-1493,6,16,141,84,225
james,PR-1493,7,16,141,84,225
james,PR-1502,1,10,622,159,781
james,PR-1503,1,10,70,14,84
james,PR-1503,2,10,70,14,84
james,PR-1503,3,10,70,14,84
james,PR-1504,3,3,93,2,95
james,PR-1500,4,10,473,4,477
james,PR-1500,5,8,451,1,452
james,PR-1503,4,11,72,15,87
james,PR-1503,5,11,72,15,87
james,PR-1500,6,8,451,1,452
james,PR-1503,6,11,72,15,87
james,PR-1500,7,8,451,1,452
james,PR-1505,3,7,243,210,453
james,PR-1505,4,8,252,215,467
james,PR-1506,1,1,1,1,2
james,PR-1508,1,3,23,8,31
james,PR-1505,5,9,254,221,475
james,PR-1505,6,8,243,212,455
james,PR-1505,7,8,243,212,455
james,PR-1505,8,8,243,212,455
james,PR-1509,1,2,12,4,16
james,PR-1505,9,8,243,212,455
james,PR-1510,1,11,378,206,584
james,PR-1510,2,12,393,243,636
james,PR-1511,1,2,2,2,4
james,PR-1512,1,1,3,1,4
james,PR-1513,1,1,39,1,40
james,PR-1510,3,12,393,243,636
james,PR-1515,1,3,10,7,17
james,PR-1514,3,15,605,74,679
james,PR-1515,2,2,8,6,14
james,PR-1516,2,15,193,39,232
james,PR-1517,1,1,8,2,10
james,PR-1516,3,16,238,39,277
james,PR-1517,2,1,8,2,10
james,PR-1516,4,16,238,39,277
james,PR-1518,2,4,52,160,212
james,PR-1518,3,4,52,160,212
james,PR-1520,1,4,386,0,386
james,PR-1520,2,4,386,0,386
james,PR-1521,1,1,1,2,3
james,PR-1519,4,26,1163,77,1240
james,PR-1519,5,26,1163,77,1240
james,PR-1520,3,4,386,0,386
james,PR-1521,2,1,1,2,3
james,PR-1521,3,1,1,2,3
james,PR-1520,4,4,386,0,386
james,PR-1519,6,26,1163,77,1240
james,PR-1519,7,26,1163,77,1240
james,PR-1520,5,4,386,0,386
james,PR-1519,8,26,1163,77,1240
james,PR-1522,1,17,223,16,239
james,PR-1520,6,4,386,0,386
james,PR-1520,7,4,386,0,386
james,PR-1523,1,2,34,1,35
james,PR-1519,9,26,1163,77,1240
james,PR-1520,8,4,386,0,386
james,PR-1519,10,26,1163,77,1240
james,PR-1523,2,2,34,1,35
james,PR-1524,1,5,5,5,10
james,PR-1525,1,10,227,8,235
james,PR-1527,1,4,156,10,166
james,PR-1522,2,18,1313,17,1330
james,PR-1530,1,3,434,0,434
james,PR-1519,11,26,1163,77,1240
james,PR-1523,3,2,34,1,35
james,PR-1531,1,7,170,46,216
james,PR-1527,2,4,156,10,166
james,PR-1519,12,26,1163,77,1240
james,PR-1522,3,18,1313,17,1330
james,PR-1527,3,4,156,10,166
james,PR-1531,2,7,170,46,216
james,PR-1525,2,14,235,10,245
james,PR-1530,2,3,434,0,434
james,PR-1522,4,18,1360,17,1377
james,PR-1519,13,26,1163,77,1240
james,PR-1522,6,19,1384,17,1401
james,PR-1530,5,13,694,4,698
james,PR-1532,2,19,792,17,809
james,PR-1519,14,26,1166,77,1243
james,PR-1532,3,25,906,32,938
james,PR-1533,1,28,923,38,961
james,PR-1519,16,26,1166,77,1243
james,PR-1522,9,19,1384,17,1401
james,PR-1532,5,25,906,32,938
james,PR-1532,6,25,906,32,938
james,PR-1522,10,19,1386,17,1403
james,PR-1533,2,28,932,40,972
james,PR-1533,3,19,244,42,286
james,PR-1519,17,27,1194,79,1273
james,PR-1532,7,16,218,34,252
james,PR-1533,4,19,244,42,286
james,PR-1522,11,19,1386,17,1403
james,PR-1534,1,57,1344,180,1524
james,PR-1519,18,27,1194,79,1273
james,PR-1533,5,3,26,8,34
james,PR-1534,3,58,1348,187,1535
james,PR-1519,19,27,1194,79,1273
james,PR-1534,4,34,204,158,362
james,PR-1535,1,1,1,13,14
james,PR-1534,5,34,204,158,362
james,PR-1534,6,34,204,158,362
james,PR-1522,12,19,1386,17,1403
james,PR-1537,2,10,27,248,275
james,PR-1536,2,6,121,7,128
james,PR-1536,3,6,122,7,129
james,PR-1538,1,1,1,1,2
james,PR-1539,1,2,22,7,29
james,PR-1538,2,1,1,1,2
james,PR-1541,1,1,3,0,3
james,PR-1540,2,7,181,29,210
james,PR-1540,3,7,181,29,210
james,PR-1540,4,7,180,29,209
james,PR-1542,1,2,109,0,109
james,PR-1540,5,7,180,29,209
james,PR-1525,4,17,295,11,306
james,PR-1543,2,4,100,40,140
james,PR-1540,6,7,180,29,209
james,PR-1544,1,7,566,296,862
james,PR-1544,2,7,566,296,862
james,PR-1546,1,1,1,1,2
james,PR-1544,3,7,566,296,862
james,PR-1545,2,20,220,265,485
james,PR-1525,5,67,837,78,915
james,PR-1544,4,7,566,296,862
james,PR-1545,3,22,224,287,511
james,PR-1525,6,67,837,78,915
james,PR-1545,4,22,224,287,511
james,PR-1547,1,1,5,2,7
james,PR-1545,5,22,224,287,511
james,PR-1545,6,22,224,287,511
james,PR-1548,1,35,563,113,676
james,PR-1549,1,11,1029,93,1122
james,PR-1549,2,12,1455,112,1567
james,PR-1548,2,35,563,113,676
james,PR-1548,3,35,563,113,676
james,PR-1548,4,35,563,113,676
james,PR-1547,2,1,5,2,7
james,PR-1548,5,35,563,113,676
james,PR-1547,3,1,5,2,7
james,PR-1552,1,6,8,0,8
james,PR-1551,1,1,16,6,22
james,PR-1550,1,6,85,11,96
james,PR-1549,3,12,1451,112,1563
james,PR-1552,2,6,8,0,8
james,PR-1548,6,35,563,113,676
james,PR-1547,4,1,5,2,7
james,PR-1553,1,1,9,5,14
james,PR-1553,2,1,9,5,14
james,PR-1551,2,1,16,6,22
james,PR-1548,7,35,563,113,676
james,PR-1549,4,12,1451,112,1563
james,PR-1554,1,5,37,19,56
james,PR-1553,3,1,8,5,13
james,PR-1553,4,1,8,5,13
james,PR-1551,3,1,16,6,22
james,PR-1549,5,12,1451,112,1563
james,PR-1553,5,1,8,5,13
james,PR-1551,4,1,16,6,22
james,PR-1549,6,12,1451,112,1563
james,PR-1548,8,35,563,113,676
james,PR-1555,1,6,325,0,325
james,PR-1553,6,1,8,5,13
james,PR-1549,7,12,1451,112,1563
james,PR-1548,9,35,558,113,671
james,PR-1553,7,1,8,5,13
james,PR-1551,5,1,16,6,22
james,PR-1549,8,12,1451,112,1563
james,PR-1548,10,35,558,113,671
james,PR-1553,8,1,8,5,13
james,PR-1548,11,35,558,113,671
james,PR-1549,9,12,1451,112,1563
james,PR-1551,6,1,16,6,22
james,PR-1553,9,1,8,5,13
james,PR-1554,2,5,37,19,56
james,PR-1551,7,1,16,6,22
james,PR-1554,3,5,37,19,56
james,PR-1548,12,98,740,1542,2282
james,PR-1551,8,1,16,6,22
james,PR-1548,13,98,740,1542,2282
james,PR-1548,14,98,759,1542,2301
james,PR-1551,9,1,16,6,22
james,PR-1551,10,1,16,6,22
james,PR-1548,15,98,759,1542,2301
james,PR-1551,11,1,16,6,22
james,PR-1548,16,98,759,1542,2301
james,PR-1556,1,2,22,16,38
james,PR-1557,1,1,52,0,52
james,PR-1551,12,1,16,6,22
james,PR-1557,2,1,52,0,52
james,PR-1559,1,15,188,1,189
james,PR-1559,2,14,188,1,189
james,PR-1548,17,98,759,1542,2301
james,PR-1551,13,1,16,6,22
james,PR-1551,14,1,16,6,22
james,PR-1558,3,20,56,117,173
james,PR-1559,3,14,224,1,225
james,PR-1560,1,2,30,1,31
james,PR-1558,4,20,56,117,173
james,PR-1551,15,1,16,6,22
james,PR-1561,1,6,217,11,228
james,PR-1561,2,10,402,21,423
james,PR-1551,16,1,16,6,22
james,PR-1548,21,98,757,1542,2299
james,PR-1551,17,1,16,6,22
james,PR-1548,22,98,757,1542,2299
james,PR-1551,18,1,16,6,22
james,PR-1563,1,10,465,48,513
james,PR-1563,2,10,465,48,513
james,PR-1561,3,10,402,21,423
james,PR-1564,1,1,0,1,1
james,PR-1565,1,10,1121,0,1121
james,PR-1563,3,10,465,48,513
james,PR-1551,19,1,16,6,22
james,PR-1565,2,9,1224,0,1224
james,PR-1566,1,9,989,1,990
james,PR-1567,1,1,1,1,2
james,PR-1568,1,17,169,103,272
james,PR-1561,4,11,486,23,509
james,PR-1561,5,11,484,23,507
james,PR-1569,1,19,1483,3,1486
james,PR-1565,3,29,1098,652,1750
james,PR-1566,2,19,1670,4,1674
james,PR-1569,2,30,1880,3,1883
james,PR-1565,4,28,452,652,1104
james,PR-1566,3,19,1670,4,1674
james,PR-1565,5,28,452,652,1104
james,PR-1565,6,28,452,652,1104
james,PR-1570,1,21,2094,3,2097
james,PR-1569,3,30,1880,3,1883
james,PR-1570,2,21,2094,3,2097
james,PR-1569,4,30,1880,3,1883
james,PR-1565,7,28,452,652,1104
james,PR-1570,3,21,2101,3,2104
james,PR-1566,5,12,1115,0,1115
james,PR-1571,1,18,1562,0,1562
james,PR-1566,6,12,1115,0,1115
james,PR-1571,2,18,1562,0,1562
james,PR-1570,4,21,2101,3,2104
james,PR-1572,1,12,175,23,198
james,PR-1571,3,6,447,0,447
james,PR-1572,2,13,178,24,202
james,PR-1570,5,13,986,3,989
james,PR-1571,4,6,447,0,447
james,PR-1572,3,13,189,25,214
james,PR-1570,6,13,986,3,989
james,PR-1571,5,6,447,0,447
james,PR-1561,6,11,518,28,546
james,PR-1572,4,13,182,25,207
james,PR-1572,5,13,182,25,207
james,PR-1569,9,30,1145,9,1154
james,PR-1572,6,14,192,25,217
james,PR-1569,10,30,1145,9,1154
james,PR-1573,3,28,741,28,769
james,PR-1573,4,30,787,28,815
james,PR-1569,11,30,1145,9,1154
james,PR-1574,1,3,80,41,121
james,PR-1573,6,30,788,28,816
james,PR-1573,7,30,788,28,816
james,PR-1573,8,30,788,28,816
james,PR-1575,1,7,99,39,138
james,PR-1575,2,9,157,41,198
james,PR-1574,2,3,65,35,100
james,PR-1574,3,3,65,35,100
james,PR-1575,3,11,311,146,457
james,PR-1561,7,17,1511,53,1564
james,PR-1573,9,31,802,30,832
james,PR-1576,1,1,2,2,4
james,PR-1573,10,31,802,30,832
james,PR-1577,1,1,1,1,2
james,PR-1573,11,31,802,30,832
james,PR-1573,12,31,799,30,829
james,PR-1573,13,31,799,30,829
james,PR-1576,2,1,2,2,4
james,PR-1561,8,17,1566,99,1665
james,PR-1578,1,2,4,4,8
james,PR-1561,9,14,1416,101,1517
james,PR-1579,1,6,75,34,109
james,PR-1579,3,39,234,94,328
james,PR-1579,4,41,239,95,334
james,PR-1561,10,14,1621,106,1727
james,PR-1579,5,43,256,98,354
james,PR-1579,6,43,256,98,354
james,PR-1580,1,2,118,20,138
james,PR-1579,7,43,256,98,354
james,PR-1581,1,30,144,58,202
james,PR-1580,2,3,126,23,149
james,PR-1582,1,8,133,101,234
james,PR-1580,3,3,126,23,149
james,PR-1583,1,2,16,2,18
james,PR-1579,8,13,112,40,152
james,PR-1582,2,8,130,101,231
james,PR-1583,2,2,16,2,18
james,PR-1584,1,11,41,115,156
james,PR-1579,9,14,123,40,163
james,PR-1583,3,2,16,2,18
james,PR-1582,3,9,132,102,234
james,PR-1584,2,11,41,115,156
james,PR-1582,4,9,132,102,234
james,PR-1582,5,9,132,102,234
james,PR-1585,1,5,53,3,56
james,PR-1579,10,14,123,40,163
james,PR-1584,3,11,41,115,156
james,PR-1580,4,3,126,23,149
james,PR-1561,12,14,1874,52,1926
james,PR-1561,13,14,1874,52,1926
james,PR-1579,11,14,123,40,163
james,PR-1582,6,9,132,102,234
james,PR-1561,14,14,1867,47,1914
james,PR-1584,4,12,56,122,178
james,PR-1582,7,9,132,102,234
james,PR-1580,5,3,126,23,149
james,PR-1579,12,14,118,39,157
james,PR-1579,13,14,118,39,157
james,PR-1579,14,15,125,42,167
james,PR-1586,1,4,86,62,148
james,PR-1587,2,7,180,64,244
james,PR-1579,18,17,166,49,215
james,PR-1588,1,1,2,0,2
james,PR-1586,2,5,88,64,152
james,PR-1579,19,17,166,49,215
james,PR-1587,4,7,165,42,207
james,PR-1588,2,1,20,0,20
james,PR-1586,3,5,88,64,152
james,PR-1584,5,12,56,122,178
james,PR-1589,1,7,127,40,167
james,PR-1561,15,13,1869,46,1915
james,PR-1586,4,5,88,64,152
james,PR-1587,5,8,181,44,225
james,PR-1589,2,7,127,40,167
james,PR-1590,1,14,0,2323,2323
james,PR-1584,6,12,56,122,178
james,PR-1586,5,5,88,64,152
james,PR-1588,3,1,20,0,20
james,PR-1589,3,8,138,90,228
james,PR-1589,4,8,138,90,228
james,PR-1591,1,1,11,6,17
james,PR-1589,5,8,138,90,228
james,PR-1590,2,14,0,2323,2323
james,PR-1591,2,1,11,6,17
james,PR-1586,6,5,88,64,152
james,PR-1584,7,12,56,122,178
james,PR-1592,4,300,1433,478,1911
james,PR-1586,7,5,88,64,152
james,PR-1593,2,1,8,4,12
james,PR-1594,1,1,1,1,2
james,PR-1595,1,4,32,16,48
james,PR-1596,1,3,11,6,17
james,PR-1595,2,4,32,16,48
james,PR-1561,16,13,1869,46,1915
james,PR-1597,1,44,227,255,482
james,PR-1561,17,13,1869,46,1915
james,PR-1597,2,44,222,250,472
james,PR-1597,3,44,222,250,472
james,PR-1595,3,4,32,16,48
james,PR-1561,18,13,1869,46,1915
james,PR-1598,1,2,23,2,25
james,PR-1595,4,4,32,16,48
james,PR-1599,1,1,357,0,357
james,PR-1600,1,2,15,0,15
james,PR-1599,2,1,356,0,356
james,PR-1600,2,2,16,2,18
james,PR-1561,21,13,1862,50,1912
james,PR-1599,3,1,365,0,365
james,PR-1601,1,2,16,2,18
james,PR-1561,22,14,1857,50,1907
james,PR-1602,1,1,42,0,42
james,PR-1603,1,6,13,13,26
james,PR-1561,23,14,1855,47,1902
james,PR-1561,24,14,1855,47,1902
james,PR-1603,2,6,13,13,26
james,PR-1561,25,14,1851,46,1897
james,PR-1604,1,73,147,149,296
james,PR-1605,1,13,172,172,344
james,PR-1607,1,48,198,280,478
james,PR-1608,1,5,86,36,122
james,PR-1607,2,48,190,280,470
james,PR-1604,2,73,147,149,296
james,PR-1609,1,5,23,12,35
james,PR-1607,3,48,190,280,470
james,PR-1606,4,4,146,8,154
james,PR-1561,26,14,1843,37,1880
james,PR-1601,2,2,16,2,18
james,PR-1599,4,1,347,0,347
james,PR-1608,2,5,87,37,124
james,PR-1609,2,6,24,13,37
james,PR-1610,1,2,5,0,5
james,PR-1601,3,2,16,2,18
james,PR-1608,3,5,87,37,124
james,PR-1610,2,2,5,0,5
james,PR-1611,1,5,87,37,124
james,PR-1601,4,2,16,2,18
james,PR-1613,2,6,126,53,179
james,PR-1611,2,5,87,37,124
james,PR-1614,1,2,5,0,5
james,PR-1601,5,2,16,2,18
james,PR-1613,3,6,126,53,179
james,PR-1609,3,8,46,28,74
james,PR-1611,3,5,87,37,124
james,PR-1614,2,2,5,0,5
james,PR-1612,6,11,87,283,370
james,PR-1614,3,2,5,0,5
james,PR-1611,4,5,87,37,124
james,PR-1612,7,11,87,283,370
james,PR-1612,8,11,87,283,370
james,PR-1611,5,5,87,37,124
james,PR-1611,6,5,87,37,124
james,PR-1613,6,7,111,55,166
james,PR-1615,1,8,46,28,74
james,PR-1615,2,8,46,28,74
james,PR-1616,2,7,61,34,95
james,PR-1616,3,7,61,34,95
james,PR-1617,1,6,6,7,13
james,PR-1616,4,7,61,34,95
james,PR-1617,2,10,20,7,27
james,PR-1618,1,1,4,2,6
james,PR-1616,5,7,61,34,95
james,PR-1617,3,10,20,7,27
james,PR-1618,2,2,28,3,31
james,PR-1619,1,3,27,6,33
james,PR-1619,2,3,30,6,36
james,PR-1620,1,15,1844,37,1881
james,PR-1616,6,7,61,34,95
james,PR-1618,3,2,28,3,31
james,PR-1622,1,3,30,6,36
james,PR-1621,2,2,25,23,48
james,PR-1623,2,6,90,21,111
james,PR-1622,2,3,30,6,36
james,PR-1621,3,2,25,23,48
james,PR-1616,7,7,61,34,95
james,PR-1620,2,17,1849,37,1886
james,PR-1622,3,3,30,6,36
james,PR-1622,4,3,30,6,36
james,PR-1625,1,2,25,23,48
james,PR-1624,4,7,261,2,263
james,PR-1625,2,2,25,23,48
james,PR-1624,5,7,261,2,263
james,PR-1623,3,6,90,21,111
james,PR-1622,5,3,30,6,36
james,PR-1616,8,7,61,34,95
james,PR-1626,1,5,2,2,4
james,PR-1622,6,3,30,6,36
james,PR-1623,4,6,90,21,111
james,PR-1628,2,2,41,3,44
james,PR-1624,6,7,305,2,307
james,PR-1616,9,7,61,34,95
james,PR-1623,5,6,90,21,111
james,PR-1625,3,2,25,23,48
james,PR-1624,7,6,304,1,305
james,PR-1627,2,3,153,25,178
james,PR-1629,1,6,7,7,14
james,PR-1630,1,2,11,4,15
james,PR-1631,1,15,406,57,463
james,PR-1632,1,4,86,4,90
james,PR-1624,8,7,314,1,315
james,PR-1624,9,7,314,1,315
james,PR-1630,2,2,11,4,15
james,PR-1632,2,4,86,4,90
james,PR-1629,3,13,41,68,109
james,PR-1633,1,1,2,2,4
james,PR-1629,4,7,9,9,18
james,PR-1627,3,3,153,25,178
james,PR-1633,2,1,2,2,4
james,PR-1627,4,3,153,25,178
james,PR-1633,3,1,2,2,4
james,PR-1630,3,2,11,4,15
james,PR-1625,4,2,25,23,48
james,PR-1623,6,6,90,21,111
james,PR-1634,1,3,12,8,20
james,PR-1632,3,6,179,4,183
james,PR-1635,1,2,178,25,203
james,PR-1632,4,6,214,4,218
james,PR-1635,2,2,175,26,201
james,PR-1636,1,1,2,2,4
james,PR-1623,7,6,90,21,111
james,PR-1627,5,3,153,25,178
james,PR-1634,2,3,12,8,20
james,PR-1623,8,6,90,21,111
james,PR-1632,6,6,214,4,218
james,PR-1635,3,2,175,26,201
james,PR-1636,2,2,3,3,6
james,PR-1627,6,3,153,25,178
james,PR-1632,7,6,214,4,218
james,PR-1627,7,3,153,25,178
james,PR-1638,1,1,8,0,8
james,PR-1637,3,6,172,0,172
james,PR-1637,4,6,172,0,172
james,PR-1639,1,1,3,1,4
james,PR-1635,4,2,175,26,201
james,PR-1635,5,2,175,26,201
james,PR-1639,2,1,3,1,4
james,PR-1638,2,1,8,0,8
james,PR-1627,8,3,153,25,178
james,PR-1640,1,1,16,3,19
james,PR-1637,6,7,173,1,174
james,PR-1637,7,7,173,1,174
james,PR-1627,9,3,153,25,178
james,PR-1640,2,1,16,3,19
james,PR-1641,1,1,0,0,0
james,PR-1627,10,3,153,25,178
james,PR-1641,2,2,42,1,43
james,PR-1641,3,6,89,1,90
james,PR-1642,1,3,153,25,178
james,PR-1640,3,1,16,3,19
james,PR-1644,1,6,216,5,221
james,PR-1645,1,1,15,17,32
james,PR-1645,2,1,22,19,41
james,PR-1644,2,6,216,5,221
james,PR-1642,2,3,153,25,178
james,PR-1640,4,1,16,3,19
james,PR-1640,5,1,16,3,19
james,PR-1623,9,6,93,32,125
james,PR-1644,4,6,216,5,221
james,PR-1640,7,1,16,3,19
james,PR-1643,10,16,668,141,809
james,PR-1646,1,10,218,10,228
james,PR-1647,1,4,52,46,98
james,PR-1647,2,20,97,79,176
james,PR-1646,2,10,218,10,228
james,PR-1644,5,6,216,5,221
james,PR-1640,8,1,16,3,19
james,PR-1643,11,16,668,141,809
james,PR-1643,12,16,668,141,809
james,PR-1640,9,1,16,3,19
james,PR-1623,10,6,93,32,125
james,PR-1647,3,20,113,82,195
james,PR-1623,11,6,93,32,125
james,PR-1647,4,41,152,403,555
james,PR-1643,13,16,668,141,809
james,PR-1648,1,4,70,56,126
james,PR-1649,1,5,260,28,288
james,PR-1647,5,70,260,482,742
james,PR-1650,1,1,1,0,1
james,PR-1650,2,1,1,0,1
james,PR-1650,3,1,1,0,1
james,PR-1648,2,8,76,61,137
james,PR-1649,2,8,356,30,386
james,PR-1643,15,16,668,141,809
james,PR-1648,3,8,76,61,137
james,PR-1649,3,8,366,30,396
james,PR-1647,8,98,643,663,1306
james,PR-1649,4,8,366,30,396
james,PR-1647,9,110,659,993,1652
james,PR-1648,4,5,72,58,130
james,PR-1647,10,113,672,1006,1678
james,PR-1647,11,113,680,1014,1694
james,PR-1649,5,8,366,30,396
james,PR-1650,4,1,1,0,1
james,PR-1623,12,6,98,37,135
james,PR-1647,12,113,680,1014,1694
james,PR-1623,13,6,101,38,139
james,PR-1652,3,29,374,145,519
james,PR-1623,14,6,101,38,139
james,PR-1647,13,125,866,1274,2140
james,PR-1653,1,1,8,1,9
james,PR-1623,15,6,101,38,139
james,PR-1647,14,125,866,1274,2140
james,PR-1653,2,1,10,1,11
james,PR-1654,1,125,867,1275,2142
james,PR-1652,4,33,845,160,1005
james,PR-1652,5,34,843,149,992
james,PR-1654,2,125,867,1275,2142
james,PR-1652,6,33,837,145,982
james,PR-1654,3,125,867,1275,2142
james,PR-1647,15,125,866,1274,2140
james,PR-1655,1,28,119,324,443
james,PR-1656,1,67,478,517,995
james,PR-1657,1,8,50,34,84
james,PR-1651,2,20,440,107,547
james,PR-1651,3,19,439,107,546
james,PR-1655,2,28,119,324,443
james,PR-1657,2,9,54,34,88
james,PR-1657,3,10,58,35,93
james,PR-1655,3,29,119,325,444
james,PR-1655,4,32,148,329,477
james,PR-1655,5,32,151,329,480
james,PR-1652,7,33,837,145,982
james,PR-1650,5,1,1,0,1
james,PR-1657,4,10,58,35,93
james,PR-1655,6,31,150,327,477
james,PR-1657,5,13,88,39,127
james,PR-1654,4,18,62,34,96
kafka,PR-9590,2,7,297,57,354
kafka,PR-9590,4,7,308,57,365
kafka,PR-9590,5,7,236,57,293
kafka,PR-9631,1,1,11,10,21
kafka,PR-9638,1,1,0,1,1
kafka,PR-9640,1,3,76,69,145
kafka,PR-9640,2,3,87,70,157
kafka,PR-9627,5,7,29,18,47
kafka,PR-9656,2,3,144,0,144
kafka,PR-9620,3,29,247,251,498
kafka,PR-9662,2,11,355,193,548
kafka,PR-9670,1,3,10,9,19
kafka,PR-9670,2,3,10,9,19
kafka,PR-9670,3,3,10,9,19
kafka,PR-9584,7,3,28,5,33
kafka,PR-8978,7,2,42,3,45
kafka,PR-9690,1,2,199,174,373
kafka,PR-9690,2,2,199,174,373
kafka,PR-9694,2,2,2,5,7
kafka,PR-9690,3,2,208,175,383
kafka,PR-9128,2,2,16,5,21
kafka,PR-9517,2,1,2,0,2
kafka,PR-9690,4,2,208,175,383
kafka,PR-9707,7,2,48,3,51
kafka,PR-9725,2,3,113,5,118
kafka,PR-9734,2,138,499,331,830
kafka,PR-9744,1,20,201,12,213
kafka,PR-9641,5,22,1095,1390,2485
kafka,PR-9703,8,1,1,1,2
kafka,PR-9764,1,3,5,6,11
kafka,PR-9764,2,3,2,7,9
kafka,PR-9744,2,27,241,60,301
kafka,PR-9686,6,1,21,16,37
kafka,PR-9744,3,27,242,60,302
kafka,PR-9786,1,3,5,4,9
kafka,PR-9789,1,2,78,57,135
kafka,PR-9790,1,1,14,7,21
kafka,PR-9790,2,1,8,8,16
kafka,PR-9790,4,2,32,9,41
kafka,PR-9790,5,2,33,9,42
kafka,PR-9794,1,3,18,5,23
kafka,PR-9590,6,9,320,61,381
kafka,PR-9590,8,9,320,61,381
kafka,PR-9796,3,7,1028,607,1635
kafka,PR-9796,4,7,1022,605,1627
kafka,PR-9590,9,14,380,64,444
kafka,PR-9803,1,1,2,3,5
kafka,PR-9815,2,6,88,79,167
kafka,PR-9817,1,1,6,1,7
kafka,PR-9744,4,28,240,63,303
kafka,PR-9789,5,4,119,60,179
kafka,PR-9789,6,4,120,60,180
kafka,PR-9712,7,4,7,4,11
kafka,PR-9825,1,1,9,3,12
kafka,PR-9822,1,2,424,102,526
kafka,PR-7561,11,106,11464,194,11658
kafka,PR-9809,5,5,73,19,92
kafka,PR-9851,1,3,5,18,23
kafka,PR-9851,2,3,18,39,57
kafka,PR-9851,3,3,18,39,57
kafka,PR-9861,1,3,5,5,10
kafka,PR-9864,1,1,9,4,13
kafka,PR-9865,1,1,22,0,22
kafka,PR-9872,1,1,18,0,18
kafka,PR-9640,4,3,94,61,155
kafka,PR-9640,5,3,95,61,156
kafka,PR-9758,10,40,1275,1038,2313
kafka,PR-9858,2,60,1008,589,1597
kafka,PR-9640,6,4,134,85,219
kafka,PR-9640,7,3,125,76,201
kafka,PR-9640,8,3,125,76,201
kafka,PR-9758,11,40,1273,1038,2311
kafka,PR-9858,3,60,1008,590,1598
kafka,PR-9902,1,9,332,35,367
kafka,PR-9908,2,58,161,153,314
kafka,PR-9758,12,40,1273,1038,2311
kafka,PR-9915,1,16,513,145,658
kafka,PR-9920,1,4,26,1,27
kafka,PR-9744,5,28,233,64,297
kafka,PR-9758,15,40,1276,1038,2314
kafka,PR-9758,16,40,1276,1041,2317
kafka,PR-9858,4,60,1008,589,1597
kafka,PR-9858,5,61,1008,590,1598
kafka,PR-9758,17,39,1275,1044,2319
kafka,PR-9758,18,39,1220,989,2209
kafka,PR-9758,19,42,1214,983,2197
kafka,PR-9744,6,30,252,76,328
kafka,PR-9744,7,30,278,84,362
kafka,PR-9858,6,61,1008,590,1598
kafka,PR-9758,20,42,1214,983,2197
kafka,PR-9758,21,42,1214,983,2197
kafka,PR-9508,27,18,467,9,476
kafka,PR-9915,2,16,515,146,661
kafka,PR-9912,6,11,401,461,862
kafka,PR-9944,1,49,2013,529,2542
kafka,PR-9858,7,61,1008,590,1598
kafka,PR-9758,22,42,1214,983,2197
kafka,PR-9912,7,11,401,461,862
kafka,PR-9954,1,10,277,109,386
kafka,PR-9744,8,31,281,88,369
kafka,PR-9744,9,31,356,88,444
kafka,PR-9954,2,10,273,109,382
kafka,PR-9954,3,10,273,109,382
kafka,PR-9950,2,2,44,1,45
kafka,PR-9641,6,22,1095,1390,2485
kafka,PR-9641,7,22,1096,1390,2486
kafka,PR-9641,8,23,1112,1425,2537
kafka,PR-9641,9,23,1112,1425,2537
kafka,PR-9641,10,23,1111,1425,2536
kafka,PR-9641,11,23,1112,1425,2537
kafka,PR-9641,12,23,1069,1429,2498
kafka,PR-9229,1,26,441,267,708
kafka,PR-9229,2,27,457,269,726
kafka,PR-9229,3,27,483,285,768
kafka,PR-9973,1,1,1,1,2
kafka,PR-9944,2,49,2711,650,3361
kafka,PR-9641,15,23,1054,1411,2465
kafka,PR-9758,23,42,1214,983,2197
kafka,PR-9986,1,22,1380,111,1491
kafka,PR-9987,1,2,46,3,49
kafka,PR-9915,3,16,515,146,661
kafka,PR-9982,3,1,1,2,3
kafka,PR-9978,5,3,354,204,558
kafka,PR-9988,1,1,1,1,2
kafka,PR-9508,28,18,467,9,476
kafka,PR-9508,29,18,467,9,476
kafka,PR-9508,30,18,467,9,476
kafka,PR-9508,31,18,467,9,476
kafka,PR-9508,32,18,467,9,476
kafka,PR-9508,33,18,467,10,477
kafka,PR-9987,2,2,79,3,82
kafka,PR-9992,1,1,15,0,15
kafka,PR-9992,3,1,21,4,25
kafka,PR-9993,1,1,1,1,2
kafka,PR-9996,2,13,351,1,352
kafka,PR-9944,4,50,2915,659,3574
kafka,PR-9744,10,31,356,88,444
kafka,PR-9998,1,5,184,0,184
kafka,PR-9906,12,2,593,642,1235
kafka,PR-9906,13,2,595,645,1240
kafka,PR-9508,34,18,467,10,477
kafka,PR-10002,1,1,44,44,88
kafka,PR-9992,4,1,23,4,27
kafka,PR-10003,1,15,83,51,134
kafka,PR-10003,2,16,112,58,170
kafka,PR-10004,1,1,1,1,2
kafka,PR-9944,5,50,2919,659,3578
kafka,PR-9978,9,9,523,261,784
kafka,PR-9992,5,1,23,4,27
kafka,PR-9978,10,9,529,261,790
kafka,PR-10005,1,10,300,33,333
kafka,PR-9992,6,1,23,4,27
kafka,PR-9944,6,50,2926,658,3584
kafka,PR-9902,2,9,321,55,376
kafka,PR-9944,7,48,2849,644,3493
kafka,PR-9944,8,48,2846,644,3490
kafka,PR-10005,2,20,850,423,1273
kafka,PR-10005,4,17,976,461,1437
kafka,PR-10003,3,15,106,50,156
kafka,PR-10008,1,6,38,53,91
kafka,PR-10008,2,6,39,53,92
kafka,PR-10009,1,5,43,37,80
kafka,PR-10011,1,1,0,42,42
kafka,PR-9906,14,2,557,605,1162
kafka,PR-9758,24,42,1214,984,2198
kafka,PR-10008,3,3,63,15,78
kafka,PR-9992,7,1,23,4,27
kafka,PR-10008,4,7,117,32,149
kafka,PR-10008,5,7,103,32,135
kafka,PR-9986,5,24,1519,112,1631
kafka,PR-10018,1,7,805,1,806
kafka,PR-10019,1,5,160,54,214
kafka,PR-9978,12,9,499,234,733
kafka,PR-9996,3,16,444,1,445
kafka,PR-9508,35,18,467,10,477
kafka,PR-9996,4,17,554,23,577
kafka,PR-9641,16,23,1054,1411,2465
kafka,PR-9758,25,42,1211,981,2192
kafka,PR-10009,2,5,43,37,80
kafka,PR-9107,16,20,1103,72,1175
kafka,PR-9107,17,20,1097,72,1169
kafka,PR-10003,5,15,119,55,174
kafka,PR-9996,5,17,475,13,488
kafka,PR-10024,1,1,4,2,6
kafka,PR-9996,6,17,478,13,491
kafka,PR-10025,1,16,175,111,286
kafka,PR-10026,1,7,250,93,343
kafka,PR-10003,7,15,118,57,175
kafka,PR-9996,7,17,445,13,458
kafka,PR-10003,8,15,118,57,175
kafka,PR-10027,1,2,37,2,39
kafka,PR-10029,1,2,32,1,33
kafka,PR-10019,2,3,130,44,174
kafka,PR-10009,3,5,45,37,82
kafka,PR-10009,4,5,45,37,82
kafka,PR-9996,8,18,585,13,598
kafka,PR-9798,1,1,14,1,15
kafka,PR-10003,10,15,118,57,175
kafka,PR-9996,9,17,516,13,529
kafka,PR-10029,2,2,32,1,33
kafka,PR-10027,2,2,37,2,39
kafka,PR-10026,2,7,250,93,343
kafka,PR-10024,2,1,4,2,6
kafka,PR-10019,3,3,130,44,174
kafka,PR-10011,2,1,0,42,42
kafka,PR-10009,5,5,45,37,82
kafka,PR-10008,6,7,103,32,135
kafka,PR-10005,5,17,976,461,1437
kafka,PR-10004,2,1,1,1,2
kafka,PR-10002,2,1,44,44,88
kafka,PR-9998,2,5,184,0,184
kafka,PR-9993,2,1,1,1,2
kafka,PR-9992,8,1,23,4,27
kafka,PR-9987,3,2,79,3,82
kafka,PR-9986,6,24,1519,112,1631
kafka,PR-9982,4,1,1,2,3
kafka,PR-9978,13,9,499,234,733
kafka,PR-9973,2,1,1,1,2
kafka,PR-9954,4,10,273,109,382
kafka,PR-9950,3,2,44,1,45
kafka,PR-9929,1,1,15,3,18
kafka,PR-9920,2,4,26,1,27
kafka,PR-9915,4,16,515,146,661
kafka,PR-9906,15,2,557,605,1162
kafka,PR-9902,3,9,321,55,376
kafka,PR-9872,2,1,18,0,18
kafka,PR-9865,2,1,22,0,22
kafka,PR-9864,2,1,9,4,13
kafka,PR-9861,2,3,5,5,10
kafka,PR-9851,4,3,18,39,57
kafka,PR-9825,2,1,9,3,12
kafka,PR-9809,6,5,73,19,92
kafka,PR-10034,3,2,2,2,4
kafka,PR-10036,1,1,1,1,2
kafka,PR-10024,4,2,30,7,37
kafka,PR-10009,6,5,45,37,82
kafka,PR-9996,11,17,509,13,522
kafka,PR-9998,3,5,184,0,184
kafka,PR-9508,37,18,467,10,477
kafka,PR-10008,7,11,56,68,124
kafka,PR-10009,7,5,45,37,82
kafka,PR-10008,8,11,67,75,142
kafka,PR-10037,1,1,0,1,1
kafka,PR-10024,5,2,30,7,37
kafka,PR-10038,1,1,0,53,53
kafka,PR-9992,9,1,23,4,27
kafka,PR-10008,9,11,68,76,144
kafka,PR-10028,3,16,56,128,184
kafka,PR-10032,3,5,192,24,216
kafka,PR-10040,1,2,4,3,7
kafka,PR-9107,19,20,1097,72,1169
kafka,PR-10018,4,7,799,1,800
kafka,PR-10019,4,4,159,48,207
kafka,PR-10018,5,7,795,1,796
kafka,PR-10018,6,7,795,1,796
kafka,PR-9998,5,13,230,39,269
kafka,PR-9998,6,13,234,39,273
kafka,PR-10005,8,15,588,244,832
kafka,PR-10040,2,4,10,10,20
kafka,PR-9998,7,13,258,39,297
kafka,PR-9998,8,13,257,39,296
kafka,PR-9987,4,2,79,3,82
kafka,PR-10008,10,11,68,76,144
kafka,PR-10044,1,2,3,3,6
kafka,PR-10046,1,1,13,8,21
kafka,PR-10046,2,1,13,8,21
kafka,PR-9997,3,8,328,63,391
kafka,PR-10019,5,4,162,51,213
kafka,PR-10047,1,6,268,4,272
kafka,PR-10048,1,2,8,9,17
kafka,PR-10033,2,1,2,3,5
kafka,PR-10049,1,7,239,302,541
kafka,PR-10005,10,24,702,291,993
kafka,PR-10050,1,1,14,9,23
kafka,PR-10008,11,11,68,76,144
kafka,PR-10019,6,4,162,51,213
kafka,PR-9867,6,50,983,1637,2620
kafka,PR-9902,4,10,400,69,469
kafka,PR-10005,11,29,724,337,1061
kafka,PR-10005,12,29,728,340,1068
kafka,PR-10005,13,29,736,357,1093
kafka,PR-10053,3,41,238,240,478
kafka,PR-9726,3,6,111,0,111
kafka,PR-10053,4,41,233,240,473
kafka,PR-10054,1,1,13,3,16
kafka,PR-10005,14,29,736,357,1093
kafka,PR-10055,2,8,168,34,202
kafka,PR-10008,12,11,68,75,143
kafka,PR-10059,1,3,65,42,107
kafka,PR-9726,4,6,112,0,112
kafka,PR-10045,3,7,419,72,491
kafka,PR-10039,5,10,65,63,128
kafka,PR-10039,6,10,67,65,132
kafka,PR-10061,1,10,396,66,462
kafka,PR-10062,3,2,39,0,39
kafka,PR-10060,2,9,412,179,591
kafka,PR-9726,5,6,112,0,112
kafka,PR-9579,33,21,1070,228,1298
kafka,PR-10046,3,1,13,8,21
kafka,PR-10000,6,10,223,169,392
kafka,PR-10060,3,9,414,179,593
kafka,PR-10048,5,2,8,9,17
kafka,PR-10067,1,10,398,63,461
kafka,PR-10061,2,10,396,66,462
kafka,PR-10002,3,1,231,231,462
kafka,PR-10051,4,1,5,0,5
kafka,PR-10068,1,2,5,5,10
kafka,PR-10068,2,7,13,13,26
kafka,PR-10061,3,10,396,66,462
kafka,PR-10062,4,2,39,0,39
kafka,PR-10068,3,2,5,5,10
kafka,PR-10068,4,2,5,5,10
kafka,PR-10069,1,4,635,99,734
kafka,PR-9986,8,25,1690,112,1802
kafka,PR-10049,3,19,583,88,671
kafka,PR-10045,4,5,343,67,410
kafka,PR-10045,5,5,341,68,409
kafka,PR-10049,4,19,584,90,674
kafka,PR-9986,9,25,1693,112,1805
kafka,PR-10039,7,10,67,65,132
kafka,PR-10069,2,5,679,100,779
kafka,PR-10072,1,7,104,134,238
kafka,PR-9579,38,22,1153,234,1387
kafka,PR-10069,3,5,674,99,773
kafka,PR-9579,39,22,1152,234,1386
kafka,PR-10073,1,2,20,1,21
kafka,PR-10074,1,2,5,3,8
kafka,PR-9579,40,22,1152,234,1386
kafka,PR-9579,41,32,1323,457,1780
kafka,PR-10002,4,1,234,234,468
kafka,PR-9579,42,32,1324,457,1781
kafka,PR-9579,44,32,1324,457,1781
kafka,PR-10069,4,5,667,102,769
kafka,PR-9579,45,32,1334,467,1801
kafka,PR-10069,5,5,667,102,769
kafka,PR-9210,5,7,573,250,823
kafka,PR-9744,12,24,332,57,389
kafka,PR-9744,13,24,332,57,389
kafka,PR-9744,14,24,319,44,363
kafka,PR-10054,2,1,13,3,16
kafka,PR-10069,7,7,842,103,945
kafka,PR-10054,3,1,13,3,16
kafka,PR-10077,1,3,102,27,129
kafka,PR-10073,2,2,45,1,46
kafka,PR-10078,1,8,27,33,60
kafka,PR-10039,8,19,240,248,488
kafka,PR-10039,9,19,245,242,487
kafka,PR-10039,10,19,245,242,487
kafka,PR-10080,1,7,18,16,34
kafka,PR-9906,16,2,557,605,1162
kafka,PR-9906,17,2,554,604,1158
kafka,PR-10079,5,16,49,39,88
kafka,PR-10079,6,16,49,39,88
kafka,PR-10081,1,1,1,1,2
kafka,PR-10078,2,8,27,33,60
kafka,PR-10082,1,5,27,24,51
kafka,PR-10012,6,3,22,13,35
kafka,PR-9990,3,2,23,2,25
kafka,PR-10041,5,13,59,36,95
kafka,PR-10069,8,8,909,109,1018
kafka,PR-9780,8,14,810,64,874
kafka,PR-10083,1,1,0,3,3
kafka,PR-9906,19,2,555,605,1160
kafka,PR-9865,3,1,8,0,8
kafka,PR-10047,2,6,268,4,272
kafka,PR-10043,3,4,445,3,448
kafka,PR-10069,9,8,990,109,1099
kafka,PR-10069,10,8,1005,109,1114
kafka,PR-9986,10,25,1691,111,1802
kafka,PR-10041,6,13,64,54,118
kafka,PR-10085,1,13,475,75,550
kafka,PR-10086,1,1,5,3,8
kafka,PR-9780,10,14,808,64,872
kafka,PR-10035,2,1,4,4,8
kafka,PR-10080,2,7,18,16,34
kafka,PR-9780,11,14,808,64,872
kafka,PR-9986,11,25,1690,111,1801
kafka,PR-10087,1,1,3,3,6
kafka,PR-10088,1,1,4,4,8
kafka,PR-10088,2,2,4,58,62
kafka,PR-10087,2,2,3,57,60
kafka,PR-10041,7,13,70,54,124
kafka,PR-10089,1,2,60,1,61
kafka,PR-10064,2,10,398,63,461
kafka,PR-10065,2,10,398,63,461
kafka,PR-10069,11,6,983,103,1086
kafka,PR-10092,1,2,15,0,15
kafka,PR-10092,2,2,15,0,15
kafka,PR-10093,1,8,930,64,994
kafka,PR-10095,1,4,690,1,691
kafka,PR-10096,1,7,122,68,190
kafka,PR-9744,15,24,316,44,360
kafka,PR-8656,6,1,5,1,6
kafka,PR-10097,1,2,9,6,15
kafka,PR-10097,2,2,9,6,15
kafka,PR-10093,2,8,930,64,994
kafka,PR-9430,14,7,792,96,888
kafka,PR-10074,2,3,26,5,31
kafka,PR-10098,1,2,9,1,10
kafka,PR-10099,1,1,1,1,2
kafka,PR-10069,12,6,961,107,1068
kafka,PR-10041,8,13,70,54,124
kafka,PR-10100,1,13,70,54,124
kafka,PR-10095,2,4,714,1,715
kafka,PR-10091,4,2,18,4,22
kafka,PR-10084,3,20,148,145,293
kafka,PR-10101,2,3,923,0,923
kafka,PR-10102,1,2,120,2,122
kafka,PR-10084,4,20,151,145,296
kafka,PR-10085,2,14,524,76,600
kafka,PR-10102,2,2,117,2,119
kafka,PR-10103,1,2,113,10,123
kafka,PR-10104,1,2,113,11,124
kafka,PR-10085,3,14,549,89,638
kafka,PR-10094,4,45,4555,3,4558
kafka,PR-10106,1,8,952,0,952
kafka,PR-10090,2,11,1371,0,1371
kafka,PR-10090,3,11,1371,0,1371
kafka,PR-10106,2,16,1721,0,1721
kafka,PR-10102,3,2,118,3,121
kafka,PR-10097,3,3,15,9,24
kafka,PR-10107,1,1,15,6,21
kafka,PR-10063,2,6,284,101,385
kafka,PR-10099,2,7,7,13,20
kafka,PR-10099,3,8,7,14,21
kafka,PR-10077,2,3,102,27,129
kafka,PR-10024,6,2,30,7,37
kafka,PR-9430,15,7,792,96,888
kafka,PR-10109,2,10,398,63,461
kafka,PR-10108,4,10,398,63,461
kafka,PR-9930,3,1,1,1,2
kafka,PR-10106,3,16,1729,0,1729
kafka,PR-10107,2,1,14,5,19
kafka,PR-10111,1,7,269,0,269
kafka,PR-10111,2,7,269,0,269
kafka,PR-10107,3,1,14,5,19
kafka,PR-10112,1,3,256,14,270
kafka,PR-10113,1,29,979,103,1082
kafka,PR-10113,2,27,963,95,1058
kafka,PR-10112,2,3,153,14,167
kafka,PR-10115,1,1,1,1,2
kafka,PR-10114,3,3,114,18,132
kafka,PR-10113,3,27,950,95,1045
kafka,PR-10097,4,3,15,9,24
kafka,PR-10117,1,1,11,11,22
kafka,PR-10118,1,1,1,1,2
kafka,PR-10119,1,24,227,956,1183
kafka,PR-10119,2,24,227,956,1183
kafka,PR-10120,1,2,3,3,6
kafka,PR-10113,4,26,847,77,924
kafka,PR-10082,2,5,27,24,51
kafka,PR-10082,3,11,37,34,71
kafka,PR-10121,1,6,0,394,394
kafka,PR-10119,3,24,227,956,1183
kafka,PR-10122,1,1,1,1,2
kafka,PR-9798,3,1,14,1,15
kafka,PR-9758,27,42,1219,989,2208
kafka,PR-9758,28,42,1218,989,2207
kafka,PR-10113,5,26,846,77,923
kafka,PR-10119,4,24,227,956,1183
kafka,PR-10110,2,2,28,3,31
kafka,PR-10110,3,2,28,3,31
kafka,PR-10123,1,9,149,77,226
kafka,PR-10123,2,31,174,102,276
kafka,PR-10123,3,31,172,95,267
kafka,PR-10123,4,31,171,95,266
kafka,PR-10123,5,31,171,95,266
kafka,PR-9229,5,28,501,320,821
kafka,PR-10113,7,28,872,83,955
kafka,PR-10125,1,1,8,4,12
kafka,PR-10127,2,1,0,10,10
kafka,PR-10113,8,32,977,95,1072
kafka,PR-10113,9,32,1047,106,1153
kafka,PR-10063,3,6,365,109,474
kafka,PR-10063,4,6,360,114,474
kafka,PR-10113,11,35,1065,109,1174
kafka,PR-10128,1,2,7,32,39
kafka,PR-10130,1,1,1,1,2
kafka,PR-10113,12,35,1065,109,1174
kafka,PR-10082,4,11,37,34,71
kafka,PR-10082,5,11,39,36,75
kafka,PR-10024,7,2,30,7,37
kafka,PR-10132,1,1,19,12,31
kafka,PR-10085,4,15,613,97,710
kafka,PR-10113,13,35,972,94,1066
kafka,PR-10133,1,2,5,1,6
kafka,PR-10113,15,36,1112,191,1303
kafka,PR-10113,16,39,1906,201,2107
kafka,PR-10134,1,1,1,1,2
kafka,PR-9670,5,3,10,9,19
kafka,PR-10136,1,2,2,0,2
kafka,PR-10137,1,23,167,543,710
kafka,PR-9758,29,42,1218,988,2206
kafka,PR-10139,1,2,4,4,8
kafka,PR-10136,2,2,2,0,2
kafka,PR-10140,1,10,15,176,191
kafka,PR-10124,5,23,53,45,98
kafka,PR-10125,2,1,8,4,12
kafka,PR-10113,17,39,1906,201,2107
kafka,PR-10138,3,10,171,82,253
kafka,PR-10070,7,51,6796,23,6819
kafka,PR-10143,1,2,104,49,153
kafka,PR-10138,6,10,178,82,260
kafka,PR-10143,2,5,129,30,159
kafka,PR-10144,1,1,1,1,2
kafka,PR-10091,5,2,18,4,22
kafka,PR-10138,7,10,190,82,272
kafka,PR-10105,25,91,8779,224,9003
kafka,PR-10024,8,2,30,7,37
kafka,PR-9758,30,42,1218,988,2206
kafka,PR-10113,20,39,1908,202,2110
kafka,PR-10072,2,12,141,185,326
kafka,PR-10151,1,1,1,1,2
kafka,PR-10155,1,3,10,2,12
kafka,PR-10149,1,1,1,1,2
kafka,PR-10148,1,1,2,2,4
kafka,PR-10158,1,4,147,42,189
kafka,PR-9950,4,2,32,1,33
kafka,PR-10152,1,2,47,8,55
kafka,PR-10112,3,3,153,14,167
kafka,PR-10153,1,3,51,6,57
kafka,PR-10143,3,5,134,30,164
kafka,PR-10105,26,70,7033,112,7145
kafka,PR-10143,4,5,129,30,159
kafka,PR-10143,5,5,129,30,159
kafka,PR-10143,6,5,129,30,159
kafka,PR-10145,2,1,1,1,2
kafka,PR-10052,4,2,168,1,169
kafka,PR-9235,4,2,12,2,14
kafka,PR-9631,3,1,11,10,21
kafka,PR-10163,2,3,373,114,487
kafka,PR-10105,27,89,7319,277,7596
kafka,PR-10070,10,55,6868,36,6904
kafka,PR-10105,28,91,7384,287,7671
kafka,PR-10145,4,1,1,1,2
kafka,PR-10024,9,2,30,7,37
kafka,PR-9235,5,2,16,4,20
kafka,PR-9590,11,14,384,65,449
kafka,PR-10105,30,44,516,250,766
kafka,PR-10105,31,43,515,249,764
kafka,PR-9758,32,43,1218,989,2207
kafka,PR-10140,2,10,15,176,191
kafka,PR-10164,1,1,0,25,25
kafka,PR-10165,1,1,4,4,8
kafka,PR-10166,1,1,1,1,2
kafka,PR-10168,1,1,0,1,1
kafka,PR-10170,1,2,81,15,96
kafka,PR-10157,4,10,247,45,292
kafka,PR-10024,10,2,30,7,37
kafka,PR-10171,1,3,21,21,42
kafka,PR-10172,1,1,27,3,30
kafka,PR-10024,11,2,29,7,36
kafka,PR-10024,12,2,29,7,36
kafka,PR-10173,1,12,1326,0,1326
kafka,PR-10174,1,2,25,14,39
kafka,PR-10175,1,43,507,246,753
kafka,PR-10177,1,1,1,1,2
kafka,PR-10157,5,10,247,45,292
kafka,PR-10137,2,23,167,543,710
kafka,PR-10175,2,47,530,258,788
kafka,PR-10105,32,47,538,261,799
kafka,PR-10105,33,47,538,261,799
kafka,PR-10175,3,47,530,258,788
kafka,PR-10178,1,3,0,3,3
kafka,PR-9912,9,13,413,476,889
kafka,PR-10179,1,2,6,6,12
kafka,PR-10180,1,3,24,1,25
kafka,PR-10181,1,2,72,72,144
kafka,PR-10181,2,2,5,5,10
kafka,PR-10169,3,4,4,4,8
kafka,PR-9958,3,6,609,435,1044
kafka,PR-9912,10,13,449,512,961
kafka,PR-10182,1,1,0,8,8
kafka,PR-9912,11,13,449,512,961
kafka,PR-9958,4,6,609,435,1044
kafka,PR-10185,1,1,70,37,107
kafka,PR-10187,1,1,5,0,5
kafka,PR-10179,2,2,11,6,17
kafka,PR-10170,2,2,100,15,115
kafka,PR-10172,2,1,27,3,30
kafka,PR-10188,1,1,1,1,2
kafka,PR-9950,6,2,34,1,35
kafka,PR-9758,33,43,1218,989,2207
kafka,PR-10191,2,2,7,8,15
kafka,PR-9992,10,1,23,4,27
kafka,PR-10191,3,2,7,8,15
kafka,PR-9758,34,45,1175,1014,2189
kafka,PR-9758,35,45,1175,1014,2189
kafka,PR-10193,1,1,1,1,2
kafka,PR-10170,3,2,100,15,115
kafka,PR-10137,3,23,203,571,774
kafka,PR-10195,1,1,9,9,18
kafka,PR-10186,2,8,13,13,26
kafka,PR-10197,1,2,25,17,42
kafka,PR-10183,5,20,661,25,686
kafka,PR-10198,1,1,1,1,2
kafka,PR-10167,3,1,8,1,9
kafka,PR-10173,2,12,1326,0,1326
kafka,PR-10200,1,9,479,86,565
kafka,PR-10183,6,20,661,25,686
kafka,PR-10170,4,2,99,15,114
kafka,PR-10171,2,3,21,21,42
kafka,PR-10140,3,10,15,176,191
kafka,PR-9847,6,5,137,13,150
kafka,PR-10201,1,1,1,1,2
kafka,PR-9972,14,9,109,88,197
kafka,PR-9826,4,1,25,5,30
kafka,PR-9441,8,6,109,36,145
kafka,PR-10202,1,1,1,1,2
kafka,PR-10202,2,1,1,1,2
kafka,PR-10204,1,1,1,1,2
kafka,PR-10183,7,20,669,29,698
kafka,PR-10059,2,3,65,42,107
kafka,PR-10051,5,1,5,0,5
kafka,PR-10199,3,8,133,52,185
kafka,PR-10199,4,6,111,30,141
kafka,PR-9851,5,3,18,36,54
kafka,PR-9851,6,3,19,37,56
kafka,PR-10206,1,18,550,32,582
kafka,PR-10203,2,2,390,391,781
kafka,PR-10203,3,2,394,395,789
kafka,PR-10206,2,20,555,32,587
kafka,PR-10206,3,20,549,32,581
kafka,PR-10052,5,2,170,1,171
kafka,PR-10052,6,2,170,1,171
kafka,PR-10162,6,1,16,4,20
kafka,PR-10059,3,5,71,48,119
kafka,PR-8259,3,4,477,10,487
kafka,PR-9717,9,1,440,0,440
kafka,PR-10207,1,1,2,1,3
kafka,PR-10203,4,6,411,397,808
kafka,PR-9847,7,7,141,14,155
kafka,PR-10199,5,8,117,30,147
kafka,PR-10203,5,6,411,397,808
kafka,PR-9758,37,45,1175,1014,2189
kafka,PR-8812,2,2,31,14,45
kafka,PR-10210,1,1,44,43,87
kafka,PR-8812,3,2,34,14,48
kafka,PR-10210,2,1,3,2,5
kafka,PR-10205,2,1,14,16,30
kafka,PR-9958,5,6,609,435,1044
kafka,PR-10199,6,11,232,54,286
kafka,PR-10112,4,3,154,15,169
kafka,PR-8812,5,3,39,15,54
kafka,PR-10059,4,7,62,57,119
kafka,PR-10179,3,3,12,7,19
kafka,PR-10194,3,27,67,132,199
kafka,PR-10199,7,11,231,55,286
kafka,PR-10194,4,28,68,134,202
kafka,PR-10206,4,20,549,32,581
kafka,PR-10194,5,27,67,133,200
kafka,PR-10194,6,28,68,134,202
kafka,PR-10211,6,8,79,60,139
kafka,PR-10213,1,1,3,1,4
kafka,PR-10213,2,1,5,3,8
kafka,PR-10214,1,1,1,1,2
kafka,PR-10162,7,1,16,4,20
kafka,PR-10215,2,2,34,12,46
kafka,PR-9758,38,45,1175,1014,2189
kafka,PR-10216,1,2,24,1,25
kafka,PR-10212,2,2,142,32,174
kafka,PR-10217,4,2,92,28,120
kafka,PR-10217,5,2,94,28,122
kafka,PR-10217,6,2,94,28,122
kafka,PR-9950,8,2,27,1,28
kafka,PR-10203,6,6,411,397,808
kafka,PR-10199,8,11,305,45,350
kafka,PR-10203,7,7,423,398,821
kafka,PR-10199,9,10,272,44,316
kafka,PR-10219,1,2,122,36,158
kafka,PR-10014,6,3,112,7,119
kafka,PR-10016,7,12,93,25,118
kafka,PR-10203,8,7,423,398,821
kafka,PR-10199,10,10,273,47,320
kafka,PR-10016,8,12,95,25,120
kafka,PR-10016,9,12,95,25,120
kafka,PR-10016,10,12,98,24,122
kafka,PR-10217,7,2,94,28,122
kafka,PR-10217,8,2,92,29,121
kafka,PR-10214,3,1,1,1,2
kafka,PR-10212,5,2,132,26,158
kafka,PR-8812,6,3,39,15,54
kafka,PR-10222,1,1,0,1,1
kafka,PR-10223,1,3,181,16,197
kafka,PR-10199,11,10,293,47,340
kafka,PR-10216,2,2,24,1,25
kafka,PR-10016,11,12,98,24,122
kafka,PR-10199,13,10,293,47,340
kafka,PR-10224,1,1,2,1,3
kafka,PR-10199,14,10,293,47,340
kafka,PR-10225,1,1,2,2,4
kafka,PR-10220,2,11,1175,8,1183
kafka,PR-10226,1,4,26,15,41
kafka,PR-10185,2,1,68,37,105
kafka,PR-10220,3,15,1389,14,1403
kafka,PR-10076,9,26,572,131,703
kafka,PR-10203,9,7,423,398,821
kafka,PR-10203,10,7,428,398,826
kafka,PR-9758,39,45,1175,1014,2189
kafka,PR-10203,11,7,430,398,828
kafka,PR-9758,40,45,1179,1014,2193
kafka,PR-10230,1,1,2,0,2
kafka,PR-9758,41,45,1009,1024,2033
kafka,PR-10231,1,1,2,5,7
kafka,PR-10141,3,2,46,15,61
kafka,PR-9758,42,45,1009,1024,2033
kafka,PR-10141,4,2,46,15,61
kafka,PR-10229,2,4,4,4,8
kafka,PR-10202,3,1,1,1,2
kafka,PR-10234,1,8,49,57,106
kafka,PR-10235,1,1,1,1,2
kafka,PR-10224,2,2,3,3,6
kafka,PR-10236,1,1,13,5,18
kafka,PR-10237,1,1,2,1,3
kafka,PR-10238,1,12,98,24,122
kafka,PR-10231,2,1,2,5,7
kafka,PR-10205,3,1,20,22,42
kafka,PR-10239,2,2,546,211,757
kafka,PR-10206,5,20,589,33,622
kafka,PR-10206,6,20,590,33,623
kafka,PR-10238,2,12,98,24,122
kafka,PR-10228,2,1,3,2,5
kafka,PR-10223,2,4,232,99,331
kafka,PR-10240,1,2,32,6,38
kafka,PR-9758,43,45,1009,1024,2033
kafka,PR-10215,4,2,55,15,70
kafka,PR-9758,44,45,1050,1031,2081
kafka,PR-10193,2,1,2,2,4
kafka,PR-10216,3,2,24,1,25
kafka,PR-10241,1,1,5,0,5
kafka,PR-10241,2,1,5,0,5
kafka,PR-10242,1,1,1,1,2
kafka,PR-10173,9,12,1394,0,1394
kafka,PR-10245,1,1,1,1,2
kafka,PR-10241,3,1,5,0,5
kafka,PR-10234,2,8,49,57,106
kafka,PR-10246,1,6,67,0,67
kafka,PR-10247,1,1,1,1,2
kafka,PR-10163,3,3,373,114,487
kafka,PR-10163,4,3,373,114,487
kafka,PR-10246,2,6,67,0,67
kafka,PR-10247,2,1,1,1,2
kafka,PR-10206,7,20,579,33,612
kafka,PR-10223,3,4,233,99,332
kafka,PR-9758,46,45,1054,1036,2090
kafka,PR-10211,7,8,79,60,139
kafka,PR-9758,47,45,1104,1048,2152
kafka,PR-10246,3,6,67,0,67
kafka,PR-10206,8,20,588,33,621
kafka,PR-10220,4,16,1408,20,1428
kafka,PR-10248,1,2,4,4,8
kafka,PR-10211,8,8,127,60,187
kafka,PR-9590,13,14,397,63,460
kafka,PR-10218,7,17,2233,0,2233
kafka,PR-10211,9,8,123,60,183
kafka,PR-10211,10,8,132,60,192
kafka,PR-10206,9,20,587,33,620
kafka,PR-10237,2,1,2,1,3
kafka,PR-10211,11,9,136,60,196
kafka,PR-10211,12,10,138,62,200
kafka,PR-10249,1,1,0,5,5
kafka,PR-10203,13,7,435,397,832
kafka,PR-10215,5,3,62,22,84
kafka,PR-10250,1,1,2,2,4
kafka,PR-10251,2,1,32,2,34
kafka,PR-10248,2,2,6,6,12
kafka,PR-10251,4,1,38,3,41
kafka,PR-10251,5,1,38,3,41
kafka,PR-10251,6,2,39,4,43
kafka,PR-10031,9,19,427,310,737
kafka,PR-10234,3,8,48,57,105
kafka,PR-10189,2,1,1,1,2
kafka,PR-10234,4,8,79,63,142
kafka,PR-10207,2,2,4,2,6
kafka,PR-10078,3,8,27,33,60
kafka,PR-10078,4,26,66,72,138
kafka,PR-10078,5,27,79,86,165
kafka,PR-10246,4,6,67,0,67
kafka,PR-10173,11,13,1398,0,1398
kafka,PR-10203,14,7,449,421,870
kafka,PR-10203,15,7,449,421,870
kafka,PR-9950,9,2,30,3,33
kafka,PR-10253,1,13,234,62,296
kafka,PR-10211,13,10,140,62,202
kafka,PR-10240,2,3,106,48,154
kafka,PR-10203,16,9,451,423,874
kafka,PR-10252,2,9,431,82,513
kafka,PR-9992,11,1,23,4,27
kafka,PR-10211,14,10,181,71,252
kafka,PR-10220,5,16,1408,20,1428
kafka,PR-10220,6,16,1408,20,1428
kafka,PR-10184,18,15,966,104,1070
kafka,PR-10253,2,15,266,100,366
kafka,PR-10253,3,15,268,100,368
kafka,PR-10184,20,15,970,104,1074
kafka,PR-10252,3,9,437,82,519
kafka,PR-10211,15,10,184,71,255
kafka,PR-10251,7,2,41,5,46
kafka,PR-10251,8,2,42,6,48
kafka,PR-10184,21,15,971,106,1077
kafka,PR-10251,9,2,42,6,48
kafka,PR-9457,11,8,17,83,100
kafka,PR-10159,5,6,58,62,120
kafka,PR-10256,1,2,3,1,4
kafka,PR-10257,1,1,18,0,18
kafka,PR-10259,1,1,1,1,2
kafka,PR-10234,5,8,80,64,144
kafka,PR-10260,1,1,1,0,1
kafka,PR-9758,48,45,1102,1047,2149
kafka,PR-10257,2,1,18,0,18
kafka,PR-10261,1,1,1,1,2
kafka,PR-10078,6,27,77,86,163
kafka,PR-10246,5,6,67,0,67
kafka,PR-10140,4,10,15,176,191
kafka,PR-10259,2,2,10,10,20
kafka,PR-10078,7,27,155,161,316
kafka,PR-10203,17,9,451,423,874
kafka,PR-10203,18,9,452,423,875
kafka,PR-10203,19,10,460,423,883
kafka,PR-10092,3,2,15,0,15
kafka,PR-10257,3,1,18,0,18
kafka,PR-10262,1,1,1,1,2
kafka,PR-10263,1,2,179,10,189
kafka,PR-10253,4,15,268,103,371
kafka,PR-10184,22,15,980,112,1092
kafka,PR-10240,3,4,108,50,158
kafka,PR-10256,2,8,185,133,318
kafka,PR-10264,1,2,14,12,26
kafka,PR-10256,3,8,197,141,338
kafka,PR-10266,1,3,859,62,921
kafka,PR-10252,4,9,440,78,518
kafka,PR-10211,16,10,188,76,264
kafka,PR-10211,17,10,188,76,264
kafka,PR-10267,1,2,10,2,12
kafka,PR-9744,16,24,329,44,373
kafka,PR-9744,17,24,327,42,369
kafka,PR-10268,1,2,24,11,35
kafka,PR-10240,4,4,111,50,161
kafka,PR-9851,7,3,23,38,61
kafka,PR-10269,1,17,699,499,1198
kafka,PR-10269,2,17,711,507,1218
kafka,PR-10269,3,17,711,507,1218
kafka,PR-10269,4,17,710,507,1217
kafka,PR-10269,5,17,741,531,1272
kafka,PR-10270,1,1,1,1,2
kafka,PR-10240,5,4,110,50,160
kafka,PR-10272,1,1,16,14,30
kafka,PR-10273,1,1,4,3,7
kafka,PR-10274,1,1,1,1,2
kafka,PR-9724,163,64,12674,172,12846
kafka,PR-9724,164,64,12675,172,12847
kafka,PR-10276,1,3,231,1,232
kafka,PR-9724,165,64,12676,172,12848
kafka,PR-9724,166,64,12682,172,12854
kafka,PR-10277,1,2,5,2,7
kafka,PR-10276,2,3,231,1,232
kafka,PR-10192,2,4,151,3,154
kafka,PR-9724,169,64,12920,176,13096
kafka,PR-9724,170,74,18997,160,19157
kafka,PR-10273,2,1,4,3,7
kafka,PR-10269,6,17,741,531,1272
kafka,PR-10135,4,3,22,52,74
kafka,PR-10252,5,9,441,79,520
kafka,PR-10269,7,17,852,603,1455
kafka,PR-10279,1,2,4,3,7
kafka,PR-10279,2,2,4,3,7
kafka,PR-9590,16,14,689,63,752
kafka,PR-10267,2,2,37,3,40
kafka,PR-10265,2,14,1107,9,1116
kafka,PR-10282,2,8,129,24,153
kafka,PR-10282,4,6,124,19,143
kafka,PR-9724,172,76,18795,161,18956
kafka,PR-9724,173,75,18796,161,18957
kafka,PR-10283,1,2,7,4,11
kafka,PR-10116,4,35,48,48,96
kafka,PR-10284,1,3,4,46,50
kafka,PR-9724,175,75,18784,167,18951
kafka,PR-9724,176,75,18785,167,18952
kafka,PR-9724,177,75,18785,167,18952
kafka,PR-10273,3,1,4,3,7
kafka,PR-9724,178,74,18835,156,18991
kafka,PR-9724,179,74,18836,156,18992
kafka,PR-10269,8,17,852,603,1455
kafka,PR-10076,10,26,572,131,703
kafka,PR-10118,2,1,1,1,2
kafka,PR-9590,17,14,576,63,639
kafka,PR-10269,9,17,852,603,1455
kafka,PR-10285,1,1,1,1,2
kafka,PR-10282,5,6,123,21,144
kafka,PR-10286,1,2,32,17,49
kafka,PR-9744,18,24,326,42,368
kafka,PR-9744,19,24,326,42,368
kafka,PR-10269,10,17,852,603,1455
kafka,PR-10021,25,10,387,88,475
kafka,PR-10266,2,3,1000,63,1063
kafka,PR-10292,2,1,9,2,11
kafka,PR-10297,1,1,2,0,2
kafka,PR-10298,1,1,2,2,4
kafka,PR-9944,14,49,3323,682,4005
kafka,PR-10286,2,2,33,18,51
kafka,PR-10021,26,9,362,74,436
kafka,PR-10300,1,15,19,381,400
kafka,PR-10300,2,16,19,382,401
kafka,PR-10301,1,1,142,50,192
kafka,PR-10276,3,3,231,1,232
kafka,PR-9724,180,55,5296,571,5867
kafka,PR-9724,181,55,5297,571,5868
kafka,PR-10303,1,1,0,5,5
kafka,PR-9724,182,55,5297,571,5868
kafka,PR-9724,183,55,5297,571,5868
kafka,PR-10304,1,1,8,1,9
kafka,PR-10305,1,2,292,162,454
kafka,PR-10281,7,4,179,55,234
kafka,PR-10306,2,1,1,1,2
kafka,PR-10085,8,18,748,110,858
kafka,PR-10085,9,18,745,113,858
kafka,PR-10300,3,16,18,387,405
kafka,PR-10292,3,1,10,2,12
kafka,PR-9724,184,56,5331,587,5918
kafka,PR-9724,185,56,5331,585,5916
kafka,PR-9724,186,56,5345,585,5930
kafka,PR-9724,187,56,5345,585,5930
kafka,PR-9724,188,56,5346,585,5931
kafka,PR-9724,189,57,5354,585,5939
kafka,PR-9724,190,57,5354,585,5939
kafka,PR-9724,191,57,5354,585,5939
kafka,PR-9756,9,11,222,16,238
kafka,PR-9724,192,77,10325,585,10910
kafka,PR-9724,193,77,10326,585,10911
kafka,PR-9724,194,77,10327,584,10911
kafka,PR-9724,195,77,10327,584,10911
kafka,PR-9724,196,77,10329,584,10913
kafka,PR-9724,197,77,10330,584,10914
kafka,PR-10307,1,1,1,3,4
kafka,PR-10308,1,1,1,1,2
kafka,PR-10135,6,4,27,94,121
kafka,PR-10299,5,8,572,3686,4258
kafka,PR-10309,1,3,134,35,169
kafka,PR-10232,6,7,46,47,93
kafka,PR-10310,1,3,30,0,30
kafka,PR-10280,6,10,1874,1193,3067
kafka,PR-10135,7,4,27,94,121
kafka,PR-10280,7,10,1873,1193,3066
kafka,PR-10232,7,7,42,48,90
kafka,PR-10311,1,2,10,1,11
kafka,PR-10311,2,2,4,2,6
kafka,PR-10135,8,4,27,94,121
kafka,PR-10135,9,4,27,94,121
kafka,PR-10243,4,1,11,8,19
kafka,PR-10312,1,2,2,2,4
kafka,PR-10309,2,4,200,81,281
kafka,PR-10309,3,4,208,79,287
kafka,PR-10313,1,1,1,1,2
kafka,PR-9724,198,78,10346,586,10932
kafka,PR-9724,199,78,10346,586,10932
kafka,PR-9724,200,78,10346,586,10932
kafka,PR-9724,201,78,10346,586,10932
kafka,PR-9724,202,78,10346,586,10932
kafka,PR-9724,203,78,10347,587,10934
kafka,PR-10276,6,4,340,10,350
kafka,PR-10314,1,3,6,6,12
kafka,PR-10315,1,3,12,0,12
kafka,PR-10316,1,1,25,5,30
kafka,PR-9724,204,78,10350,587,10937
kafka,PR-9724,205,78,10350,587,10937
kafka,PR-10317,1,2,310,106,416
kafka,PR-9724,206,78,10351,587,10938
kafka,PR-9724,207,79,10352,588,10940
kafka,PR-10318,1,2,98,2,100
kafka,PR-10319,1,4,14,21,35
kafka,PR-9963,8,14,158,108,266
kafka,PR-10280,8,10,1873,1193,3066
kafka,PR-10320,1,1,1,1,2
kafka,PR-10304,5,2,89,11,100
kafka,PR-10304,6,2,90,12,102
kafka,PR-10282,6,19,493,146,639
kafka,PR-10321,1,1,2,3,5
kafka,PR-10150,4,13,1756,254,2010
kafka,PR-10322,1,2,17,17,34
kafka,PR-10322,2,2,9,10,19
kafka,PR-10323,3,5,262,342,604
kafka,PR-10056,4,2,1,26,27
kafka,PR-10324,1,1,169,5,174
kafka,PR-10313,2,2,2,2,4
kafka,PR-10324,3,1,228,5,233
kafka,PR-10304,7,2,90,12,102
kafka,PR-10327,1,1,9,3,12
kafka,PR-10326,5,3,8,2,10
kafka,PR-10328,1,1,1,1,2
kafka,PR-10327,2,1,8,5,13
kafka,PR-10329,1,1,2,2,4
kafka,PR-10276,7,4,344,27,371
kafka,PR-10276,8,4,341,24,365
kafka,PR-9754,14,3,120,87,207
kafka,PR-9724,208,79,10489,606,11095
kafka,PR-9724,209,79,10590,609,11199
kafka,PR-9724,210,79,10589,609,11198
kafka,PR-9724,211,79,10588,609,11197
kafka,PR-10319,2,4,101,118,219
kafka,PR-10304,8,2,100,12,112
kafka,PR-9724,212,79,10588,609,11197
kafka,PR-9724,213,78,10647,608,11255
kafka,PR-9724,214,78,10650,611,11261
kafka,PR-9724,215,78,10651,611,11262
kafka,PR-9724,216,98,17111,611,17722
kafka,PR-9724,217,98,17110,611,17721
kafka,PR-10319,3,4,102,124,226
kafka,PR-10322,3,2,16,10,26
kafka,PR-10330,1,7,62,0,62
kafka,PR-10323,4,5,268,348,616
kafka,PR-10329,2,6,26,29,55
kafka,PR-10333,1,4,12,2,14
kafka,PR-10333,2,4,12,2,14
kafka,PR-10334,2,2,42,7,49
kafka,PR-10333,3,4,12,2,14
kafka,PR-10333,4,4,12,2,14
kafka,PR-10297,2,1,5,0,5
kafka,PR-10292,4,1,8,2,10
kafka,PR-10337,3,1,13,0,13
kafka,PR-9724,218,98,16391,611,17002
kafka,PR-9724,219,98,16392,611,17003
kafka,PR-9724,220,98,16392,611,17003
kafka,PR-9724,221,100,16840,611,17451
kafka,PR-10337,4,1,7,0,7
kafka,PR-10339,1,1,0,4,4
kafka,PR-8117,7,19,964,300,1264
kafka,PR-10329,3,6,26,29,55
kafka,PR-10304,9,2,99,12,111
kafka,PR-10339,2,1,0,5,5
kafka,PR-10338,2,1,20,3,23
kafka,PR-9724,222,100,16840,611,17451
kafka,PR-9724,223,100,16841,611,17452
kafka,PR-10329,4,6,30,33,63
kafka,PR-10329,5,6,30,34,64
kafka,PR-10077,3,3,102,27,129
kafka,PR-9724,224,100,16842,612,17454
kafka,PR-9724,225,100,16842,612,17454
kafka,PR-10292,5,1,8,1,9
kafka,PR-10323,6,6,272,348,620
kafka,PR-10334,3,2,46,7,53
kafka,PR-10317,2,4,772,115,887
kafka,PR-10309,4,5,208,79,287
kafka,PR-10340,1,4,8,4,12
kafka,PR-10340,2,4,9,5,14
kafka,PR-10340,3,4,11,7,18
kafka,PR-10334,4,2,44,7,51
kafka,PR-10341,1,1,4,2,6
kafka,PR-10341,2,1,4,2,6
kafka,PR-10323,7,7,277,359,636
kafka,PR-10344,2,1,15,24,39
kafka,PR-10313,3,3,32,2,34
kafka,PR-10344,3,2,22,29,51
kafka,PR-10345,1,1,19,1,20
kafka,PR-10315,2,3,12,0,12
kafka,PR-10346,1,1,33,17,50
kafka,PR-9724,226,140,18012,637,18649
kafka,PR-10345,3,1,19,1,20
kafka,PR-10309,5,4,203,79,282
kafka,PR-9724,227,142,17732,678,18410
kafka,PR-10347,1,1,1,0,1
kafka,PR-10304,10,2,99,12,111
kafka,PR-9724,228,142,17680,679,18359
kafka,PR-10349,1,1,19,19,38
kafka,PR-10348,3,1,1,1,2
kafka,PR-10344,4,2,19,17,36
kafka,PR-10340,5,5,53,7,60
kafka,PR-10238,3,12,98,24,122
kafka,PR-10332,5,8,132,124,256
kafka,PR-10077,4,3,102,27,129
kafka,PR-10350,1,1,15,11,26
kafka,PR-10351,1,2,7,1,8
kafka,PR-10352,1,1,1,1,2
kafka,PR-10334,5,2,43,7,50
kafka,PR-10282,7,23,599,265,864
kafka,PR-10340,6,5,52,7,59
kafka,PR-10344,5,2,19,17,36
kafka,PR-10354,1,1,1,0,1
kafka,PR-10353,2,2,6,0,6
kafka,PR-10220,8,16,1426,32,1458
kafka,PR-10356,2,2,16,2,18
kafka,PR-10357,1,12,28,37,65
kafka,PR-10276,10,4,341,24,365
kafka,PR-10357,2,12,40,54,94
kafka,PR-10077,5,3,109,29,138
kafka,PR-10255,5,5,54,57,111
kafka,PR-10289,4,6,312,6,318
kafka,PR-10358,1,1,1,1,2
kafka,PR-9779,4,1,168,57,225
kafka,PR-10357,3,12,44,58,102
kafka,PR-10359,1,1,0,1,1
kafka,PR-10361,1,4,33,29,62
kafka,PR-10361,2,4,33,29,62
kafka,PR-10362,1,20,60,55,115
kafka,PR-10360,3,2,133,1,134
kafka,PR-10220,9,19,1362,43,1405
kafka,PR-10361,3,4,35,31,66
kafka,PR-10351,3,3,29,1,30
kafka,PR-9944,16,49,3337,705,4042
kafka,PR-10362,2,20,60,55,115
kafka,PR-10362,3,20,60,55,115
kafka,PR-10357,4,12,44,58,102
kafka,PR-10363,1,1,1,0,1
kafka,PR-10150,5,13,1756,254,2010
kafka,PR-10286,3,2,35,19,54
kafka,PR-10361,4,4,35,31,66
kafka,PR-10350,2,1,15,11,26
kafka,PR-10352,2,1,1,1,2
kafka,PR-10358,2,1,1,1,2
kafka,PR-10220,11,19,1361,43,1404
kafka,PR-10362,4,20,86,75,161
kafka,PR-10275,12,23,3194,41,3235
kafka,PR-10281,10,4,179,55,234
kafka,PR-10355,5,5,143,46,189
kafka,PR-10282,9,34,634,285,919
kafka,PR-10364,1,1,1,3,4
kafka,PR-10275,13,23,3160,41,3201
kafka,PR-10150,6,13,1756,254,2010
kafka,PR-10368,1,3,5,15,20
kafka,PR-10368,2,3,13,17,30
kafka,PR-10346,2,2,59,13,72
kafka,PR-10346,3,2,59,13,72
kafka,PR-10346,4,2,59,13,72
kafka,PR-10351,4,3,132,1,133
kafka,PR-10346,5,2,78,13,91
kafka,PR-10150,7,13,1756,254,2010
kafka,PR-10369,2,2,20,2,22
kafka,PR-10346,6,2,76,13,89
kafka,PR-10370,1,1,1,1,2
kafka,PR-10333,5,30,116,41,157
kafka,PR-10367,4,2,135,71,206
kafka,PR-10367,5,2,135,71,206
kafka,PR-10077,6,3,107,27,134
kafka,PR-10077,7,3,107,27,134
kafka,PR-10370,2,13,14,14,28
kafka,PR-10371,2,2,157,16,173
kafka,PR-10371,3,2,179,18,197
kafka,PR-10371,4,2,190,25,215
kafka,PR-10370,3,14,15,15,30
kafka,PR-10371,5,3,186,25,211
kafka,PR-10254,3,9,194,54,248
kafka,PR-10372,1,10,224,167,391
kafka,PR-10254,4,11,201,61,262
kafka,PR-10275,14,23,3174,41,3215
kafka,PR-10309,6,4,200,80,280
kafka,PR-10373,1,1,2,2,4
kafka,PR-10351,5,3,143,1,144
kafka,PR-10375,1,2,40,0,40
kafka,PR-10376,1,3,6,23,29
kafka,PR-10325,3,1,0,391,391
kafka,PR-9858,9,63,1035,603,1638
kafka,PR-9858,10,63,1035,603,1638
kafka,PR-10378,1,16,79,682,761
kafka,PR-10378,2,17,92,683,775
kafka,PR-10379,1,3,0,22,22
kafka,PR-10379,2,4,8,22,30
kafka,PR-10374,2,10,226,169,395
kafka,PR-10380,1,9,11,194,205
kafka,PR-10371,6,3,186,25,211
kafka,PR-10383,1,1,2,1,3
kafka,PR-10384,1,1,1,1,2
kafka,PR-10386,1,1,2,0,2
kafka,PR-10374,3,10,226,169,395
kafka,PR-10388,1,3,127,23,150
kafka,PR-10388,2,3,128,24,152
kafka,PR-10389,1,1,22,9,31
kafka,PR-10254,5,11,210,64,274
kafka,PR-10391,1,1,1,0,1
kafka,PR-10386,2,1,4,0,4
kafka,PR-10379,3,4,8,22,30
kafka,PR-10392,1,9,12,9,21
kafka,PR-10392,3,9,12,11,23
kafka,PR-10389,2,1,21,9,30
kafka,PR-10386,3,1,4,0,4
kafka,PR-10085,11,27,1236,378,1614
kafka,PR-10394,3,1,1,0,1
kafka,PR-10281,12,4,179,55,234
kafka,PR-10395,1,4,179,55,234
kafka,PR-10281,13,4,190,68,258
kafka,PR-10385,2,22,393,179,572
kafka,PR-10392,4,10,178,262,440
kafka,PR-10386,4,1,1,1,2
kafka,PR-10386,5,1,1,2,3
kafka,PR-10389,3,1,21,9,30
kafka,PR-9944,18,49,3271,705,3976
kafka,PR-10396,1,2,97,5,102
kafka,PR-10397,1,3,11,46,57
kafka,PR-10375,3,2,40,0,40
kafka,PR-10085,12,28,1263,399,1662
kafka,PR-10394,4,1,1,0,1
kafka,PR-10085,14,30,1429,513,1942
kafka,PR-10085,15,30,1427,513,1940
kafka,PR-10275,15,23,3174,41,3215
kafka,PR-10399,1,1,4,4,8
kafka,PR-10399,2,1,10,7,17
kafka,PR-10398,2,2,19,1,20
kafka,PR-10403,1,2,44,3,47
kafka,PR-10404,1,1,4,0,4
kafka,PR-10398,3,2,18,1,19
kafka,PR-10388,3,4,187,37,224
kafka,PR-10405,1,2,26,8,34
kafka,PR-10406,1,1,3,3,6
kafka,PR-10407,1,1,39,14,53
kafka,PR-10408,2,1,3,0,3
kafka,PR-10142,8,7,185,34,219
kafka,PR-10409,3,1,17,13,30
kafka,PR-10407,5,4,67,147,214
kafka,PR-10407,6,4,64,147,211
kafka,PR-10407,8,4,52,139,191
kafka,PR-10407,9,4,45,152,197
kafka,PR-10405,2,2,26,8,34
kafka,PR-10280,11,10,1840,1193,3033
kafka,PR-10413,1,1,2,2,4
kafka,PR-10389,4,1,21,9,30
kafka,PR-10414,3,21,81,70,151
kafka,PR-10385,3,22,393,179,572
kafka,PR-10414,4,21,81,70,151
kafka,PR-10416,1,3,8,3,11
kafka,PR-10414,5,21,81,70,151
kafka,PR-10407,10,2,60,32,92
kafka,PR-10387,10,2,19,16,35
kafka,PR-10387,11,3,96,28,124
kafka,PR-10407,12,3,79,43,122
kafka,PR-10407,13,3,83,43,126
kafka,PR-10407,15,3,141,41,182
kafka,PR-10407,16,3,138,44,182
kafka,PR-10418,1,1,5,6,11
kafka,PR-10419,1,1,35,1,36
kafka,PR-10420,1,2,4,0,4
kafka,PR-10412,2,5,3,244,247
kafka,PR-10414,9,25,108,100,208
kafka,PR-10378,3,17,92,683,775
kafka,PR-10378,4,19,92,684,776
kafka,PR-10407,17,3,184,41,225
kafka,PR-10407,18,3,173,31,204
kafka,PR-10407,19,3,180,31,211
kafka,PR-10407,20,4,218,51,269
kafka,PR-10421,1,12,13,796,809
kafka,PR-10421,2,12,13,795,808
kafka,PR-10407,21,4,216,51,267
kafka,PR-10301,2,1,142,50,192
kafka,PR-10378,5,19,92,684,776
kafka,PR-10398,4,2,22,1,23
kafka,PR-10378,6,19,92,685,777
kafka,PR-10421,4,12,13,795,808
kafka,PR-10407,22,5,238,54,292
kafka,PR-10407,23,5,240,54,294
kafka,PR-10407,24,5,241,54,295
kafka,PR-10407,26,6,260,53,313
kafka,PR-10423,1,1,1,1,2
kafka,PR-10407,27,6,433,53,486
kafka,PR-10302,3,9,13,195,208
kafka,PR-9724,229,145,17712,684,18396
kafka,PR-9724,230,106,17650,684,18334
kafka,PR-10425,1,3,0,27,27
kafka,PR-10414,10,25,109,100,209
kafka,PR-10414,11,25,109,100,209
kafka,PR-10385,4,22,393,179,572
kafka,PR-10425,2,4,1,27,28
kafka,PR-10429,1,9,659,53,712
kafka,PR-10414,13,25,109,100,209
kafka,PR-10398,8,3,48,13,61
kafka,PR-10430,1,2,7,12,19
kafka,PR-10398,9,3,48,13,61
kafka,PR-10430,2,2,8,13,21
kafka,PR-10401,7,3,446,89,535
kafka,PR-9724,231,106,17707,684,18391
kafka,PR-9724,232,126,17707,684,18391
kafka,PR-10424,3,4,86,85,171
kafka,PR-10436,1,1,2,23,25
kafka,PR-10342,11,12,96,260,356
kafka,PR-10426,5,4,70,63,133
kafka,PR-10398,11,3,47,13,60
kafka,PR-10444,1,2,75,12,87
kafka,PR-10405,11,9,76,17,93
kafka,PR-10424,5,4,73,73,146
kafka,PR-9724,234,127,17628,686,18314
kafka,PR-10445,2,11,289,91,380
kafka,PR-10142,9,7,185,34,219
kafka,PR-10434,1,1,0,1,1
kafka,PR-10440,1,5,1,197,198
kafka,PR-10435,6,18,18,608,626
kafka,PR-10410,2,1,8,9,17
kafka,PR-10389,5,1,16,8,24
kafka,PR-10077,8,3,107,27,134
kafka,PR-9724,235,129,17527,691,18218
kafka,PR-10446,1,1,2,0,2
kafka,PR-9724,236,129,17526,691,18217
kafka,PR-10440,2,5,1,197,198
kafka,PR-10447,1,1,0,15,15
kafka,PR-10436,2,2,4,23,27
kafka,PR-10448,1,1,1,1,2
kafka,PR-10405,12,9,74,17,91
kafka,PR-10293,7,21,118,316,434
kafka,PR-10443,1,5,1,721,722
kafka,PR-10437,1,6,17,143,160
kafka,PR-10293,9,22,119,316,435
kafka,PR-10449,1,1,25,22,47
kafka,PR-10450,1,26,65,2171,2236
kafka,PR-10451,2,1,0,5,5
kafka,PR-10443,2,5,1,721,722
kafka,PR-10452,1,30,23,83,106
kafka,PR-10453,1,1,9,7,16
kafka,PR-10254,6,13,248,82,330
kafka,PR-10454,1,3,3,3,6
kafka,PR-10455,1,2,11,1,12
kafka,PR-10430,3,2,8,13,21
kafka,PR-10452,3,35,23,94,117
kafka,PR-10282,10,34,670,289,959
kafka,PR-10405,13,9,79,17,96
kafka,PR-10405,14,12,83,21,104
kafka,PR-8844,5,10,497,114,611
kafka,PR-9851,9,3,21,48,69
kafka,PR-10457,1,2,15,773,788
kafka,PR-10458,1,6,7,24,31
kafka,PR-10458,6,28,60,157,217
kafka,PR-10459,1,2,2,7,9
kafka,PR-10422,2,1,19,21,40
kafka,PR-10142,10,7,298,36,334
kafka,PR-10381,9,17,217,131,348
kafka,PR-10405,15,14,95,38,133
kafka,PR-10405,16,14,95,38,133
kafka,PR-10453,2,1,9,7,16
kafka,PR-10282,11,34,674,292,966
kafka,PR-10461,2,4,626,1,627
kafka,PR-10405,17,16,116,56,172
kafka,PR-10445,3,11,291,92,383
kafka,PR-10405,18,16,114,52,166
kafka,PR-10405,19,16,114,52,166
kafka,PR-10405,22,14,88,27,115
kafka,PR-10447,2,1,0,15,15
kafka,PR-10446,2,1,7,1,8
kafka,PR-10405,23,12,79,19,98
kafka,PR-10456,4,3,191,0,191
kafka,PR-10445,5,12,320,95,415
kafka,PR-10405,24,12,79,19,98
kafka,PR-10405,25,12,80,19,99
kafka,PR-10405,26,12,80,19,99
kafka,PR-10142,11,7,264,36,300
kafka,PR-10464,1,1,0,5,5
kafka,PR-10457,2,3,118,869,987
kafka,PR-10439,2,4,158,3,161
kafka,PR-10278,3,3,110,9,119
kafka,PR-10393,2,16,324,125,449
kafka,PR-10461,3,4,625,1,626
kafka,PR-10461,4,4,625,1,626
kafka,PR-10450,2,26,66,2171,2237
kafka,PR-10450,3,26,68,2173,2241
kafka,PR-10393,4,16,330,125,455
kafka,PR-10457,4,3,121,872,993
kafka,PR-10457,6,3,122,872,994
kafka,PR-10468,2,3,118,14,132
kafka,PR-10469,1,1,7,6,13
kafka,PR-9229,6,31,527,327,854
kafka,PR-10457,7,3,122,872,994
kafka,PR-10457,8,3,122,872,994
kafka,PR-10471,2,3,56,471,527
kafka,PR-9937,3,4,104,7,111
kafka,PR-10461,5,4,659,1,660
kafka,PR-10473,14,2,121,17,138
kafka,PR-10475,5,8,217,0,217
kafka,PR-10477,1,1,1,1,2
kafka,PR-9229,10,34,573,351,924
kafka,PR-10474,3,9,1487,348,1835
kafka,PR-10474,4,13,1613,349,1962
kafka,PR-10445,6,13,326,97,423
kafka,PR-10366,14,28,1405,54,1459
kafka,PR-10142,12,7,271,36,307
kafka,PR-9944,19,49,3293,719,4012
kafka,PR-10254,7,14,284,89,373
kafka,PR-10481,1,4,100,83,183
kafka,PR-10479,2,1,5,7,12
kafka,PR-10483,1,15,1077,2,1079
kafka,PR-10479,4,1,8,6,14
kafka,PR-10484,1,1,27,6,33
kafka,PR-10446,3,1,7,1,8
kafka,PR-9851,10,3,20,48,68
kafka,PR-9724,237,129,17554,692,18246
kafka,PR-10486,1,1,30,26,56
kafka,PR-10389,6,1,16,8,24
kafka,PR-10487,1,5,21,2,23
kafka,PR-10438,9,19,36,434,470
kafka,PR-10485,1,1,5,1,6
kafka,PR-10488,2,1,2,2,4
kafka,PR-9229,11,34,566,335,901
kafka,PR-10254,8,14,284,89,373
kafka,PR-9229,12,34,566,334,900
kafka,PR-10389,7,1,16,8,24
kafka,PR-10254,9,14,284,89,373
kafka,PR-10483,2,15,1075,2,1077
kafka,PR-10131,11,3,17,11,28
kafka,PR-10474,5,13,1331,349,1680
kafka,PR-10492,1,11,55,10,65
kafka,PR-10493,1,1,9,0,9
kafka,PR-10470,3,51,190,380,570
kafka,PR-10492,2,13,58,13,71
kafka,PR-10495,1,1,1,0,1
kafka,PR-10470,4,51,194,381,575
kafka,PR-10495,2,1,1,0,1
kafka,PR-10496,1,3,1,2,3
kafka,PR-10301,5,2,171,51,222
kafka,PR-10497,1,35,499,738,1237
kafka,PR-9229,13,34,567,335,902
kafka,PR-10496,2,3,7,2,9
kafka,PR-10498,1,1,6,2,8
kafka,PR-10470,7,52,319,407,726
kafka,PR-10489,2,13,129,1,130
kafka,PR-10446,4,1,7,1,8
kafka,PR-10457,9,3,122,871,993
kafka,PR-10446,5,2,22,8,30
kafka,PR-10471,4,3,54,467,521
kafka,PR-10490,3,3,22,3,25
kafka,PR-10469,2,1,11,9,20
kafka,PR-10331,9,13,955,34,989
kafka,PR-10498,2,1,6,2,8
kafka,PR-10492,3,13,58,13,71
kafka,PR-10490,4,3,18,3,21
kafka,PR-10331,10,13,955,34,989
kafka,PR-10491,3,3,7,122,129
kafka,PR-10254,11,17,335,140,475
kafka,PR-10495,3,1,2,0,2
kafka,PR-10493,2,1,21,0,21
kafka,PR-10492,4,14,64,18,82
kafka,PR-10497,3,35,553,779,1332
kafka,PR-10481,2,4,100,83,183
kafka,PR-10421,5,13,17,795,812
kafka,PR-10502,1,2,1,24,25
kafka,PR-10218,25,15,1717,20,1737
kafka,PR-9724,238,133,17491,688,18179
kafka,PR-10502,2,2,1,24,25
kafka,PR-10501,2,1,0,1,1
kafka,PR-10218,26,15,1713,20,1733
kafka,PR-9724,239,134,17505,688,18193
kafka,PR-10490,5,3,18,3,21
kafka,PR-10504,1,20,627,163,790
kafka,PR-10506,1,1,2,1,3
kafka,PR-10504,2,20,629,162,791
kafka,PR-10480,8,9,184,120,304
kafka,PR-10508,1,7,19,2051,2070
kafka,PR-10510,1,2,60,1,61
kafka,PR-7284,3,4,746,0,746
kafka,PR-10427,6,11,49,74,123
kafka,PR-10511,1,3,3,59,62
kafka,PR-10512,1,9,132,465,597
kafka,PR-10427,7,11,49,74,123
kafka,PR-10218,27,14,1725,20,1745
kafka,PR-10516,1,1,3,2,5
kafka,PR-9590,19,14,582,75,657
kafka,PR-10517,2,1,0,24,24
kafka,PR-9944,21,54,3331,744,4075
kafka,PR-10512,2,9,154,465,619
kafka,PR-10085,16,30,1435,517,1952
kafka,PR-10510,2,2,113,1,114
kafka,PR-10218,28,14,1725,20,1745
kafka,PR-10411,12,3,6,12,18
kafka,PR-10271,10,28,2653,38,2691
kafka,PR-10042,12,2,77,4,81
kafka,PR-10483,3,15,1170,2,1172
kafka,PR-10411,13,4,11,20,31
kafka,PR-10512,3,9,159,465,624
kafka,PR-10518,1,3,76,4,80
kafka,PR-10469,4,1,11,9,20
kafka,PR-10475,8,8,291,11,302
kafka,PR-10503,7,2,101,2,103
kafka,PR-10498,3,1,6,2,8
kafka,PR-9640,12,2,117,65,182
kafka,PR-9627,7,7,29,18,47
kafka,PR-9584,9,3,28,5,33
kafka,PR-10522,2,1,0,15,15
kafka,PR-10258,5,1,12,2,14
kafka,PR-10524,1,1,2,2,4
kafka,PR-10042,14,2,77,4,81
kafka,PR-10218,30,14,1725,20,1745
kafka,PR-10509,5,1,57,68,125
kafka,PR-10491,5,3,7,122,129
kafka,PR-10409,6,1,11,16,27
kafka,PR-10488,4,1,2,2,4
kafka,PR-10525,1,3,76,4,80
kafka,PR-7284,4,4,746,0,746
kafka,PR-10469,5,1,11,7,18
kafka,PR-10446,7,2,22,8,30
kafka,PR-10526,1,1,1,1,2
kafka,PR-10507,12,170,2137,1927,4064
kafka,PR-10258,6,1,10,0,10
kafka,PR-10490,7,3,18,3,21
kafka,PR-10527,1,60,1009,120,1129
kafka,PR-10503,8,2,101,2,103
kafka,PR-10491,6,3,10,123,133
kafka,PR-10480,11,13,215,141,356
kafka,PR-10529,1,1,1,1,2
kafka,PR-10491,7,2,9,123,132
kafka,PR-10506,3,1,3,1,4
kafka,PR-10512,5,9,159,465,624
kafka,PR-10507,13,173,2724,2267,4991
kafka,PR-10480,12,13,244,140,384
kafka,PR-10530,1,2,43,2,45
kafka,PR-10530,2,2,41,2,43
kafka,PR-10409,7,1,15,19,34
kafka,PR-10338,4,1,20,3,23
kafka,PR-10446,8,2,22,8,30
kafka,PR-10529,3,1,54,52,106
kafka,PR-10531,1,1,2,0,2
kafka,PR-10446,9,3,37,9,46
kafka,PR-10532,1,3,16,11,27
kafka,PR-10511,3,3,2,58,60
kafka,PR-9724,243,133,17816,291,18107
kafka,PR-9779,6,1,168,57,225
kafka,PR-9779,7,1,168,57,225
kafka,PR-9724,245,133,17819,292,18111
kafka,PR-10529,4,1,2,2,4
kafka,PR-10530,3,2,55,2,57
kafka,PR-10530,4,2,58,2,60
kafka,PR-9724,247,136,17863,300,18163
kafka,PR-10277,3,2,5,2,7
kafka,PR-10470,8,52,320,408,728
kafka,PR-10470,9,52,635,486,1121
kafka,PR-10530,5,2,48,2,50
kafka,PR-10463,10,10,577,27,604
kafka,PR-10536,1,1,1,1,2
kafka,PR-10470,10,52,636,487,1123
kafka,PR-10537,1,12,322,194,516
kafka,PR-10538,1,2,4,4,8
kafka,PR-10470,11,52,636,487,1123
kafka,PR-10532,2,5,99,15,114
kafka,PR-10539,1,139,88,4,92
kafka,PR-10540,1,2,1,7,8
kafka,PR-10463,11,10,577,27,604
kafka,PR-10532,3,5,99,15,114
kafka,PR-9724,248,136,17876,297,18173
kafka,PR-10400,7,7,24,33,57
kafka,PR-10498,4,4,6,19,25
kafka,PR-10539,2,139,84,4,88
kafka,PR-10498,5,9,36,60,96
kafka,PR-9724,249,138,17886,294,18180
kafka,PR-10540,2,2,1,7,8
kafka,PR-10498,6,7,18,50,68
kafka,PR-9861,4,3,6,11,17
kafka,PR-10507,14,173,2777,2320,5097
kafka,PR-9861,5,3,6,11,17
kafka,PR-10271,13,15,934,18,952
kafka,PR-10507,15,172,2918,2461,5379
kafka,PR-10507,16,178,5722,4964,10686
kafka,PR-10538,2,2,6,4,10
kafka,PR-10271,14,15,944,18,962
kafka,PR-10507,17,178,5742,4985,10727
kafka,PR-10545,1,1,1,0,1
kafka,PR-10545,2,2,4,0,4
kafka,PR-10544,5,8,126,9,135
kafka,PR-9724,250,143,17875,296,18171
kafka,PR-10546,1,1,30,30,60
kafka,PR-10498,7,7,18,50,68
kafka,PR-10271,15,14,928,18,946
kafka,PR-9549,11,8,996,1,997
kafka,PR-10439,4,4,158,3,161
kafka,PR-10547,2,2,45,16,61
kafka,PR-10471,6,3,54,467,521
kafka,PR-10457,11,3,122,871,993
kafka,PR-10548,1,1,1,0,1
kafka,PR-9944,23,54,3326,744,4070
kafka,PR-10548,2,7,91,1,92
kafka,PR-10537,2,12,325,194,519
kafka,PR-10549,1,2,45,2,47
kafka,PR-10508,3,7,19,2052,2071
kafka,PR-10549,2,2,46,2,48
kafka,PR-10550,1,23,386,213,599
kafka,PR-10551,1,2,0,3,3
kafka,PR-10551,2,2,3,3,6
kafka,PR-10519,3,3,76,3,79
kafka,PR-10553,1,1,1,1,2
kafka,PR-10554,1,1,20,1,21
kafka,PR-10551,3,2,3,3,6
kafka,PR-10271,16,14,954,18,972
kafka,PR-10555,1,2,15,15,30
kafka,PR-10556,1,1,17,32,49
kafka,PR-10508,4,7,25,2053,2078
kafka,PR-10557,1,3,4,130,134
kafka,PR-9640,13,2,114,65,179
kafka,PR-10558,1,1,1,1,2
kafka,PR-10559,1,1,5,3,8
kafka,PR-10446,10,3,37,9,46
kafka,PR-10498,8,7,18,50,68
kafka,PR-10552,4,2,285,107,392
kafka,PR-10551,4,2,3,3,6
kafka,PR-10556,2,1,7,17,24
kafka,PR-10561,1,6,80,28,108
kafka,PR-10558,2,2,43,1,44
kafka,PR-9861,6,3,7,12,19
kafka,PR-10556,3,1,7,17,24
kafka,PR-10562,1,3,5,0,5
kafka,PR-10549,3,2,90,1,91
kafka,PR-9861,7,3,13,18,31
kafka,PR-10563,2,13,797,151,948
kafka,PR-10562,2,3,5,0,5
kafka,PR-10549,5,2,90,2,92
kafka,PR-10549,6,2,92,7,99
kafka,PR-10559,2,1,6,3,9
kafka,PR-9821,6,5,23,8,31
kafka,PR-9861,8,3,9,14,23
kafka,PR-10509,6,1,123,75,198
kafka,PR-10551,5,2,3,3,6
kafka,PR-10402,5,4,10,13,23
kafka,PR-10176,3,52,352,290,642
kafka,PR-10478,26,13,3004,2182,5186
kafka,PR-10566,1,1,1,1,2
kafka,PR-10567,1,1,1,1,2
kafka,PR-9640,14,3,123,65,188
kafka,PR-10509,7,1,123,75,198
kafka,PR-10530,6,2,52,2,54
kafka,PR-10549,7,2,96,7,103
kafka,PR-10530,7,2,52,2,54
kafka,PR-10569,1,2,34,5,39
kafka,PR-10549,8,2,96,7,103
kafka,PR-10570,1,4,7,6,13
kafka,PR-10462,20,24,2697,60,2757
kafka,PR-10549,9,2,96,7,103
kafka,PR-10571,1,1,0,1,1
kafka,PR-10572,1,6,161,5,166
kafka,PR-10565,2,2,22,2,24
kafka,PR-10446,11,3,37,9,46
kafka,PR-10575,1,1,2,1,3
kafka,PR-10574,2,1,5,0,5
kafka,PR-10567,2,1,1,1,2
kafka,PR-10576,1,1,2,3,5
kafka,PR-10577,1,2,20,9,29
kafka,PR-10575,2,1,3,2,5
kafka,PR-10271,18,15,961,18,979
kafka,PR-10530,8,2,53,7,60
kafka,PR-10565,3,2,26,2,28
kafka,PR-10530,9,2,55,7,62
kafka,PR-10572,2,6,142,5,147
kafka,PR-10580,1,1,1,7,8
kafka,PR-10565,4,2,29,2,31
kafka,PR-10580,2,1,3,8,11
kafka,PR-10483,5,21,1248,24,1272
kafka,PR-10583,1,3,43,2,45
kafka,PR-10584,1,3,43,2,45
kafka,PR-10483,6,22,1250,33,1283
kafka,PR-10585,1,1,9,0,9
kafka,PR-10271,20,15,982,18,1000
kafka,PR-10586,1,2,13,2,15
kafka,PR-10580,3,1,3,8,11
kafka,PR-9640,15,3,129,65,194
kafka,PR-10077,10,3,107,27,134
kafka,PR-9627,8,7,29,18,47
kafka,PR-10586,2,1,2,1,3
kafka,PR-10558,3,2,43,1,44
kafka,PR-10547,3,2,45,16,61
kafka,PR-9627,9,2,18,4,22
kafka,PR-10587,1,5,191,34,225
kafka,PR-10074,4,3,34,7,41
kafka,PR-8923,5,4,95,18,113
kafka,PR-10548,6,6,164,1,165
kafka,PR-9821,7,5,23,8,31
kafka,PR-9627,10,1,11,6,17
kafka,PR-9640,16,3,129,65,194
kafka,PR-9640,17,3,129,65,194
kafka,PR-10591,1,4,13,9,22
kafka,PR-10592,2,1,21,2,23
kafka,PR-10593,1,3,88,50,138
kafka,PR-10593,2,4,91,53,144
kafka,PR-10592,3,1,20,2,22
kafka,PR-10594,1,0,0,0,0
kafka,PR-10594,2,0,0,0,0
kafka,PR-10595,1,9,116,61,177
kafka,PR-10594,3,2,41,2,43
kafka,PR-10596,1,2,41,2,43
kafka,PR-10593,3,4,102,53,155
kafka,PR-10548,9,10,181,7,188
kafka,PR-10599,1,11,718,0,718
kafka,PR-10573,7,42,495,228,723
kafka,PR-9590,21,15,582,75,657
kafka,PR-10480,14,13,347,140,487
kafka,PR-10548,10,9,176,7,183
kafka,PR-10598,2,1,7,7,14
kafka,PR-10600,1,3,3,3,6
kafka,PR-10554,2,1,20,1,21
kafka,PR-10271,28,20,1039,148,1187
kafka,PR-8923,6,5,114,24,138
kafka,PR-10466,11,1,0,5,5
kafka,PR-10599,2,11,719,0,719
kafka,PR-10497,5,35,553,779,1332
kafka,PR-10085,19,30,1461,522,1983
kafka,PR-10480,15,13,355,138,493
kafka,PR-10564,8,6,241,176,417
kafka,PR-10573,8,42,495,228,723
kafka,PR-10547,4,2,45,16,61
kafka,PR-10547,5,2,45,16,61
kafka,PR-10598,3,1,8,8,16
kafka,PR-10466,12,1,0,5,5
kafka,PR-9786,4,3,4,3,7
kafka,PR-10601,1,1,11,8,19
kafka,PR-10023,4,11,341,426,767
kafka,PR-10462,22,23,2500,61,2561
kafka,PR-10604,1,8,18,20,38
kafka,PR-10591,2,4,15,11,26
kafka,PR-9441,13,7,257,79,336
kafka,PR-10480,16,13,355,138,493
kafka,PR-10605,1,2,29,5,34
kafka,PR-10466,13,1,0,5,5
kafka,PR-9590,22,15,604,91,695
kafka,PR-10480,17,13,355,138,493
kafka,PR-10085,20,30,1461,522,1983
kafka,PR-9590,23,15,547,91,638
kafka,PR-10480,18,13,356,138,494
kafka,PR-10607,1,2,2,2,4
kafka,PR-10608,1,5,50,225,275
kafka,PR-10585,2,1,9,0,9
kafka,PR-10446,12,3,37,9,46
kafka,PR-10077,11,3,107,27,134
kafka,PR-10577,2,2,20,9,29
kafka,PR-10608,2,5,56,249,305
kafka,PR-10610,1,2,11,8,19
kafka,PR-10509,9,1,141,92,233
kafka,PR-10611,1,2,63,15,78
kafka,PR-10612,1,7,255,8,263
kafka,PR-10085,21,32,1678,644,2322
kafka,PR-10604,2,8,31,29,60
kafka,PR-10563,3,13,900,162,1062
kafka,PR-10614,1,1,1,1,2
kafka,PR-10617,1,2,22,0,22
kafka,PR-10618,1,1,1,1,2
kafka,PR-10271,29,21,1122,148,1270
kafka,PR-10475,9,11,422,58,480
kafka,PR-10597,8,4,74,18,92
kafka,PR-10593,4,4,166,53,219
kafka,PR-10475,10,11,418,58,476
kafka,PR-7891,15,1,46,46,92
kafka,PR-10535,6,11,40,57,97
kafka,PR-10617,2,2,24,0,24
kafka,PR-10542,4,11,208,126,334
kafka,PR-10535,7,12,47,64,111
kafka,PR-10126,4,2,6,6,12
kafka,PR-10620,1,2,13,2,15
kafka,PR-10593,5,4,202,70,272
kafka,PR-10085,22,32,1677,644,2321
kafka,PR-10597,9,4,74,18,92
kafka,PR-10085,23,32,1676,644,2320
kafka,PR-9944,24,53,2556,807,3363
kafka,PR-10615,5,16,329,57,386
kafka,PR-9944,25,53,2555,807,3362
kafka,PR-10622,1,2,4,26,30
kafka,PR-10619,2,2,7,7,14
kafka,PR-10597,10,4,74,18,92
kafka,PR-10619,3,2,7,7,14
kafka,PR-10446,13,3,35,7,42
kafka,PR-10623,1,4,7,12,19
kafka,PR-10431,2,10,262,237,499
kafka,PR-10624,1,6,1275,4,1279
kafka,PR-10617,3,2,24,0,24
kafka,PR-10625,1,1,8,4,12
kafka,PR-10593,6,4,203,70,273
kafka,PR-10619,4,2,8,8,16
kafka,PR-10626,1,18,35,19,54
kafka,PR-10550,2,26,389,204,593
kafka,PR-10628,1,14,53,53,106
kafka,PR-10624,2,6,1275,4,1279
kafka,PR-9944,26,53,2554,807,3361
kafka,PR-10617,4,2,24,0,24
kafka,PR-10431,3,10,293,247,540
kafka,PR-10271,30,21,1122,148,1270
kafka,PR-10294,8,7,48,205,253
kafka,PR-10294,9,7,50,207,257
kafka,PR-10259,4,2,1,304,305
kafka,PR-10509,10,2,313,99,412
kafka,PR-10613,3,4,272,31,303
kafka,PR-10630,1,1,2,2,4
kafka,PR-9779,8,1,168,57,225
kafka,PR-10572,3,6,142,5,147
kafka,PR-10631,1,1,64,56,120
kafka,PR-10509,11,2,313,99,412
kafka,PR-10631,4,1,43,46,89
kafka,PR-10632,1,1,2,2,4
kafka,PR-10631,5,1,43,46,89
kafka,PR-10631,6,1,46,49,95
kafka,PR-10613,4,4,276,31,307
kafka,PR-10631,7,1,45,49,94
kafka,PR-10630,2,1,3,3,6
kafka,PR-10634,1,8,259,14,273
kafka,PR-10633,2,2,13,1,14
kafka,PR-10572,4,6,142,5,147
kafka,PR-9944,27,52,2548,790,3338
kafka,PR-10634,3,8,247,9,256
kafka,PR-10635,1,1,1,1,2
kafka,PR-10636,1,1,1,1,2
kafka,PR-10637,1,1,1,0,1
kafka,PR-10636,2,1,1,1,2
kafka,PR-10296,4,6,6,21,27
kafka,PR-10610,2,2,9,8,17
kafka,PR-10568,8,23,486,110,596
kafka,PR-10460,4,12,531,744,1275
kafka,PR-10639,1,1,36,31,67
kafka,PR-10640,1,3,19,0,19
kafka,PR-10641,1,1,1,1,2
kafka,PR-10642,1,1,1,1,2
kafka,PR-10640,2,5,41,3,44
kafka,PR-10561,2,7,142,30,172
kafka,PR-10634,4,8,251,9,260
kafka,PR-10431,4,10,295,249,544
kafka,PR-10634,5,8,251,9,260
kafka,PR-10640,4,20,64,21,85
kafka,PR-10643,1,1,4,5,9
kafka,PR-10621,3,8,260,54,314
kafka,PR-10646,1,1,19,33,52
kafka,PR-10645,2,1,33,20,53
kafka,PR-10572,5,6,142,5,147
kafka,PR-10525,2,3,76,4,80
kafka,PR-10647,1,1,0,4,4
kafka,PR-10610,3,2,9,8,17
kafka,PR-10390,8,11,359,141,500
kafka,PR-10638,5,64,152,83,235
kafka,PR-10649,2,3,18,7,25
kafka,PR-10650,1,1,1,1,2
kafka,PR-10651,1,14,1991,2120,4111
kafka,PR-10649,3,3,20,9,29
kafka,PR-10156,15,14,1586,1006,2592
kafka,PR-10431,5,10,299,251,550
kafka,PR-10156,16,14,1588,1006,2594
kafka,PR-10653,1,1,25,19,44
kafka,PR-10655,1,1,0,1,1
kafka,PR-10656,2,1,1,1,2
kafka,PR-10657,1,4,13,1,14
kafka,PR-10654,1,1,1,1,2
kafka,PR-9724,252,80,9215,309,9524
kafka,PR-9724,253,120,17808,296,18104
kafka,PR-10659,1,1,1,1,2
kafka,PR-10661,1,1,1,1,2
kafka,PR-10638,6,64,152,79,231
kafka,PR-10662,1,1,12,5,17
kafka,PR-10620,2,2,13,2,15
kafka,PR-10643,2,1,9,2,11
kafka,PR-10561,3,7,142,30,172
kafka,PR-10572,6,6,142,5,147
kafka,PR-10634,6,9,254,35,289
kafka,PR-10663,1,4,223,196,419
kafka,PR-10606,3,4,8,4,12
kafka,PR-10572,7,7,299,5,304
kafka,PR-10664,1,7,48,42,90
kafka,PR-10665,1,1,8,8,16
kafka,PR-10666,2,3,64,56,120
kafka,PR-10667,1,1,11,15,26
kafka,PR-10669,1,7,62,57,119
kafka,PR-10671,1,1,2,7,9
kafka,PR-10672,1,7,62,57,119
kafka,PR-10670,2,3,41,10,51
kafka,PR-10552,5,2,331,195,526
kafka,PR-10670,3,3,40,9,49
kafka,PR-9724,254,120,17808,296,18104
kafka,PR-10673,1,1,9,0,9
kafka,PR-10431,6,10,299,251,550
kafka,PR-10504,4,20,679,176,855
kafka,PR-10666,3,4,66,58,124
kafka,PR-10563,4,13,900,162,1062
kafka,PR-8259,4,12,3317,10,3327
kafka,PR-9724,255,130,17808,296,18104
kafka,PR-10676,1,3,32,30,62
kafka,PR-10676,2,5,49,46,95
kafka,PR-10677,1,1,3,0,3
kafka,PR-10677,2,1,3,0,3
kafka,PR-10504,5,20,679,176,855
kafka,PR-10654,2,2,3,3,6
kafka,PR-10494,10,17,740,124,864
kafka,PR-10677,3,2,5,1,6
kafka,PR-10504,6,25,847,133,980
kafka,PR-10679,1,6,142,5,147
kafka,PR-10572,8,7,299,5,304
kafka,PR-10677,4,2,5,1,6
kafka,PR-6592,12,11,1013,1,1014
kafka,PR-10680,1,5,25,42,67
kafka,PR-9980,5,1,1,1,2
kafka,PR-10504,7,28,845,137,982
kafka,PR-10572,10,8,261,6,267
kafka,PR-10675,4,15,65,185,250
kafka,PR-10677,5,2,7,0,7
kafka,PR-10676,3,5,49,46,95
kafka,PR-10677,6,2,7,0,7
kafka,PR-10685,1,2,7,0,7
kafka,PR-10676,4,19,286,158,444
kafka,PR-10677,7,2,9,0,9
kafka,PR-10677,8,2,7,0,7
kafka,PR-10677,9,2,9,0,9
kafka,PR-10507,19,186,6331,5150,11481
kafka,PR-10507,20,184,6238,5104,11342
kafka,PR-10685,2,2,9,0,9
kafka,PR-10679,2,6,145,5,150
kafka,PR-10685,3,2,9,0,9
kafka,PR-10675,5,15,65,185,250
kafka,PR-10609,20,19,515,178,693
kafka,PR-10572,12,7,194,4,198
kafka,PR-6592,14,11,1004,1,1005
kafka,PR-10572,13,6,193,2,195
kafka,PR-10689,1,7,148,1,149
kafka,PR-10690,1,1,5,3,8
kafka,PR-10689,2,6,120,0,120
kafka,PR-10677,10,2,9,0,9
kafka,PR-10691,3,149,517,353,870
kafka,PR-10686,5,2,17,9,26
kafka,PR-10677,11,2,10,0,10
kafka,PR-10660,2,4,7,6,13
kafka,PR-10693,1,3,857,2,859
kafka,PR-10677,12,2,10,0,10
kafka,PR-10606,7,4,15,11,26
kafka,PR-10620,3,2,14,2,16
kafka,PR-10504,8,28,851,141,992
kafka,PR-10634,7,9,254,35,289
kafka,PR-10694,1,3,24,11,35
kafka,PR-10695,1,10,77,773,850
kafka,PR-10688,3,7,241,48,289
kafka,PR-10696,1,4,160,187,347
kafka,PR-10606,8,4,15,11,26
kafka,PR-10504,9,28,857,142,999
kafka,PR-10697,1,1,2,0,2
kafka,PR-10696,2,4,159,188,347
kafka,PR-10690,2,1,4,4,8
kafka,PR-10494,11,17,789,124,913
kafka,PR-10694,2,3,23,10,33
kafka,PR-10699,1,26,509,288,797
kafka,PR-10691,4,152,534,367,901
kafka,PR-10700,1,1,0,2,2
kafka,PR-10702,2,2,14,15,29
kafka,PR-10703,1,1,2,2,4
kafka,PR-10705,1,37,605,951,1556
kafka,PR-10664,2,7,153,48,201
kafka,PR-10706,1,1,1,1,2
kafka,PR-10703,2,1,7,5,12
kafka,PR-9229,15,34,568,333,901
kafka,PR-10585,3,1,9,0,9
kafka,PR-9310,8,2,18,3,21
kafka,PR-10620,4,2,13,2,15
kafka,PR-10550,3,26,509,288,797
kafka,PR-10550,4,26,516,288,804
kafka,PR-10708,1,1,3,5,8
kafka,PR-9944,29,55,3009,831,3840
kafka,PR-10704,3,2,52,1,53
kafka,PR-10705,2,37,605,950,1555
kafka,PR-10644,4,3,175,26,201
kafka,PR-10677,13,2,10,0,10
kafka,PR-10156,17,13,1590,1006,2596
kafka,PR-10709,1,1,0,1,1
kafka,PR-10675,6,15,66,185,251
kafka,PR-10646,2,2,25,35,60
kafka,PR-10156,18,13,1601,1015,2616
kafka,PR-10706,2,1,1,1,2
kafka,PR-10596,2,2,41,2,43
kafka,PR-10694,3,3,22,9,31
kafka,PR-10711,1,5,6,6,12
kafka,PR-10712,1,4,37,11,48
kafka,PR-10709,2,1,6,7,13
kafka,PR-10633,3,2,13,1,14
kafka,PR-10579,14,19,2541,431,2972
kafka,PR-10694,4,3,23,10,33
kafka,PR-10700,2,1,2,2,4
kafka,PR-10713,1,3,18,18,36
kafka,PR-10714,1,4,67,3,70
kafka,PR-10561,4,7,142,30,172
kafka,PR-10572,15,6,182,2,184
kafka,PR-10550,5,26,516,288,804
kafka,PR-10572,16,6,183,2,185
kafka,PR-10579,15,19,2541,431,2972
kafka,PR-10156,19,33,1807,1094,2901
kafka,PR-10705,3,37,643,948,1591
kafka,PR-9724,256,130,17601,296,17897
kafka,PR-10715,1,1,3,0,3
kafka,PR-10713,2,3,18,18,36
kafka,PR-10689,5,8,220,44,264
kafka,PR-10664,4,7,168,48,216
kafka,PR-10457,12,3,122,871,993
kafka,PR-10552,7,3,445,333,778
kafka,PR-10717,1,1,1,0,1
kafka,PR-10550,6,26,514,272,786
kafka,PR-10651,2,14,1992,2123,4115
kafka,PR-10504,10,28,860,142,1002
kafka,PR-10696,3,4,188,218,406
kafka,PR-10719,1,2,5,4,9
kafka,PR-10652,3,9,323,53,376
kafka,PR-10681,6,22,497,19,516
kafka,PR-10629,2,2,110,0,110
kafka,PR-10715,2,1,2,0,2
kafka,PR-10720,1,17,109,78,187
kafka,PR-10722,1,2,6,7,13
kafka,PR-9311,2,19,550,59,609
kafka,PR-10700,3,1,2,2,4
kafka,PR-10482,23,65,134,80,214
kafka,PR-10723,1,8,15,23,38
kafka,PR-10724,1,3,6,171,177
kafka,PR-9724,257,130,17735,296,18031
kafka,PR-9766,12,4,111,63,174
kafka,PR-10727,1,2,0,13,13
kafka,PR-10728,1,1,4,2,6
kafka,PR-10729,2,2,4,67,71
kafka,PR-10730,1,12,9,128,137
kafka,PR-9724,258,170,17735,296,18031
kafka,PR-10482,24,65,134,80,214
kafka,PR-10714,2,4,67,3,70
kafka,PR-10730,2,12,12,128,140
kafka,PR-10729,3,2,4,67,71
kafka,PR-10475,11,11,435,60,495
kafka,PR-10720,2,17,109,78,187
kafka,PR-10731,1,1,8,2,10
kafka,PR-10732,2,5,178,306,484
kafka,PR-9724,259,170,17735,296,18031
kafka,PR-10338,5,1,20,3,23
kafka,PR-10482,25,65,134,80,214
kafka,PR-10735,3,25,232,167,399
kafka,PR-9724,260,170,17736,297,18033
kafka,PR-10457,13,4,82,826,908
kafka,PR-10471,7,3,54,467,521
kafka,PR-10736,1,1,1,1,2
kafka,PR-9724,261,170,17735,296,18031
kafka,PR-10367,11,2,521,74,595
kafka,PR-10737,1,1,0,17,17
kafka,PR-10375,5,2,40,0,40
kafka,PR-9724,262,210,17735,296,18031
kafka,PR-9724,263,250,17735,296,18031
kafka,PR-10724,2,3,6,173,179
kafka,PR-10739,1,1,1,1,2
kafka,PR-10705,5,40,956,943,1899
kafka,PR-10482,26,65,138,80,218
kafka,PR-10705,6,40,960,944,1904
kafka,PR-10741,1,44,156,1,157
kafka,PR-10742,1,9,66,52,118
kafka,PR-10742,2,9,66,52,118
kafka,PR-10652,5,10,577,33,610
kafka,PR-10609,22,20,578,191,769
kafka,PR-10731,2,1,8,2,10
kafka,PR-10609,24,21,522,165,687
kafka,PR-10690,3,1,6,6,12
kafka,PR-10742,3,9,65,51,116
kafka,PR-10482,27,65,138,80,218
kafka,PR-10724,3,3,6,173,179
kafka,PR-10651,3,14,1992,2123,4115
kafka,PR-10648,4,12,869,75,944
kafka,PR-10504,11,32,868,154,1022
kafka,PR-10651,4,14,1994,2125,4119
kafka,PR-10665,3,1,6,6,12
kafka,PR-10482,28,65,138,80,218
kafka,PR-10649,4,6,55,13,68
kafka,PR-10652,7,9,460,33,493
kafka,PR-10744,1,70,514,221,735
kafka,PR-10682,3,1,23,18,41
kafka,PR-10742,4,9,71,51,122
kafka,PR-10742,5,9,71,51,122
kafka,PR-9672,142,250,17732,296,18028
kafka,PR-10596,3,2,41,2,43
kafka,PR-10156,21,33,1807,1094,2901
kafka,PR-10698,6,2,6,2,8
kafka,PR-10745,1,1,35,34,69
kafka,PR-10722,2,2,3,7,10
kafka,PR-10746,1,1,3,3,6
kafka,PR-10747,1,6,47,50,97
kafka,PR-10749,1,7,109,92,201
kafka,PR-10750,1,1,24,7,31
kafka,PR-10747,2,6,47,52,99
kafka,PR-10728,2,1,4,2,6
kafka,PR-10552,8,3,446,334,780
kafka,PR-10751,1,1,2,2,4
kafka,PR-10752,1,16,397,28,425
kafka,PR-10754,1,5,126,11,137
kafka,PR-10752,2,16,397,28,425
kafka,PR-10755,1,3,57,1,58
kafka,PR-10609,26,22,536,165,701
kafka,PR-10754,2,6,127,12,139
kafka,PR-10017,9,4,32,9,41
kafka,PR-10755,2,3,56,0,56
kafka,PR-10609,27,22,624,159,783
kafka,PR-10747,3,6,47,52,99
kafka,PR-10746,2,2,6,6,12
kafka,PR-10609,28,22,615,159,774
kafka,PR-10683,13,42,1157,425,1582
kafka,PR-10755,4,4,64,0,64
kafka,PR-10756,1,1,3,3,6
kafka,PR-10749,3,7,93,92,185
kafka,PR-10749,4,7,98,95,193
kafka,PR-10757,1,9,32,21,53
kafka,PR-10552,9,3,459,335,794
kafka,PR-10758,1,1,34,0,34
kafka,PR-10759,1,6,14,14,28
kafka,PR-10760,1,8,216,64,280
kafka,PR-10761,1,10,33,30,63
kafka,PR-10757,2,9,28,21,49
kafka,PR-10762,2,12,180,112,292
kafka,PR-10763,1,1,39,1,40
kafka,PR-10683,16,44,1692,441,2133
kafka,PR-10755,5,4,65,0,65
kafka,PR-10683,17,62,1796,517,2313
kafka,PR-10609,29,22,615,159,774
kafka,PR-10017,10,5,34,11,45
kafka,PR-10755,6,4,65,0,65
kafka,PR-9229,16,34,568,333,901
kafka,PR-10683,18,62,1864,519,2383
kafka,PR-10764,1,1,4,4,8
kafka,PR-10762,3,12,180,112,292
kafka,PR-10710,2,5,1,311,312
kafka,PR-10766,1,5,159,158,317
kafka,PR-10767,1,1,11,11,22
kafka,PR-10768,1,1,217,217,434
kafka,PR-10769,1,1,185,231,416
kafka,PR-10770,1,1,685,686,1371
kafka,PR-10766,2,5,159,158,317
kafka,PR-10752,3,18,398,28,426
kafka,PR-10683,21,64,1927,524,2451
kafka,PR-10704,4,2,52,1,53
kafka,PR-10771,1,1,1,1,2
kafka,PR-10772,1,7,74,8,82
kafka,PR-10773,1,250,17732,296,18028
kafka,PR-10683,24,64,2042,529,2571
kafka,PR-10609,31,22,615,159,774
kafka,PR-10684,11,3,119,54,173
kafka,PR-10683,25,64,2042,529,2571
kafka,PR-10773,2,251,17732,296,18028
kafka,PR-10766,3,5,159,158,317
kafka,PR-10768,2,1,217,217,434
kafka,PR-10534,4,2,40,2,42
kafka,PR-10774,1,2,10,0,10
kafka,PR-10770,2,1,720,721,1441
kafka,PR-10593,8,4,189,61,250
kafka,PR-10776,1,5,10,10,20
kafka,PR-10777,1,2,7,7,14
kafka,PR-10773,3,251,17732,296,18028
kafka,PR-10778,1,2,3,5,8
kafka,PR-10704,5,2,57,3,60
kafka,PR-10761,3,10,35,30,65
kafka,PR-10775,3,3,60,7,67
kafka,PR-10764,2,1,9,4,13
kafka,PR-10704,6,1,7,3,10
kafka,PR-10744,2,70,514,221,735
kafka,PR-10780,1,1,4,3,7
kafka,PR-10780,2,1,5,5,10
kafka,PR-10584,2,5,78,2,80
kafka,PR-10749,5,7,98,93,191
kafka,PR-10736,2,1,1,1,2
kafka,PR-10593,9,4,192,61,253
kafka,PR-10773,4,252,17739,296,18035
kafka,PR-10781,1,1,1,1,2
kafka,PR-10782,1,1,2,2,4
kafka,PR-10736,3,1,1,1,2
kafka,PR-10783,1,2,6,6,12
kafka,PR-10786,1,26,465,609,1074
kafka,PR-10785,3,33,1424,208,1632
kafka,PR-10652,8,9,460,33,493
kafka,PR-10785,4,34,1488,208,1696
kafka,PR-10609,32,22,615,159,774
kafka,PR-9229,17,34,568,333,901
kafka,PR-10789,1,2,13,3,16
kafka,PR-10790,2,1,2,2,4
kafka,PR-10585,4,1,8,0,8
kafka,PR-10791,1,1,1,1,2
kafka,PR-10792,1,4,36,72,108
kafka,PR-10749,6,7,98,93,191
kafka,PR-10794,1,5,44,13,57
kafka,PR-10795,1,2,66,1,67
kafka,PR-10783,2,2,5,5,10
kafka,PR-10785,5,34,1667,208,1875
kafka,PR-10794,2,5,44,13,57
kafka,PR-10794,3,5,69,13,82
kafka,PR-10585,5,1,8,0,8
kafka,PR-10785,6,34,1711,208,1919
kafka,PR-10796,1,1,1,1,2
kafka,PR-10797,1,1,1,1,2
kafka,PR-10738,4,25,190,64,254
kafka,PR-10794,4,9,215,19,234
kafka,PR-10785,7,34,1790,208,1998
kafka,PR-10765,5,73,788,2947,3735
kafka,PR-10585,6,1,8,0,8
kafka,PR-10794,5,11,228,26,254
kafka,PR-10785,8,35,1811,208,2019
kafka,PR-10738,6,27,287,70,357
kafka,PR-10746,3,2,6,6,12
kafka,PR-10799,1,15,1066,433,1499
kafka,PR-10785,9,36,1820,210,2030
kafka,PR-10800,1,2,6,1,7
kafka,PR-10783,3,2,5,5,10
kafka,PR-10797,2,1,1,1,2
kafka,PR-10794,6,11,244,26,270
kafka,PR-10786,2,32,687,625,1312
kafka,PR-9672,158,252,17739,296,18035
kafka,PR-10770,3,1,721,722,1443
kafka,PR-10785,10,36,1820,210,2030
kafka,PR-10801,1,2,6,6,12
kafka,PR-10802,1,11,93,42,135
kafka,PR-10797,3,1,1,1,2
kafka,PR-9944,31,59,3238,868,4106
kafka,PR-10754,4,6,129,13,142
kafka,PR-10590,8,4,88,15,103
kafka,PR-10616,4,29,1929,293,2222
kafka,PR-10803,3,4,5,3,8
kafka,PR-10749,7,11,171,119,290
kafka,PR-10801,2,2,6,6,12
kafka,PR-10805,1,1,5,0,5
kafka,PR-10664,5,5,109,35,144
kafka,PR-10736,5,1,1,2,3
kafka,PR-10806,1,1,1,0,1
kafka,PR-10593,10,4,195,61,256
kafka,PR-10808,1,3,3,37,40
kafka,PR-10738,7,30,295,73,368
kafka,PR-10808,2,3,3,37,40
kafka,PR-10805,2,1,4,0,4
kafka,PR-10787,4,3,0,0,0
kafka,PR-10803,4,10,19,8,27
kafka,PR-10698,7,2,6,2,8
kafka,PR-10668,3,1,199,181,380
kafka,PR-10772,2,7,129,8,137
kafka,PR-10749,8,11,174,119,293
kafka,PR-10803,5,10,19,8,27
kafka,PR-10731,3,2,14,3,17
kafka,PR-10471,8,4,59,492,551
kafka,PR-10664,6,5,111,37,148
kafka,PR-10811,1,2,60,52,112
kafka,PR-10664,7,5,111,37,148
kafka,PR-10471,9,4,59,492,551
kafka,PR-10793,2,8,148,278,426
kafka,PR-10664,8,5,111,37,148
kafka,PR-10731,4,3,16,5,21
kafka,PR-10652,9,9,460,33,493
kafka,PR-10805,3,1,4,0,4
kafka,PR-10731,5,3,16,5,21
kafka,PR-10809,2,1,21,31,52
kafka,PR-10803,6,10,19,8,27
kafka,PR-10646,3,2,33,35,68
kafka,PR-10793,3,8,210,282,492
kafka,PR-10815,1,2,15,8,23
kafka,PR-10817,1,1,4,4,8
kafka,PR-10818,1,1,4,1,5
kafka,PR-10819,1,1,5,4,9
kafka,PR-10646,4,2,33,35,68
kafka,PR-10805,4,1,4,4,8
kafka,PR-10817,2,1,4,4,8
kafka,PR-10814,2,22,1256,19,1275
kafka,PR-10821,1,2,26,65,91
kafka,PR-10803,7,10,19,8,27
kafka,PR-10823,1,2,93,13,106
kafka,PR-10805,5,2,7,4,11
kafka,PR-7480,3,4,296,0,296
kafka,PR-10815,2,2,14,8,22
kafka,PR-10823,2,2,94,13,107
kafka,PR-10824,1,3,14,14,28
kafka,PR-9311,4,19,573,65,638
kafka,PR-10821,2,2,26,65,91
kafka,PR-10821,3,2,26,65,91
kafka,PR-10760,2,13,416,23,439
kafka,PR-9590,24,15,546,82,628
kafka,PR-10828,1,3,29,6,35
kafka,PR-10828,2,4,36,6,42
kafka,PR-10749,9,11,194,130,324
kafka,PR-10820,3,1,2,1,3
kafka,PR-10749,10,11,173,117,290
kafka,PR-10802,2,11,93,42,135
kafka,PR-10785,11,36,1820,210,2030
kafka,PR-10828,3,4,43,6,49
kafka,PR-10793,4,8,213,283,496
kafka,PR-10829,1,1,0,16,16
kafka,PR-9441,17,7,229,70,299
kafka,PR-10784,2,25,304,214,518
kafka,PR-10830,2,13,131,6,137
kafka,PR-10831,2,15,212,75,287
kafka,PR-10832,1,1,1,1,2
kafka,PR-10763,2,1,39,1,40
kafka,PR-10833,1,1,1,1,2
kafka,PR-10834,1,1,1,1,2
kafka,PR-10836,1,3,211,21,232
kafka,PR-10763,3,2,93,1,94
kafka,PR-10803,8,10,19,8,27
kafka,PR-10828,4,4,43,6,49
kafka,PR-10837,1,64,1428,305,1733
kafka,PR-10835,3,2,19,33,52
kafka,PR-10836,2,4,206,28,234
kafka,PR-10828,5,4,43,6,49
kafka,PR-10835,4,2,17,33,50
kafka,PR-10834,2,1,1,1,2
kafka,PR-10336,3,2,22,4,26
kafka,PR-10335,4,1,3,4,7
kafka,PR-10786,3,33,835,710,1545
kafka,PR-10838,1,1,5,3,8
kafka,PR-10802,3,11,125,44,169
kafka,PR-10760,3,13,416,23,439
kafka,PR-10802,4,11,123,44,167
kafka,PR-10760,4,13,454,23,477
kafka,PR-10802,5,11,134,35,169
kafka,PR-10786,4,33,826,709,1535
kafka,PR-10760,5,13,454,23,477
kafka,PR-10810,5,28,385,233,618
kafka,PR-10846,1,1,1,1,2
kafka,PR-10845,2,6,16,7,23
kafka,PR-10803,9,10,19,8,27
kafka,PR-9590,25,15,546,82,628
kafka,PR-8259,5,4,487,8,495
kafka,PR-10810,6,28,385,233,618
kafka,PR-10847,1,1,1,1,2
kafka,PR-10794,7,10,260,27,287
kafka,PR-10749,11,11,169,122,291
kafka,PR-10786,5,34,788,720,1508
kafka,PR-10749,12,11,160,122,282
kafka,PR-10816,5,253,17739,295,18034
kafka,PR-10849,1,1,1,0,1
kafka,PR-10850,1,8,241,365,606
kafka,PR-10835,5,2,18,34,52
kafka,PR-10851,1,17,1048,76,1124
kafka,PR-10835,6,2,13,28,41
kafka,PR-10850,2,8,211,368,579
kafka,PR-10853,1,1,1,0,1
kafka,PR-10855,1,33,2,58,60
kafka,PR-10856,1,20,35,60,95
kafka,PR-10854,2,19,71,184,255
kafka,PR-10850,3,8,207,375,582
kafka,PR-10853,2,1,1,0,1
kafka,PR-10856,2,20,34,60,94
kafka,PR-10855,2,33,2,58,60
kafka,PR-10810,7,28,385,233,618
kafka,PR-10857,1,27,474,437,911
kafka,PR-10858,1,3,5,8,13
kafka,PR-10683,37,58,1494,424,1918
kafka,PR-10850,4,8,207,375,582
kafka,PR-10816,6,256,17765,298,18063
kafka,PR-10736,6,1,1,2,3
kafka,PR-9414,21,4,347,9,356
kafka,PR-10818,2,2,42,1,43
kafka,PR-10856,3,20,34,60,94
kafka,PR-10860,2,1,0,3,3
kafka,PR-10847,2,1,1,1,2
kafka,PR-10850,5,7,207,361,568
kafka,PR-10863,1,6,403,9,412
kafka,PR-10850,6,7,206,361,567
kafka,PR-10863,2,6,396,9,405
kafka,PR-10749,13,11,159,124,283
kafka,PR-10786,6,34,819,734,1553
kafka,PR-10649,5,7,57,13,70
kafka,PR-10847,3,1,1,1,2
kafka,PR-10863,3,6,408,9,417
kafka,PR-10584,3,5,71,2,73
kafka,PR-10865,1,14,417,269,686
kafka,PR-10858,2,3,5,8,13
kafka,PR-10858,3,3,5,8,13
kafka,PR-10846,2,4,27,16,43
kafka,PR-10863,4,6,410,9,419
kafka,PR-10818,3,2,50,1,51
kafka,PR-10816,9,257,17776,302,18078
kafka,PR-10866,1,1,2,1,3
kafka,PR-10848,5,4,90,27,117
kafka,PR-10847,4,1,1,1,2
kafka,PR-10858,4,1,1,1,2
kafka,PR-10383,5,2,31,3,34
kafka,PR-10702,4,3,15,16,31
kafka,PR-10584,5,5,86,1,87
kafka,PR-10383,6,2,30,2,32
kafka,PR-10868,1,2,7,0,7
kafka,PR-10869,1,90,643,393,1036
kafka,PR-10702,6,3,39,25,64
kafka,PR-10702,7,3,57,21,78
kafka,PR-10816,10,257,17777,303,18080
kafka,PR-10869,3,126,700,397,1097
kafka,PR-10847,5,1,1,1,2
kafka,PR-10816,11,257,17489,303,17792
kafka,PR-10847,6,1,1,1,2
kafka,PR-10816,12,297,17489,303,17792
kafka,PR-10869,4,126,700,397,1097
kafka,PR-10870,1,2,2,1,3
kafka,PR-10858,5,1,2,1,3
kafka,PR-10848,6,4,90,27,117
kafka,PR-10858,6,2,6,3,9
kafka,PR-10816,13,297,17496,304,17800
kafka,PR-10871,2,2,11,3,14
kafka,PR-10873,1,1,8,5,13
kafka,PR-10874,1,1,13,56,69
kafka,PR-10875,1,1,13,56,69
kafka,PR-10876,1,1,4,19,23
kafka,PR-10811,2,3,62,52,114
kafka,PR-10816,14,297,17496,304,17800
kafka,PR-10873,2,1,8,5,13
kafka,PR-10816,16,297,17494,303,17797
kafka,PR-10773,33,297,17513,303,17816
kafka,PR-9944,32,59,3250,870,4120
kafka,PR-10852,4,2,14,15,29
kafka,PR-10851,2,17,1048,76,1124
kafka,PR-10802,6,11,134,35,169
kafka,PR-10773,34,298,17567,304,17871
kafka,PR-10863,5,6,431,12,443
kafka,PR-10873,3,1,8,5,13
kafka,PR-10872,5,10,83,190,273
kafka,PR-10878,1,2,38,5,43
kafka,PR-10863,6,6,431,13,444
kafka,PR-10584,6,5,101,7,108
kafka,PR-10879,1,1,8,6,14
kafka,PR-10880,1,3,8,10,18
kafka,PR-10881,1,4,276,431,707
kafka,PR-10804,8,33,42,0,42
kafka,PR-10882,1,2,34,0,34
kafka,PR-10584,7,5,101,7,108
kafka,PR-10882,2,2,34,0,34
kafka,PR-10749,14,11,159,124,283
kafka,PR-10843,6,3,15,6,21
kafka,PR-10883,1,1,2,0,2
kafka,PR-10861,3,10,1046,611,1657
kafka,PR-10786,8,34,975,740,1715
kafka,PR-10773,35,298,17577,304,17881
kafka,PR-10584,8,5,94,4,98
kafka,PR-10838,2,1,5,3,8
kafka,PR-10884,1,3,21,22,43
kafka,PR-10879,2,2,29,19,48
kafka,PR-10816,17,230,17451,305,17756
kafka,PR-10773,36,230,17451,305,17756
kafka,PR-10863,7,6,443,13,456
kafka,PR-10878,2,2,48,14,62
kafka,PR-10858,7,2,32,2,34
kafka,PR-10872,6,10,83,190,273
kafka,PR-10773,37,230,17450,304,17754
kafka,PR-10816,18,230,17450,304,17754
kafka,PR-10881,2,5,277,433,710
kafka,PR-10861,4,11,1074,615,1689
kafka,PR-10872,7,10,83,190,273
kafka,PR-10885,1,5,91,4,95
kafka,PR-10886,1,1,24,12,36
kafka,PR-10883,2,1,2,0,2
kafka,PR-10754,5,6,137,17,154
kafka,PR-10773,38,230,17450,304,17754
kafka,PR-10886,2,1,22,10,32
kafka,PR-10754,6,6,157,30,187
kafka,PR-10872,8,10,83,190,273
kafka,PR-10814,3,4,1194,0,1194
kafka,PR-10861,7,11,1132,615,1747
kafka,PR-10867,4,28,232,185,417
kafka,PR-10773,39,231,17469,305,17774
kafka,PR-10816,19,231,17469,305,17774
kafka,PR-10701,4,3,39,23,62
kafka,PR-10868,2,2,7,0,7
kafka,PR-10763,4,2,83,1,84
kafka,PR-10858,8,2,90,7,97
kafka,PR-10733,8,8,686,11,697
kafka,PR-10868,3,4,26,5,31
kafka,PR-10861,8,12,1131,621,1752
kafka,PR-10773,40,231,17476,305,17781
kafka,PR-10816,20,231,17476,305,17781
kafka,PR-10888,1,4,50,40,90
kafka,PR-10863,8,6,445,12,457
kafka,PR-10863,9,9,519,51,570
kafka,PR-10872,9,10,100,200,300
kafka,PR-10889,4,2,320,3,323
kafka,PR-10863,10,9,519,51,570
kafka,PR-10629,3,2,110,0,110
kafka,PR-10888,2,4,53,43,96
kafka,PR-10652,10,9,460,33,493
kafka,PR-10872,10,10,100,200,300
kafka,PR-10880,2,5,216,21,237
kafka,PR-10890,1,1,5,6,11
kafka,PR-10887,3,20,548,511,1059
kafka,PR-10891,1,10,120,13,133
kafka,PR-10836,3,4,192,28,220
kafka,PR-10652,11,10,490,32,522
kafka,PR-10805,6,2,7,4,11
kafka,PR-10891,2,10,123,13,136
kafka,PR-10836,4,4,178,27,205
kafka,PR-10824,4,3,12,12,24
kafka,PR-10816,21,231,17479,305,17784
kafka,PR-10892,2,13,390,82,472
kafka,PR-10588,11,4,227,43,270
kafka,PR-10733,10,8,686,11,697
kafka,PR-10701,5,3,39,23,62
kafka,PR-10818,4,2,50,1,51
kafka,PR-10894,1,2,72,2,74
kafka,PR-10863,11,9,520,51,571
kafka,PR-10836,5,4,162,29,191
kafka,PR-10818,5,2,50,1,51
kafka,PR-10863,12,9,520,51,571
kafka,PR-10895,1,9,518,47,565
kafka,PR-10593,11,3,149,51,200
kafka,PR-10593,12,3,146,45,191
kafka,PR-10649,6,7,57,13,70
kafka,PR-10896,1,4,178,9,187
kafka,PR-10869,7,126,697,396,1093
kafka,PR-10763,5,2,112,25,137
kafka,PR-10858,9,2,90,7,97
kafka,PR-10593,13,3,139,37,176
kafka,PR-10649,7,7,58,13,71
kafka,PR-10763,6,2,111,25,136
kafka,PR-10893,2,1,21,0,21
kafka,PR-10836,6,4,162,29,191
kafka,PR-10891,3,11,118,20,138
kafka,PR-10754,7,6,158,30,188
kafka,PR-10897,1,6,7,7,14
kafka,PR-10898,1,1,2,1,3
kafka,PR-10868,4,4,26,5,31
kafka,PR-10901,1,1,3,3,6
kafka,PR-10858,10,2,90,7,97
kafka,PR-10147,3,1,4,1,5
kafka,PR-10902,1,1,3,1,4
kafka,PR-10824,5,3,12,12,24
kafka,PR-10903,1,1,2,1,3
kafka,PR-10904,1,2,17,24,41
kafka,PR-10838,4,3,197,57,254
kafka,PR-10593,14,3,116,35,151
kafka,PR-10593,15,2,115,34,149
kafka,PR-10869,8,126,696,395,1091
kafka,PR-10593,16,2,115,34,149
kafka,PR-10760,6,14,461,39,500
kafka,PR-10902,3,7,62,19,81
kafka,PR-10905,1,2,5,5,10
kafka,PR-10814,4,5,1215,0,1215
kafka,PR-10880,3,7,259,34,293
kafka,PR-9944,34,58,3197,872,4069
kafka,PR-10894,4,3,164,121,285
kafka,PR-10814,5,5,1201,0,1201
kafka,PR-9944,35,58,3197,872,4069
kafka,PR-10900,3,7,140,25,165
kafka,PR-10903,2,1,2,1,3
kafka,PR-10824,7,3,12,12,24
kafka,PR-10377,7,1,2,2,4
kafka,PR-10377,8,1,2,2,4
kafka,PR-10794,9,6,173,10,183
kafka,PR-10908,1,1,2,1,3
kafka,PR-10868,5,4,26,5,31
kafka,PR-10812,8,15,421,77,498
kafka,PR-10794,10,6,173,10,183
kafka,PR-10907,4,88,9666,1766,11432
kafka,PR-10907,5,88,9778,1766,11544
kafka,PR-10816,22,230,17486,306,17792
kafka,PR-10802,7,11,134,35,169
kafka,PR-10851,3,17,1048,76,1124
kafka,PR-10862,3,2,53,16,69
kafka,PR-10910,1,2,18,2,20
kafka,PR-10816,23,230,17499,306,17805
kafka,PR-10911,1,4,0,78,78
kafka,PR-10896,2,4,218,12,230
kafka,PR-10907,6,90,9792,1767,11559
kafka,PR-10760,8,20,456,55,511
kafka,PR-10896,3,4,217,12,229
kafka,PR-10760,9,20,456,55,511
kafka,PR-10900,4,7,145,25,170
kafka,PR-10763,7,2,139,114,253
kafka,PR-10907,7,90,9799,1768,11567
kafka,PR-10912,1,3,6,32,38
kafka,PR-10652,12,10,490,32,522
kafka,PR-10812,9,17,450,93,543
kafka,PR-10763,8,2,188,115,303
kafka,PR-10805,7,2,7,4,11
kafka,PR-10907,8,90,9758,1768,11526
kafka,PR-10652,13,10,488,32,520
kafka,PR-10812,10,17,451,93,544
kafka,PR-10907,9,90,9769,1768,11537
kafka,PR-10816,24,230,17499,306,17805
kafka,PR-10913,2,4,185,11,196
kafka,PR-10914,1,15,513,143,656
kafka,PR-10884,2,3,31,27,58
kafka,PR-10763,9,2,197,131,328
kafka,PR-10915,1,4,75,10,85
kafka,PR-10916,1,1,8,7,15
kafka,PR-10854,3,19,71,184,255
kafka,PR-10816,25,230,17252,307,17559
kafka,PR-10816,26,230,17256,307,17563
kafka,PR-10912,2,5,6,68,74
kafka,PR-10763,10,1,140,131,271
kafka,PR-10760,10,20,467,55,522
kafka,PR-10816,27,230,17261,307,17568
kafka,PR-10841,7,7,93,97,190
kafka,PR-10896,4,4,221,12,233
kafka,PR-10629,4,2,110,0,110
kafka,PR-10913,3,4,183,11,194
kafka,PR-10763,11,1,142,131,273
kafka,PR-10763,12,1,109,74,183
kafka,PR-10913,4,4,201,16,217
kafka,PR-10918,1,5,31,4,35
kafka,PR-10763,13,2,128,33,161
kafka,PR-10913,5,5,218,17,235
kafka,PR-10915,2,4,82,11,93
kafka,PR-9944,36,58,3189,874,4063
kafka,PR-10816,28,230,17265,307,17572
kafka,PR-10915,3,4,82,11,93
kafka,PR-10916,6,1,12,7,19
kafka,PR-7802,6,10,290,51,341
kafka,PR-10763,14,2,128,33,161
kafka,PR-10816,29,230,17265,307,17572
kafka,PR-10919,1,1,1,1,2
kafka,PR-10916,7,1,14,7,21
kafka,PR-10920,1,4,27,4,31
kafka,PR-10760,12,20,408,46,454
kafka,PR-10825,3,12,87,30,117
kafka,PR-10922,1,1,15,8,23
kafka,PR-10918,2,5,25,4,29
kafka,PR-10840,4,38,1370,183,1553
kafka,PR-10854,4,19,72,184,256
kafka,PR-10922,2,1,16,8,24
kafka,PR-10854,5,19,73,184,257
kafka,PR-10918,3,11,55,8,63
kafka,PR-10190,5,2,21,1,22
kafka,PR-10923,1,2,3,5,8
kafka,PR-10190,6,2,21,1,22
kafka,PR-10858,11,2,82,7,89
kafka,PR-10887,4,20,546,510,1056
kafka,PR-10763,15,2,113,91,204
kafka,PR-10916,8,1,10,14,24
kafka,PR-10763,16,2,110,91,201
kafka,PR-10816,30,231,17297,308,17605
kafka,PR-10916,9,1,10,14,24
kafka,PR-10879,3,2,29,19,48
kafka,PR-10916,10,1,11,15,26
kafka,PR-10900,5,7,171,25,196
kafka,PR-10913,6,5,230,28,258
kafka,PR-10916,11,1,11,15,26
kafka,PR-10760,13,21,448,47,495
kafka,PR-10816,32,231,17309,308,17617
kafka,PR-10916,12,1,12,15,27
kafka,PR-10879,4,2,29,19,48
kafka,PR-10925,1,1,1,1,2
kafka,PR-10923,2,2,2,5,7
kafka,PR-10926,1,49,380,72,452
kafka,PR-10916,13,1,12,15,27
kafka,PR-10926,2,49,389,72,461
kafka,PR-10816,33,231,17314,307,17621
kafka,PR-10928,1,1,4,5,9
kafka,PR-10921,4,3,66,1,67
kafka,PR-10760,14,21,441,47,488
kafka,PR-10221,4,6,181,5,186
kafka,PR-10840,5,38,1467,190,1657
kafka,PR-10922,3,1,0,18,18
kafka,PR-10748,4,1,6,0,6
kafka,PR-10840,6,38,1473,190,1663
kafka,PR-10929,1,1,13,1,14
kafka,PR-10221,5,6,184,5,189
kafka,PR-10918,4,7,35,8,43
kafka,PR-10864,1,9,376,177,553
kafka,PR-10858,12,2,87,7,94
kafka,PR-10927,3,20,164,52,216
kafka,PR-10816,36,228,17104,353,17457
kafka,PR-10858,13,2,87,7,94
kafka,PR-10763,17,2,110,91,201
kafka,PR-10812,12,17,546,96,642
kafka,PR-10763,18,2,97,92,189
kafka,PR-10748,5,1,7,0,7
kafka,PR-10816,37,229,17126,353,17479
kafka,PR-10932,1,2,48,1,49
kafka,PR-10816,38,229,17126,353,17479
kafka,PR-10773,45,229,17126,353,17479
kafka,PR-10816,40,229,17121,353,17474
kafka,PR-10773,48,229,17117,353,17470
kafka,PR-10816,41,230,17118,353,17471
kafka,PR-10773,49,230,17119,353,17472
kafka,PR-10920,2,4,27,4,31
kafka,PR-10919,2,1,1,1,2
kafka,PR-10811,3,3,62,52,114
kafka,PR-10816,42,230,17118,353,17471
kafka,PR-10864,2,9,438,176,614
kafka,PR-10918,5,7,35,8,43
kafka,PR-10936,1,2,49,4,53
kafka,PR-10892,3,13,396,100,496
kafka,PR-10915,4,5,85,12,97
kafka,PR-10763,19,2,98,92,190
kafka,PR-10864,3,9,437,175,612
kafka,PR-10913,8,6,252,32,284
kafka,PR-10892,4,13,332,101,433
kafka,PR-10824,8,3,12,12,24
kafka,PR-10899,16,20,515,90,605
kafka,PR-10858,14,2,86,7,93
kafka,PR-10763,20,2,97,92,189
kafka,PR-9944,37,58,3208,878,4086
kafka,PR-10899,17,21,553,95,648
kafka,PR-10816,43,230,17118,353,17471
kafka,PR-9944,38,58,3207,878,4085
kafka,PR-10899,18,21,546,92,638
kafka,PR-10930,2,2,11,0,11
kafka,PR-10938,1,1,15,8,23
kafka,PR-10939,1,1,3,2,5
kafka,PR-10838,5,3,179,44,223
kafka,PR-10838,6,8,190,52,242
kafka,PR-10931,9,86,4994,4681,9675
kafka,PR-10932,2,2,30,1,31
kafka,PR-10940,1,1,2,1,3
kafka,PR-10864,4,10,443,178,621
kafka,PR-10892,5,13,335,103,438
kafka,PR-10864,5,10,439,178,617
kafka,PR-10887,5,18,146,139,285
kafka,PR-10926,3,49,404,79,483
kafka,PR-10941,1,7,62,219,281
kafka,PR-10936,2,3,61,9,70
kafka,PR-10652,14,11,495,33,528
kafka,PR-10892,6,13,337,103,440
kafka,PR-10942,1,2,408,384,792
kafka,PR-10932,3,2,30,1,31
kafka,PR-10932,4,2,30,1,31
kafka,PR-10822,38,36,2579,41,2620
kafka,PR-10892,7,13,354,103,457
kafka,PR-10811,4,3,74,56,130
kafka,PR-10903,3,1,2,1,3
kafka,PR-10903,4,3,64,8,72
kafka,PR-10936,3,3,76,22,98
kafka,PR-10945,1,1,2,22,24
kafka,PR-10936,4,4,83,24,107
kafka,PR-10946,1,13,138,46,184
kafka,PR-10947,1,1,4,4,8
kafka,PR-10918,6,7,37,8,45
kafka,PR-10948,1,9,18,26,44
kafka,PR-10946,2,14,132,42,174
kafka,PR-10892,8,13,350,103,453
kafka,PR-10652,15,11,495,33,528
kafka,PR-10946,3,14,134,44,178
kafka,PR-10813,7,41,277,154,431
kafka,PR-10652,16,11,501,35,536
kafka,PR-9497,4,1,2,2,4
kafka,PR-10950,1,1,2,2,4
kafka,PR-10812,13,17,547,96,643
kafka,PR-10892,10,13,351,105,456
kafka,PR-10896,5,4,222,12,234
kafka,PR-10813,9,39,292,153,445
kafka,PR-10896,6,4,222,12,234
kafka,PR-10946,5,14,201,62,263
kafka,PR-10936,5,4,83,24,107
kafka,PR-10949,4,33,3064,28,3092
kafka,PR-10728,3,1,4,2,6
kafka,PR-10811,6,3,125,95,220
kafka,PR-10743,17,54,2873,1058,3931
kafka,PR-10903,5,3,64,8,72
kafka,PR-10932,5,2,27,0,27
kafka,PR-10937,4,2,28,15,43
kafka,PR-10917,8,5,94,32,126
kafka,PR-10940,2,6,12,11,23
kafka,PR-10931,14,42,1387,4173,5560
kafka,PR-10952,1,6,176,29,205
kafka,PR-10917,9,5,94,32,126
kafka,PR-10854,6,19,73,184,257
kafka,PR-10946,8,15,209,63,272
kafka,PR-10864,6,9,460,183,643
kafka,PR-10955,1,2,143,1,144
kafka,PR-10957,1,1,0,54,54
kafka,PR-9878,12,5,780,257,1037
kafka,PR-10959,1,2,25,27,52
kafka,PR-10960,1,2,25,27,52
kafka,PR-10958,4,3,28,21,49
kafka,PR-10811,8,3,130,85,215
kafka,PR-10960,2,2,30,27,57
kafka,PR-10805,8,2,7,4,11
kafka,PR-10277,4,2,5,2,7
kafka,PR-9878,13,5,786,257,1043
kafka,PR-10944,3,1,39,23,62
kafka,PR-10805,9,2,5,4,9
kafka,PR-10961,1,3,134,7,141
kafka,PR-10963,1,1,3,2,5
kafka,PR-10965,2,6,111,57,168
kafka,PR-10868,6,4,24,5,29
kafka,PR-10966,1,1,2,2,4
kafka,PR-10967,1,2,6,2,8
kafka,PR-10805,10,3,8,4,12
kafka,PR-10968,1,5,4,25,29
kafka,PR-10931,17,45,1445,4200,5645
kafka,PR-10969,1,9,75,54,129
kafka,PR-10971,1,1,8,11,19
kafka,PR-10968,2,6,5,26,31
kafka,PR-10963,2,2,22,2,24
kafka,PR-10968,3,6,6,26,32
kafka,PR-10965,3,6,116,58,174
kafka,PR-10968,4,6,6,26,32
kafka,PR-10921,5,3,66,1,67
kafka,PR-9878,14,5,804,261,1065
kafka,PR-10973,4,13,160,78,238
kafka,PR-10960,3,2,25,28,53
kafka,PR-10974,2,3,984,14,998
kafka,PR-10965,4,7,150,107,257
kafka,PR-9878,15,5,808,265,1073
kafka,PR-10960,4,2,22,24,46
kafka,PR-9878,16,5,766,265,1031
kafka,PR-10579,28,24,2637,431,3068
kafka,PR-10960,5,2,20,22,42
kafka,PR-10975,1,1,6,1,7
kafka,PR-10974,3,3,1004,14,1018
kafka,PR-10960,6,2,20,22,42
kafka,PR-10976,1,1,226,333,559
kafka,PR-10921,6,3,66,1,67
kafka,PR-10977,1,2,3,3,6
kafka,PR-10579,30,24,2667,431,3098
kafka,PR-8571,4,22,110,78,188
kafka,PR-10960,7,2,22,24,46
kafka,PR-10975,2,1,6,1,7
kafka,PR-10978,1,6,84,5,89
kafka,PR-10976,2,1,226,334,560
kafka,PR-10979,1,1,1,0,1
kafka,PR-10951,6,3,70,4,74
kafka,PR-10955,3,3,159,3,162
kafka,PR-10981,1,8,14,10,24
kafka,PR-10864,8,9,466,185,651
kafka,PR-10982,1,1,1,1,2
kafka,PR-10955,4,3,159,3,162
kafka,PR-8571,5,22,110,78,188
kafka,PR-10983,1,1,5,0,5
kafka,PR-10980,2,3,51,6,57
kafka,PR-10931,18,46,1454,4200,5654
kafka,PR-9944,39,59,3213,882,4095
kafka,PR-10915,5,5,85,12,97
kafka,PR-10931,19,46,1454,4202,5656
kafka,PR-10903,6,4,79,17,96
kafka,PR-10984,1,1,1,1,2
kafka,PR-10985,1,6,303,55,358
kafka,PR-10977,2,2,4,4,8
kafka,PR-10985,2,6,304,56,360
kafka,PR-10955,5,3,159,3,162
kafka,PR-10962,9,15,1701,260,1961
kafka,PR-10962,10,15,1701,260,1961
kafka,PR-10987,2,2,19,2,21
kafka,PR-8571,6,22,110,78,188
kafka,PR-10525,3,2,45,4,49
kafka,PR-8571,7,22,110,78,188
kafka,PR-9944,40,59,3214,882,4096
kafka,PR-10989,1,2,5,3,8
kafka,PR-10988,3,3,17,8,25
kafka,PR-10579,32,24,2546,431,2977
kafka,PR-10991,1,2,49,14,63
kafka,PR-10992,1,4,12,12,24
kafka,PR-8259,6,4,487,8,495
kafka,PR-10993,1,1,1,1,2
kafka,PR-10992,2,7,28,27,55
kafka,PR-10952,2,6,224,34,258
kafka,PR-10994,1,4,141,118,259
kafka,PR-10990,3,9,502,39,541
kafka,PR-10985,4,6,326,59,385
kafka,PR-10560,3,3,111,18,129
kafka,PR-10996,1,4,16,4,20
kafka,PR-10973,6,15,208,126,334
kafka,PR-10985,5,6,330,68,398
kafka,PR-10802,8,11,134,35,169
kafka,PR-10851,4,17,1048,76,1124
kafka,PR-10987,4,2,19,2,21
kafka,PR-10602,4,14,1280,7,1287
kafka,PR-10794,13,7,187,11,198
kafka,PR-10649,9,7,57,13,70
kafka,PR-10988,5,3,34,25,59
kafka,PR-10995,2,1,1,1,2
kafka,PR-10998,1,1,2,2,4
kafka,PR-10499,4,1,2,2,4
kafka,PR-10999,1,6,224,34,258
kafka,PR-10952,3,6,224,34,258
kafka,PR-10988,6,3,34,25,59
kafka,PR-11001,1,1,1,1,2
kafka,PR-10998,2,1,2,2,4
kafka,PR-11003,1,3,72,6,78
kafka,PR-11004,1,7,135,75,210
kafka,PR-11003,2,3,92,6,98
kafka,PR-10997,4,1,2,2,4
kafka,PR-11005,1,1,1,1,2
kafka,PR-11006,1,1,9,1,10
kafka,PR-10794,15,8,298,15,313
kafka,PR-10726,5,18,322,65,387
kafka,PR-11009,2,2,7,2,9
kafka,PR-10579,33,24,2733,431,3164
kafka,PR-10990,4,10,498,38,536
kafka,PR-10969,2,11,87,54,141
kafka,PR-11011,1,2,7,1,8
kafka,PR-11012,1,8,8,8,16
kafka,PR-10991,2,2,51,14,65
kafka,PR-11011,2,2,10,1,11
kafka,PR-11000,3,2,84,121,205
kafka,PR-11013,1,3,28,19,47
kafka,PR-9541,11,2,31,13,44
kafka,PR-11003,3,3,92,6,98
kafka,PR-11012,2,11,11,20,31
kafka,PR-11002,3,2,116,2,118
kafka,PR-11014,1,1,2,2,4
kafka,PR-11011,3,2,13,1,14
kafka,PR-10935,4,4,124,5,129
kafka,PR-11013,2,3,94,48,142
kafka,PR-11012,3,11,11,20,31
kafka,PR-10794,18,10,337,54,391
kafka,PR-10811,9,3,149,90,239
kafka,PR-11015,1,4,54,0,54
kafka,PR-10811,10,3,149,90,239
kafka,PR-10868,7,5,21,1,22
kafka,PR-10868,8,5,20,0,20
kafka,PR-10794,19,10,338,54,392
kafka,PR-11017,1,4,239,255,494
kafka,PR-10811,11,3,214,98,312
kafka,PR-11017,2,4,239,255,494
kafka,PR-11016,2,5,245,111,356
kafka,PR-11017,3,4,231,247,478
kafka,PR-10973,7,15,300,147,447
kafka,PR-11018,1,1,13,28,41
kafka,PR-10280,50,20,2202,1308,3510
kafka,PR-10280,51,20,2202,1308,3510
kafka,PR-11006,2,1,9,1,10
kafka,PR-10753,5,20,1755,319,2074
kafka,PR-11020,1,1,17,1,18
kafka,PR-11021,1,3,71,31,102
kafka,PR-11019,2,3,248,55,303
kafka,PR-10943,4,2,4,3,7
kafka,PR-11022,1,3,66,32,98
kafka,PR-10280,52,20,2202,1308,3510
kafka,PR-11023,1,1,2,1,3
kafka,PR-10943,5,2,4,3,7
kafka,PR-11025,1,4,125,16,141
kafka,PR-11026,1,3,185,23,208
kafka,PR-11028,1,1,1,1,2
kafka,PR-11017,4,4,231,247,478
kafka,PR-11017,5,4,231,247,478
kafka,PR-10935,5,4,124,5,129
kafka,PR-11030,1,1,7,7,14
kafka,PR-11031,1,3,45,4,49
kafka,PR-11011,8,11,37,19,56
kafka,PR-10952,4,6,232,35,267
kafka,PR-10914,3,17,496,159,655
kafka,PR-11009,3,2,7,2,9
kafka,PR-10500,9,4,77,9,86
kafka,PR-10753,6,20,1752,318,2070
kafka,PR-10986,2,2,18,1,19
kafka,PR-10985,6,6,348,86,434
kafka,PR-11032,2,8,74,54,128
kafka,PR-11034,1,2,83,112,195
kafka,PR-11006,3,1,14,2,16
kafka,PR-11035,1,3,214,42,256
kafka,PR-11009,4,2,7,2,9
kafka,PR-11007,6,1,14,5,19
kafka,PR-11019,3,3,246,53,299
kafka,PR-11025,2,4,125,16,141
kafka,PR-10994,2,4,141,118,259
kafka,PR-11006,4,1,5,3,8
kafka,PR-11037,1,1,1,1,2
kafka,PR-11008,9,2,113,13,126
kafka,PR-11038,1,3,48,1,49
kafka,PR-11025,3,5,126,17,143
kafka,PR-11039,1,1,343,240,583
kafka,PR-11040,1,3,31,13,44
kafka,PR-11031,2,3,47,4,51
kafka,PR-10952,5,6,233,35,268
kafka,PR-11034,2,2,83,112,195
kafka,PR-11002,4,3,89,3,92
kafka,PR-11041,1,2,60,1,61
kafka,PR-10985,7,6,341,80,421
kafka,PR-10991,3,2,116,20,136
kafka,PR-11042,1,16,566,123,689
kafka,PR-10683,38,59,1509,438,1947
kafka,PR-8259,7,4,497,8,505
kafka,PR-11020,2,1,17,1,18
kafka,PR-10683,39,59,1518,438,1956
kafka,PR-11043,1,1,2,2,4
kafka,PR-11044,1,1,2,2,4
kafka,PR-11045,1,1,6,9,15
kafka,PR-11019,5,3,171,70,241
kafka,PR-10683,40,59,1518,438,1956
kafka,PR-8259,8,4,500,11,511
kafka,PR-11047,1,2,0,12,12
kafka,PR-11019,6,3,173,72,245
kafka,PR-11021,3,3,49,33,82
kafka,PR-11022,3,3,48,35,83
kafka,PR-11035,3,3,191,47,238
kafka,PR-11026,2,3,199,25,224
kafka,PR-11021,4,3,49,33,82
kafka,PR-11019,7,3,143,55,198
kafka,PR-11049,1,3,3,3,6
kafka,PR-11022,4,3,47,35,82
kafka,PR-11035,4,3,191,47,238
kafka,PR-11026,3,3,199,25,224
kafka,PR-11021,5,3,49,33,82
kafka,PR-10877,6,16,1256,1,1257
kafka,PR-10991,4,2,116,20,136
kafka,PR-11050,1,3,42,42,84
kafka,PR-11051,1,1,3,8,11
kafka,PR-11027,2,2,4,17,21
kafka,PR-11024,3,2,18,13,31
kafka,PR-10904,6,2,18,25,43
kafka,PR-11019,8,3,143,55,198
kafka,PR-8259,9,4,500,11,511
kafka,PR-10952,6,6,233,35,268
kafka,PR-10851,7,16,998,75,1073
kafka,PR-11042,2,18,684,214,898
kafka,PR-11050,2,3,42,42,84
kafka,PR-10753,7,21,1722,252,1974
kafka,PR-11054,1,8,88,55,143
kafka,PR-11055,1,4,7,2,9
kafka,PR-11056,1,5,347,31,378
kafka,PR-11026,4,3,199,25,224
kafka,PR-11019,9,3,143,55,198
kafka,PR-10953,2,6,30,7,37
kafka,PR-10941,2,7,67,208,275
kafka,PR-11022,6,3,38,32,70
kafka,PR-11035,6,3,106,46,152
kafka,PR-11057,1,4,83,11,94
kafka,PR-10753,8,21,1722,252,1974
kafka,PR-11035,7,3,106,46,152
kafka,PR-11059,1,1,5,2,7
kafka,PR-11054,2,8,95,55,150
kafka,PR-10753,9,21,1722,252,1974
kafka,PR-10952,7,6,234,39,273
kafka,PR-11029,2,2,46,2,48
kafka,PR-11056,2,5,347,31,378
kafka,PR-10683,41,59,1518,438,1956
kafka,PR-10952,8,6,236,41,277
kafka,PR-11064,1,1,10,6,16
kafka,PR-11065,1,5,347,31,378
kafka,PR-11042,3,21,1194,288,1482
kafka,PR-11066,1,2,68,0,68
kafka,PR-11067,1,1,3,0,3
kafka,PR-10921,7,3,66,1,67
kafka,PR-11026,6,3,91,30,121
kafka,PR-11068,1,6,276,23,299
kafka,PR-10987,5,2,19,2,21
kafka,PR-11023,2,1,2,1,3
kafka,PR-10868,9,5,20,0,20
kafka,PR-10868,10,5,18,3,21
kafka,PR-10953,4,6,38,7,45
kafka,PR-11070,1,2,10,2,12
kafka,PR-11071,1,1,10,12,22
kafka,PR-10563,6,13,907,163,1070
kafka,PR-11069,2,1,8,2,10
kafka,PR-11067,2,1,3,0,3
kafka,PR-11066,2,2,74,2,76
kafka,PR-10579,34,24,2718,431,3149
kafka,PR-10868,11,5,18,3,21
kafka,PR-11036,6,54,804,460,1264
kafka,PR-11072,2,230,17089,336,17425
kafka,PR-11072,3,231,17175,347,17522
kafka,PR-10773,53,231,17175,347,17522
kafka,PR-11072,4,231,17176,347,17523
kafka,PR-11073,1,6,367,24,391
kafka,PR-10773,54,231,17176,347,17523
kafka,PR-11075,1,1,3,3,6
kafka,PR-10987,6,2,20,2,22
kafka,PR-11072,8,231,17151,345,17496
kafka,PR-10773,58,231,17151,345,17496
kafka,PR-10773,59,231,17151,345,17496
kafka,PR-11072,9,231,17151,345,17496
kafka,PR-11077,1,1,117,73,190
kafka,PR-10811,12,3,225,98,323
kafka,PR-11072,10,231,17151,345,17496
kafka,PR-10851,8,15,946,75,1021
kafka,PR-10773,60,231,17151,345,17496
kafka,PR-11075,2,1,1,1,2
kafka,PR-10851,9,15,938,71,1009
kafka,PR-10773,61,231,17151,345,17496
kafka,PR-10884,3,3,31,28,59
kafka,PR-11016,3,5,235,111,346
kafka,PR-11078,1,51,791,414,1205
kafka,PR-11066,4,2,58,2,60
kafka,PR-11079,1,4,32,38,70
kafka,PR-11075,4,1,1,1,2
kafka,PR-11080,1,2,13,1,14
kafka,PR-10978,2,6,87,5,92
kafka,PR-11002,5,3,90,3,93
kafka,PR-11081,1,1,1,1,2
kafka,PR-11082,1,2,2,1,3
kafka,PR-11042,4,21,1194,288,1482
kafka,PR-10811,14,3,227,99,326
kafka,PR-10788,19,71,2130,535,2665
kafka,PR-11070,2,3,24,2,26
kafka,PR-10964,11,20,680,120,800
kafka,PR-11084,1,5,66,36,102
kafka,PR-10683,42,59,1519,438,1957
kafka,PR-11084,2,12,103,76,179
kafka,PR-11085,1,3,15,13,28
kafka,PR-11020,3,1,17,1,18
kafka,PR-11086,1,13,166,36,202
kafka,PR-10683,43,59,1520,439,1959
kafka,PR-11085,2,3,14,14,28
kafka,PR-11087,1,1,2,1,3
kafka,PR-11039,2,1,376,258,634
kafka,PR-11089,1,1,1,2,3
kafka,PR-10921,10,4,108,12,120
kafka,PR-11086,3,6,13,24,37
kafka,PR-11092,1,1,1,7,8
kafka,PR-11091,2,1,10,7,17
kafka,PR-11094,1,2,7,6,13
kafka,PR-11090,2,2,3,1,4
kafka,PR-8844,7,10,507,114,621
kafka,PR-11089,2,1,1,2,3
kafka,PR-11063,4,1,326,0,326
kafka,PR-11093,2,1,3,0,3
kafka,PR-11094,2,2,7,6,13
kafka,PR-11083,5,1,8,4,12
kafka,PR-11070,3,8,31,2,33
kafka,PR-11095,1,1,13,0,13
kafka,PR-11093,3,1,4,1,5
kafka,PR-11094,3,2,7,6,13
kafka,PR-11085,3,3,15,15,30
kafka,PR-11097,1,1,0,4,4
kafka,PR-11098,1,5,278,85,363
kafka,PR-10788,21,74,2147,524,2671
kafka,PR-11099,1,8,98,90,188
kafka,PR-11070,4,8,31,2,33
kafka,PR-10788,22,74,2160,526,2686
kafka,PR-11063,5,1,326,0,326
kafka,PR-11093,4,1,4,1,5
kafka,PR-11061,6,4,378,1,379
kafka,PR-10921,11,5,111,15,126
kafka,PR-11100,2,4,38,39,77
kafka,PR-11061,7,4,378,1,379
kafka,PR-11093,5,1,4,1,5
kafka,PR-11089,3,1,1,2,3
kafka,PR-11098,2,5,279,85,364
kafka,PR-11101,1,1,3,6,9
kafka,PR-11099,2,8,133,89,222
kafka,PR-11085,4,3,15,15,30
kafka,PR-11093,6,1,4,1,5
kafka,PR-11099,3,9,134,90,224
kafka,PR-11097,2,2,47,7,54
kafka,PR-11101,2,1,3,6,9
kafka,PR-11102,1,4,7,7,14
kafka,PR-11053,9,4,274,1,275
kafka,PR-11103,1,1,2,0,2
kafka,PR-11104,1,2,40,7,47
kafka,PR-11103,2,1,2,0,2
kafka,PR-11085,5,3,21,15,36
kafka,PR-11106,1,7,333,272,605
kafka,PR-11105,2,10,311,406,717
kafka,PR-11107,3,8,337,281,618
kafka,PR-11098,3,5,275,85,360
kafka,PR-11099,4,9,130,89,219
kafka,PR-11109,1,16,274,134,408
kafka,PR-11062,3,2,15,2,17
kafka,PR-11099,5,8,129,88,217
kafka,PR-11057,2,5,134,12,146
kafka,PR-11098,4,5,274,85,359
kafka,PR-11097,3,2,49,7,56
kafka,PR-10196,4,1,56,29,85
kafka,PR-11002,6,3,90,3,93
kafka,PR-11109,2,16,288,136,424
kafka,PR-11111,1,1,6,2,8
kafka,PR-11098,5,6,285,88,373
kafka,PR-11111,2,7,14,11,25
kafka,PR-11101,4,2,146,10,156
kafka,PR-11057,3,5,148,15,163
kafka,PR-11112,1,2,8,2,10
kafka,PR-11113,1,1,7,11,18
kafka,PR-11062,4,3,16,3,19
kafka,PR-11114,1,8,106,82,188
kafka,PR-11111,4,7,14,11,25
kafka,PR-11115,1,4,8,9,17
kafka,PR-11114,2,9,124,95,219
kafka,PR-10881,3,5,277,433,710
kafka,PR-11108,5,5,28,12,40
kafka,PR-11117,1,1,2,1,3
kafka,PR-11075,5,1,1,1,2
kafka,PR-11107,4,8,337,281,618
kafka,PR-11106,2,7,333,272,605
kafka,PR-11053,10,4,267,1,268
kafka,PR-11118,1,8,146,28,174
kafka,PR-11119,1,1,1,1,2
kafka,PR-11114,3,9,126,95,221
kafka,PR-11118,2,8,148,30,178
kafka,PR-11109,3,7,168,55,223
kafka,PR-11121,1,1,1,1,2
kafka,PR-11057,5,5,162,16,178
kafka,PR-11109,4,7,188,53,241
kafka,PR-11105,4,10,291,409,700
kafka,PR-11122,1,1,0,2,2
kafka,PR-11123,1,1,40,21,61
kafka,PR-11124,1,2,10,6,16
kafka,PR-11125,1,1,1,1,2
kafka,PR-10881,5,5,277,433,710
kafka,PR-10873,4,1,8,5,13
kafka,PR-11116,3,1,37,6,43
kafka,PR-11074,2,2,35,69,104
kafka,PR-11126,1,5,97,24,121
kafka,PR-10969,3,10,78,45,123
kafka,PR-10969,4,10,77,44,121
kafka,PR-11127,1,1,8,7,15
kafka,PR-11126,2,5,138,24,162
kafka,PR-11128,1,2,3,5,8
kafka,PR-11130,1,1,2,2,4
kafka,PR-11131,1,2,102,15,117
kafka,PR-11123,2,1,39,20,59
kafka,PR-11132,1,1,1,1,2
kafka,PR-11132,2,2,9,4,13
kafka,PR-11126,3,4,132,22,154
kafka,PR-11131,2,2,100,15,115
kafka,PR-10683,44,59,1520,439,1959
kafka,PR-10788,28,74,2232,529,2761
kafka,PR-11098,6,6,381,99,480
kafka,PR-11131,3,2,100,15,115
kafka,PR-11099,6,8,128,88,216
kafka,PR-11099,7,9,158,88,246
kafka,PR-11131,4,2,91,15,106
kafka,PR-10784,4,25,309,215,524
kafka,PR-11133,1,2,49,1,50
kafka,PR-10980,3,3,51,6,57
kafka,PR-11134,1,2,54,12,66
kafka,PR-11116,4,1,29,8,37
kafka,PR-11131,5,2,91,15,106
kafka,PR-11098,7,7,417,99,516
kafka,PR-11098,8,7,418,99,517
kafka,PR-11134,2,2,54,12,66
kafka,PR-11124,2,2,10,6,16
kafka,PR-10788,29,74,2234,529,2763
kafka,PR-11135,2,2,1,39,40
kafka,PR-11136,1,2,29,1,30
kafka,PR-11137,1,1,165,192,357
kafka,PR-11138,1,13,442,300,742
kafka,PR-11135,3,2,1,39,40
kafka,PR-11126,4,4,142,27,169
kafka,PR-11131,6,6,134,17,151
kafka,PR-11140,1,1,1,0,1
kafka,PR-11141,1,3,287,151,438
kafka,PR-11142,1,1,15,1,16
kafka,PR-11126,6,4,138,27,165
kafka,PR-11141,2,4,306,157,463
kafka,PR-11140,2,1,2,1,3
kafka,PR-11135,4,2,1,39,40
kafka,PR-11131,7,6,139,18,157
kafka,PR-11080,2,2,13,1,14
kafka,PR-11124,3,3,86,46,132
kafka,PR-11143,1,2,14,12,26
kafka,PR-11144,1,1,3,2,5
kafka,PR-11129,3,1,11,6,17
kafka,PR-10881,6,5,285,440,725
kafka,PR-11131,8,6,139,18,157
kafka,PR-11141,3,4,307,157,464
kafka,PR-10914,4,17,495,160,655
kafka,PR-11126,7,4,141,27,168
kafka,PR-11141,4,4,292,157,449
kafka,PR-10277,6,2,30,2,32
kafka,PR-11116,5,5,261,26,287
kafka,PR-11120,17,16,856,93,949
kafka,PR-11145,1,1,5,0,5
kafka,PR-11120,18,16,856,93,949
kafka,PR-11141,5,4,291,157,448
kafka,PR-11145,2,1,5,0,5
kafka,PR-11146,2,7,255,135,390
kafka,PR-11147,1,1,56,0,56
kafka,PR-11148,1,4,94,66,160
kafka,PR-11124,5,5,92,67,159
kafka,PR-11150,1,1,3,3,6
kafka,PR-11145,3,1,5,0,5
kafka,PR-11150,2,1,2,2,4
kafka,PR-11140,3,1,3,2,5
kafka,PR-11145,4,1,5,0,5
kafka,PR-11140,4,1,3,2,5
kafka,PR-11151,1,1,28,1,29
kafka,PR-11151,2,1,32,1,33
kafka,PR-11116,7,7,286,43,329
kafka,PR-11141,6,4,292,157,449
kafka,PR-11116,8,7,286,43,329
kafka,PR-11155,1,2,51,53,104
kafka,PR-10969,5,10,77,44,121
kafka,PR-11141,7,4,280,165,445
kafka,PR-11156,2,2,65,4,69
kafka,PR-11158,1,3,30,15,45
kafka,PR-11157,3,3,58,105,163
kafka,PR-11138,2,13,445,301,746
kafka,PR-11160,1,1,7,2,9
kafka,PR-10909,15,13,260,90,350
kafka,PR-11161,1,2,8,0,8
kafka,PR-11141,8,4,280,165,445
kafka,PR-10807,3,4,66,23,89
kafka,PR-11162,1,2,12,15,27
kafka,PR-10909,16,13,251,90,341
kafka,PR-11163,1,1,3,2,5
kafka,PR-10909,17,13,252,90,342
kafka,PR-11144,3,1,3,2,5
kafka,PR-11164,1,1,12,12,24
kafka,PR-10788,33,33,795,215,1010
kafka,PR-10788,35,31,800,208,1008
kafka,PR-10788,36,31,800,208,1008
kafka,PR-11141,18,7,287,168,455
kafka,PR-10784,5,25,309,215,524
kafka,PR-11165,1,1,2,1,3
kafka,PR-11166,1,4,14,9,23
kafka,PR-11167,1,3,49,84,133
kafka,PR-11168,1,1,2,1,3
kafka,PR-11166,2,4,15,10,25
kafka,PR-11169,1,1,3,3,6
kafka,PR-11170,1,11,323,98,421
kafka,PR-11141,19,7,291,168,459
kafka,PR-11110,4,4,46,37,83
kafka,PR-11171,1,2,33,9,42
kafka,PR-11172,1,1,68,7,75
kafka,PR-11141,20,7,291,168,459
kafka,PR-11168,2,1,10,2,12
kafka,PR-10914,7,18,556,169,725
kafka,PR-10788,37,31,800,208,1008
kafka,PR-11141,21,7,298,169,467
kafka,PR-11168,3,1,10,2,12
kafka,PR-10788,38,25,672,185,857
kafka,PR-10602,5,15,1281,9,1290
kafka,PR-11141,22,7,298,169,467
kafka,PR-11168,4,1,10,2,12
kafka,PR-11141,23,7,298,169,467
kafka,PR-11174,1,3,10,9,19
kafka,PR-11166,3,4,13,9,22
kafka,PR-11174,2,3,10,9,19
kafka,PR-10602,6,16,1299,11,1310
kafka,PR-11110,5,4,46,37,83
kafka,PR-11172,2,1,68,7,75
kafka,PR-11175,1,4,14,6,20
kafka,PR-11171,2,3,45,11,56
kafka,PR-11110,7,4,46,37,83
kafka,PR-10788,41,29,714,188,902
kafka,PR-11163,2,1,3,2,5
kafka,PR-11177,1,2,36,19,55
kafka,PR-11153,3,1,26,9,35
kafka,PR-11159,6,1,1,2,3
kafka,PR-11176,2,1,2,2,4
kafka,PR-10906,3,5,125,11,136
kafka,PR-11151,3,2,49,4,53
kafka,PR-11168,5,1,6,2,8
kafka,PR-11171,3,3,48,11,59
kafka,PR-11178,1,1,8,1,9
kafka,PR-10788,42,29,678,188,866
kafka,PR-11179,1,1,11,5,16
kafka,PR-10788,43,29,706,188,894
kafka,PR-10788,44,29,717,189,906
kafka,PR-11180,1,1,1,1,2
kafka,PR-11178,2,3,72,2,74
kafka,PR-11179,2,3,71,7,78
kafka,PR-11110,8,4,46,37,83
kafka,PR-10807,4,4,68,23,91
kafka,PR-11182,2,5,195,7,202
kafka,PR-11179,3,3,85,7,92
kafka,PR-11153,4,1,28,11,39
kafka,PR-11171,4,3,52,17,69
kafka,PR-11183,1,1,1,1,2
kafka,PR-11179,4,3,85,7,92
kafka,PR-11184,1,1,9,0,9
kafka,PR-11179,6,13,145,16,161
kafka,PR-10788,45,28,790,217,1007
kafka,PR-11138,3,13,445,301,746
kafka,PR-11181,3,2,25,13,38
kafka,PR-10788,46,28,794,219,1013
kafka,PR-11179,7,13,141,19,160
kafka,PR-11179,8,13,141,19,160
kafka,PR-11185,1,1,3,1,4
kafka,PR-10807,5,4,68,23,91
kafka,PR-11179,9,13,141,19,160
kafka,PR-11137,2,1,152,192,344
kafka,PR-11187,2,13,129,29,158
kafka,PR-11179,10,13,141,19,160
kafka,PR-11179,11,13,149,19,168
kafka,PR-11188,2,6,60,14,74
kafka,PR-11124,7,7,279,52,331
kafka,PR-10851,10,15,937,70,1007
kafka,PR-10802,9,11,133,34,167
kafka,PR-11190,1,1,4,4,8
kafka,PR-11179,12,12,141,21,162
kafka,PR-11189,2,3,194,39,233
kafka,PR-11192,2,24,55,56,111
kafka,PR-11154,7,56,486,477,963
kafka,PR-11193,1,1,11,5,16
kafka,PR-11194,1,5,28,28,56
kafka,PR-11189,3,3,233,39,272
kafka,PR-10914,8,18,556,169,725
kafka,PR-11189,5,4,312,46,358
kafka,PR-11195,1,5,41,29,70
kafka,PR-11196,1,1,2,0,2
kafka,PR-11198,1,1,9,9,18
kafka,PR-11189,6,4,568,236,804
kafka,PR-11191,8,8,250,30,280
kafka,PR-11191,9,8,258,30,288
kafka,PR-11138,4,13,438,302,740
kafka,PR-11199,1,2,26,3,29
kafka,PR-11200,1,2,26,0,26
kafka,PR-11201,1,2,31,10,41
kafka,PR-11200,2,2,22,0,22
kafka,PR-11191,10,8,245,30,275
kafka,PR-11202,1,3,42,3,45
kafka,PR-11191,11,8,227,30,257
kafka,PR-11203,1,1,1,1,2
kafka,PR-11204,2,12,595,95,690
kafka,PR-11204,3,12,595,95,690
kafka,PR-11205,1,4,92,0,92
kafka,PR-11206,1,2,15,11,26
kafka,PR-11197,5,205,17165,326,17491
kafka,PR-11207,1,5,104,2,106
kafka,PR-11200,3,2,22,0,22
kafka,PR-11199,2,2,31,6,37
kafka,PR-11208,2,3,14,17,31
kafka,PR-11209,1,4,199,18,217
kafka,PR-11212,1,3,6,3,9
kafka,PR-11208,3,3,14,17,31
kafka,PR-11199,3,6,47,6,53
kafka,PR-11208,4,3,14,17,31
kafka,PR-11215,2,1,23,47,70
kafka,PR-11133,2,2,49,1,50
kafka,PR-10969,6,10,75,43,118
kafka,PR-11216,1,6,483,226,709
kafka,PR-11197,7,205,17165,326,17491
kafka,PR-11216,2,7,517,234,751
kafka,PR-11212,2,6,9,6,15
kafka,PR-11217,2,3,65,0,65
kafka,PR-11219,1,2,7,1,8
kafka,PR-11216,3,7,597,234,831
kafka,PR-10897,2,12,17,7,24
kafka,PR-11221,1,2,52,2,54
kafka,PR-11216,4,8,639,234,873
kafka,PR-11222,1,1,22,1,23
kafka,PR-11221,2,2,49,2,51
kafka,PR-11216,5,8,654,234,888
kafka,PR-11218,3,7,149,46,195
kafka,PR-11223,1,1,1,1,2
kafka,PR-11221,3,2,67,16,83
kafka,PR-11221,4,2,67,16,83
kafka,PR-11216,6,8,701,234,935
kafka,PR-11224,1,1,1,1,2
kafka,PR-11216,7,10,705,238,943
kafka,PR-11184,2,1,19,14,33
kafka,PR-10914,9,18,557,170,727
kafka,PR-11225,1,1,14,14,28
kafka,PR-11226,1,1,3,1,4
kafka,PR-11228,2,2,81,2,83
kafka,PR-11229,1,2,82,63,145
kafka,PR-11230,1,4,73,4,77
kafka,PR-11231,1,2,14,7,21
kafka,PR-10914,10,18,557,170,727
kafka,PR-11231,2,3,148,7,155
kafka,PR-11232,1,2,78,43,121
kafka,PR-11233,1,11,214,354,568
kafka,PR-11227,2,14,531,64,595
kafka,PR-11214,2,2,98,121,219
kafka,PR-11235,1,10,345,28,373
kafka,PR-11230,2,4,76,20,96
kafka,PR-11234,2,12,423,173,596
kafka,PR-11230,3,4,76,20,96
kafka,PR-11236,1,1,42,35,77
kafka,PR-11237,1,2,7,4,11
kafka,PR-11236,2,1,42,38,80
kafka,PR-11238,1,1,16,1,17
kafka,PR-11215,3,1,23,47,70
kafka,PR-11239,1,3,9,2,11
kafka,PR-11233,2,11,214,354,568
kafka,PR-11239,2,4,13,4,17
kafka,PR-11236,3,2,42,40,82
kafka,PR-11240,1,1,1,0,1
kafka,PR-11241,1,4,22,0,22
kafka,PR-11228,3,2,81,2,83
kafka,PR-11215,4,1,25,36,61
kafka,PR-11243,1,1,1,1,2
kafka,PR-11242,2,14,361,15,376
kafka,PR-11234,3,12,423,173,596
kafka,PR-11227,3,14,531,64,595
kafka,PR-11239,3,4,12,4,16
kafka,PR-10851,11,15,937,70,1007
kafka,PR-11243,2,1,1,1,2
kafka,PR-11244,1,1,0,1,1
kafka,PR-10802,10,11,133,34,167
kafka,PR-10851,12,17,915,158,1073
kafka,PR-11245,1,3,282,195,477
kafka,PR-11246,1,1,15,7,22
kafka,PR-11239,5,7,35,34,69
kafka,PR-11247,3,2,11,78,89
kafka,PR-11242,3,14,361,15,376
kafka,PR-11239,6,7,35,34,69
kafka,PR-11239,7,7,35,34,69
kafka,PR-11214,3,2,106,97,203
kafka,PR-11210,4,1,3,8,11
kafka,PR-11248,2,2,125,1,126
kafka,PR-11249,1,1,2,2,4
kafka,PR-11225,2,2,57,53,110
kafka,PR-11248,4,2,136,1,137
kafka,PR-11222,2,1,20,0,20
kafka,PR-11239,8,7,35,34,69
kafka,PR-11246,2,1,16,8,24
kafka,PR-11250,1,2,17,16,33
kafka,PR-11248,5,2,136,1,137
kafka,PR-11252,1,13,277,340,617
kafka,PR-11231,3,3,148,7,155
kafka,PR-11253,1,1,4,4,8
kafka,PR-11086,4,5,13,17,30
kafka,PR-11225,3,3,116,61,177
kafka,PR-11255,1,2,30,1,31
kafka,PR-11241,2,4,26,0,26
kafka,PR-11231,4,3,149,7,156
kafka,PR-11238,2,1,17,1,18
kafka,PR-11253,2,1,4,4,8
kafka,PR-11241,3,4,26,0,26
kafka,PR-11255,2,2,30,1,31
kafka,PR-11250,2,2,49,13,62
kafka,PR-11256,1,2,135,4,139
kafka,PR-11255,3,2,30,1,31
kafka,PR-11250,3,2,49,13,62
kafka,PR-11252,2,13,277,340,617
kafka,PR-11256,2,2,135,4,139
kafka,PR-11257,1,1,1,1,2
kafka,PR-11086,5,5,13,16,29
kafka,PR-11104,3,2,42,7,49
kafka,PR-11214,4,2,106,97,203
kafka,PR-10851,13,17,919,158,1077
kafka,PR-10851,14,19,1001,158,1159
kafka,PR-11227,5,14,530,82,612
kafka,PR-11104,4,2,42,7,49
kafka,PR-11258,2,1,28,0,28
kafka,PR-11259,1,1,1,0,1
kafka,PR-11260,1,2,36,0,36
kafka,PR-11262,1,2,4,2,6
kafka,PR-11263,1,18,19,45,64
kafka,PR-11227,6,16,687,112,799
kafka,PR-11104,5,2,42,7,49
kafka,PR-11225,4,3,115,61,176
kafka,PR-11264,1,1,5,1,6
kafka,PR-11265,1,1,2,2,4
kafka,PR-11104,6,2,42,7,49
kafka,PR-11104,7,2,42,7,49
kafka,PR-11242,4,17,409,17,426
kafka,PR-11228,4,3,49,4,53
kafka,PR-11250,4,2,49,13,62
kafka,PR-11110,9,4,50,37,87
kafka,PR-11241,4,4,30,0,30
kafka,PR-11228,5,4,50,5,55
kafka,PR-11266,1,1,4,3,7
kafka,PR-11225,5,3,115,61,176
kafka,PR-11073,5,4,360,30,390
kafka,PR-11262,2,2,4,2,6
kafka,PR-11267,1,3,31,1,32
kafka,PR-11264,2,1,5,1,6
kafka,PR-11266,2,3,22,7,29
kafka,PR-11265,3,1,1,2,3
kafka,PR-11267,2,4,35,1,36
kafka,PR-11269,1,1,2,2,4
kafka,PR-11270,2,1,6,1,7
kafka,PR-11263,3,18,19,45,64
kafka,PR-11271,1,1,1,1,2
kafka,PR-11272,1,16,287,85,372
kafka,PR-11265,4,1,1,2,3
kafka,PR-11104,8,2,42,7,49
kafka,PR-11273,1,2,8,0,8
kafka,PR-11104,9,2,42,7,49
kafka,PR-11272,2,16,315,85,400
kafka,PR-11275,1,1,18,40,58
kafka,PR-9769,55,49,846,172,1018
kafka,PR-11268,2,1,27,7,34
kafka,PR-11267,3,6,41,7,48
kafka,PR-9769,56,49,846,172,1018
kafka,PR-11278,1,12,131,16,147
kafka,PR-11267,4,6,48,15,63
kafka,PR-11279,1,1,1,1,2
kafka,PR-11267,5,6,48,15,63
kafka,PR-11149,10,28,1250,45,1295
kafka,PR-11255,4,2,31,2,33
kafka,PR-11267,6,6,52,15,67
kafka,PR-11149,11,29,1300,45,1345
kafka,PR-11060,7,7,277,163,440
kafka,PR-11060,9,7,274,163,437
kafka,PR-11280,1,1,4,2,6
kafka,PR-11141,39,6,271,123,394
kafka,PR-11281,1,8,280,141,421
kafka,PR-11042,5,21,1194,288,1482
kafka,PR-11281,6,10,317,186,503
kafka,PR-10467,14,11,628,482,1110
kafka,PR-11282,1,1,1,1,2
kafka,PR-11281,7,12,322,190,512
kafka,PR-11281,8,12,319,190,509
kafka,PR-11281,9,12,326,202,528
kafka,PR-11281,10,12,326,202,528
kafka,PR-11228,6,4,49,6,55
kafka,PR-11228,8,4,78,11,89
kafka,PR-11149,12,29,1302,44,1346
kafka,PR-11281,11,12,326,202,528
kafka,PR-11283,5,3,108,7,115
kafka,PR-11286,1,3,5,5,10
kafka,PR-11086,6,5,13,16,29
kafka,PR-11286,2,4,6,6,12
kafka,PR-11255,5,3,34,5,39
kafka,PR-11288,1,4,25,5,30
kafka,PR-11174,3,3,10,9,19
kafka,PR-10839,14,92,556,556,1112
kafka,PR-11290,1,1,4,4,8
kafka,PR-11284,2,39,3969,0,3969
kafka,PR-11281,12,12,326,202,528
kafka,PR-11255,6,3,34,5,39
kafka,PR-11281,13,12,325,202,527
kafka,PR-10914,11,19,587,192,779
kafka,PR-11255,7,3,36,5,41
kafka,PR-11227,7,18,1328,116,1444
kafka,PR-11292,1,2,236,3,239
kafka,PR-11292,2,3,451,288,739
kafka,PR-10851,15,19,1010,158,1168
kafka,PR-10851,16,19,1003,158,1161
kafka,PR-11255,8,3,36,6,42
kafka,PR-11293,1,1,3,3,6
kafka,PR-11252,3,23,582,978,1560
kafka,PR-11288,2,4,28,5,33
kafka,PR-11294,2,2,148,40,188
kafka,PR-11086,7,5,13,16,29
kafka,PR-11288,3,4,23,4,27
kafka,PR-11294,3,2,148,40,188
kafka,PR-11033,7,10,255,87,342
kafka,PR-11295,1,15,131,106,237
kafka,PR-11141,41,6,271,123,394
kafka,PR-11295,2,15,167,143,310
kafka,PR-11296,1,1,6,6,12
kafka,PR-11296,2,6,30,12,42
kafka,PR-11296,3,6,31,13,44
kafka,PR-11296,4,6,37,14,51
kafka,PR-11173,8,2,191,116,307
kafka,PR-11296,6,6,44,16,60
kafka,PR-11296,7,9,97,53,150
kafka,PR-11296,8,10,85,59,144
kafka,PR-11298,1,5,10,9,19
kafka,PR-11296,9,12,129,79,208
kafka,PR-11296,10,12,133,79,212
kafka,PR-11288,4,4,23,4,27
kafka,PR-11241,5,4,30,0,30
kafka,PR-11299,1,4,13,2,15
kafka,PR-11300,1,4,22,2,24
kafka,PR-11296,11,12,125,79,204
kafka,PR-11295,3,15,169,144,313
kafka,PR-11074,3,2,35,69,104
kafka,PR-11301,2,12,32,37,69
kafka,PR-11017,6,4,231,246,477
kafka,PR-11137,3,2,153,193,346
kafka,PR-11297,2,7,108,3,111
kafka,PR-11302,1,8,72,18,90
kafka,PR-11303,1,1,3,3,6
kafka,PR-11304,1,1,12,0,12
kafka,PR-11301,3,12,36,40,76
kafka,PR-11291,2,3,41,6,47
kafka,PR-11250,5,2,73,18,91
kafka,PR-11305,1,1,1,3,4
kafka,PR-11254,2,83,260,213,473
kafka,PR-11302,2,8,72,18,90
kafka,PR-11076,4,3,150,3,153
kafka,PR-11250,6,2,67,13,80
kafka,PR-11303,2,1,3,3,6
kafka,PR-11250,7,2,64,13,77
kafka,PR-11307,1,1,4,3,7
kafka,PR-11276,2,2,92,1,93
kafka,PR-11306,2,2,11,11,22
kafka,PR-11250,8,2,64,13,77
kafka,PR-11307,2,1,7,6,13
kafka,PR-11308,1,2,18,1,19
kafka,PR-11186,20,30,1201,531,1732
kafka,PR-11213,8,8,350,129,479
kafka,PR-11213,9,9,365,130,495
kafka,PR-11218,4,7,149,46,195
kafka,PR-11033,8,9,127,89,216
kafka,PR-11292,3,3,451,288,739
kafka,PR-11302,3,8,73,18,91
kafka,PR-11294,4,2,150,37,187
kafka,PR-11250,9,2,64,13,77
kafka,PR-10897,3,12,17,7,24
kafka,PR-11309,1,1,2,8,10
kafka,PR-10881,7,4,286,439,725
kafka,PR-11310,1,7,185,16,201
kafka,PR-11284,3,46,4974,0,4974
kafka,PR-11313,1,1,3,0,3
kafka,PR-11312,2,2,90,10,100
kafka,PR-11284,4,48,5152,0,5152
kafka,PR-11292,4,3,451,288,739
kafka,PR-11272,3,16,316,85,401
kafka,PR-11314,1,2,60,26,86
kafka,PR-11033,9,9,148,92,240
kafka,PR-11287,3,2,24,7,31
kafka,PR-11316,1,6,80,82,162
kafka,PR-11316,2,6,92,97,189
kafka,PR-11317,1,1,1,1,2
kafka,PR-11318,1,1,2,2,4
kafka,PR-11272,4,16,316,85,401
kafka,PR-10976,3,1,163,267,430
kafka,PR-10976,4,1,164,267,431
kafka,PR-11317,2,1,1,1,2
kafka,PR-11058,11,21,1113,89,1202
kafka,PR-11319,1,3,28,2,30
kafka,PR-11313,2,1,7,2,9
kafka,PR-10914,13,19,552,179,731
kafka,PR-11312,3,2,98,12,110
kafka,PR-10914,14,18,500,190,690
kafka,PR-10373,3,1,2,2,4
kafka,PR-10873,5,1,8,5,13
kafka,PR-11281,14,12,324,202,526
kafka,PR-11283,8,3,110,7,117
kafka,PR-11322,1,1,208,0,208
kafka,PR-11322,2,2,332,0,332
kafka,PR-11320,2,21,1018,289,1307
kafka,PR-11323,1,7,362,191,553
kafka,PR-11186,21,31,1210,531,1741
kafka,PR-11080,3,2,13,1,14
kafka,PR-11252,4,23,633,978,1611
kafka,PR-11324,1,1,1,1,2
kafka,PR-11322,3,2,332,0,332
kafka,PR-11325,1,1,1,1,2
kafka,PR-11227,9,18,1114,117,1231
kafka,PR-11080,4,2,13,1,14
kafka,PR-11186,22,31,1210,531,1741
kafka,PR-11293,2,2,4,4,8
kafka,PR-10914,15,18,499,191,690
kafka,PR-11252,5,23,681,978,1659
kafka,PR-10914,16,18,499,191,690
kafka,PR-11252,6,23,681,978,1659
kafka,PR-11323,2,7,362,191,553
kafka,PR-11328,2,3,5,6,11
kafka,PR-11289,5,8,730,189,919
kafka,PR-11252,7,23,681,978,1659
kafka,PR-11289,6,8,738,189,927
kafka,PR-11330,1,2,121,22,143
kafka,PR-10976,5,1,192,271,463
kafka,PR-11293,3,3,6,6,12
kafka,PR-11289,7,8,744,189,933
kafka,PR-11252,8,23,681,978,1659
kafka,PR-11289,8,8,744,189,933
kafka,PR-11252,9,26,699,1007,1706
kafka,PR-11320,3,21,1019,290,1309
kafka,PR-11252,10,27,708,1007,1715
kafka,PR-11329,2,1,3,3,6
kafka,PR-11332,1,1,7,3,10
kafka,PR-11333,1,3,32,1,33
kafka,PR-10649,10,7,57,13,70
kafka,PR-11334,1,1,4,2,6
kafka,PR-11289,9,8,807,233,1040
kafka,PR-11335,1,3,7,11,18
kafka,PR-11289,10,8,807,233,1040
kafka,PR-11336,1,14,517,32,549
kafka,PR-11293,4,2,4,4,8
kafka,PR-11338,1,2,17,0,17
kafka,PR-11337,2,4,320,65,385
kafka,PR-11321,3,3,82,63,145
kafka,PR-11170,4,12,394,100,494
kafka,PR-11170,5,12,396,100,496
kafka,PR-11341,1,4,7,6,13
kafka,PR-11342,1,4,10,8,18
kafka,PR-11343,1,1,42,0,42
kafka,PR-11333,2,3,50,1,51
kafka,PR-11058,13,25,1494,101,1595
kafka,PR-11344,1,1,7,0,7
kafka,PR-11333,4,3,50,1,51
kafka,PR-11170,6,12,396,100,496
kafka,PR-11346,1,1,9,13,22
kafka,PR-11311,2,3,205,17,222
kafka,PR-11331,2,33,1035,845,1880
kafka,PR-11347,1,1,11,0,11
kafka,PR-11310,3,10,339,32,371
kafka,PR-11348,1,1,1,1,2
kafka,PR-11348,2,1,1,1,2
kafka,PR-11349,1,1,6,2,8
kafka,PR-11348,3,2,5,5,10
kafka,PR-11350,1,61,1912,1475,3387
kafka,PR-11351,1,2,8,6,14
kafka,PR-11331,3,33,1028,846,1874
kafka,PR-11351,2,2,8,6,14
kafka,PR-11351,3,3,32,12,44
kafka,PR-11227,10,17,773,117,890
kafka,PR-11339,4,3,303,2,305
kafka,PR-11321,4,3,82,63,145
kafka,PR-11326,2,1,66,26,92
kafka,PR-11352,1,1,1,0,1
kafka,PR-11353,1,3,9,4,13
kafka,PR-11351,4,3,32,12,44
kafka,PR-11351,5,5,43,19,62
kafka,PR-11351,6,5,41,19,60
kafka,PR-11170,7,12,391,100,491
kafka,PR-11351,7,7,45,25,70
kafka,PR-11354,1,1,2,1,3
kafka,PR-11351,8,7,56,35,91
kafka,PR-11345,5,4,60,6,66
kafka,PR-11315,4,20,521,412,933
kafka,PR-11355,1,1,6,1,7
kafka,PR-11351,9,3,54,25,79
kafka,PR-11170,8,13,398,101,499
kafka,PR-11058,15,28,1540,131,1671
kafka,PR-11315,5,20,522,413,935
kafka,PR-11351,10,3,53,24,77
kafka,PR-11347,3,1,10,0,10
kafka,PR-11351,11,3,59,23,82
kafka,PR-11327,4,3,46,9,55
kafka,PR-11353,2,3,9,4,13
kafka,PR-11357,1,2,163,0,163
kafka,PR-11353,3,3,13,4,17
kafka,PR-11358,1,1,4,4,8
kafka,PR-11352,2,4,37,0,37
kafka,PR-11349,2,1,7,3,10
kafka,PR-11359,1,2,2,2,4
kafka,PR-11327,5,3,46,9,55
kafka,PR-11360,1,1,2,2,4
kafka,PR-10884,4,3,31,28,59
kafka,PR-11352,3,4,20,0,20
kafka,PR-11352,4,4,19,0,19
kafka,PR-11355,2,1,6,1,7
kafka,PR-11362,1,3,27,22,49
kafka,PR-11363,1,1,0,6,6
kafka,PR-11361,3,2,42,2,44
kafka,PR-11359,2,2,2,2,4
kafka,PR-11364,1,1,6,1,7
kafka,PR-11365,1,1,0,2,2
kafka,PR-11366,1,1,1,0,1
kafka,PR-11364,2,2,7,2,9
kafka,PR-11331,4,42,1636,1482,3118
kafka,PR-11368,1,7,633,19,652
kafka,PR-11333,5,5,96,4,100
kafka,PR-11362,2,4,36,24,60
kafka,PR-11368,2,8,680,20,700
kafka,PR-11370,1,1,12,11,23
kafka,PR-11234,5,11,528,176,704
kafka,PR-11058,17,28,1585,142,1727
kafka,PR-11326,3,2,98,37,135
kafka,PR-11368,3,8,675,20,695
kafka,PR-11372,1,1,1,1,2
kafka,PR-11369,2,13,827,101,928
kafka,PR-11272,7,24,601,373,974
kafka,PR-11345,6,1,1,1,2
kafka,PR-11373,1,1,2,0,2
kafka,PR-11326,4,2,98,37,135
kafka,PR-11272,8,25,645,392,1037
kafka,PR-10525,4,2,45,4,49
kafka,PR-11371,3,2,18,1,19
kafka,PR-11369,3,13,827,101,928
kafka,PR-11369,4,13,848,101,949
kafka,PR-11323,3,7,362,191,553
kafka,PR-11323,4,7,460,191,651
kafka,PR-11374,1,7,99,16,115
kafka,PR-11360,2,1,2,2,4
kafka,PR-11360,5,1,2,2,4
kafka,PR-11375,1,2,3,1,4
kafka,PR-11058,18,28,1610,142,1752
kafka,PR-11356,2,4,84,66,150
kafka,PR-11058,19,28,1610,142,1752
kafka,PR-11376,1,2,28,7,35
kafka,PR-11234,6,12,529,177,706
kafka,PR-11377,1,1,3,3,6
kafka,PR-11378,1,1,3,1,4
kafka,PR-11379,1,1,10,10,20
kafka,PR-11355,4,1,9,1,10
kafka,PR-11381,1,25,645,392,1037
kafka,PR-11381,2,5,97,25,122
kafka,PR-11285,9,15,249,79,328
kafka,PR-11381,3,5,119,26,145
kafka,PR-11382,1,3,55,1,56
kafka,PR-11220,5,7,70,25,95
kafka,PR-11332,5,1,42,3,45
kafka,PR-11370,2,1,14,14,28
kafka,PR-11058,20,28,1633,142,1775
kafka,PR-11382,2,3,58,1,59
kafka,PR-11384,1,1,8,2,10
kafka,PR-11331,5,42,1739,1541,3280
kafka,PR-11383,3,106,1093,607,1700
kafka,PR-11311,3,6,303,17,320
kafka,PR-11249,2,1,2,2,4
kafka,PR-11384,2,1,8,2,10
kafka,PR-11350,2,75,2043,1525,3568
kafka,PR-11362,3,4,39,24,63
kafka,PR-11386,1,17,235,150,385
kafka,PR-11272,10,26,682,402,1084
kafka,PR-11387,1,2,97,0,97
kafka,PR-11058,21,28,1626,142,1768
kafka,PR-11047,2,2,1,13,14
kafka,PR-11323,5,7,460,191,651
kafka,PR-11323,6,7,474,193,667
kafka,PR-10528,6,7,245,26,271
kafka,PR-11389,1,1,11,13,24
kafka,PR-11391,1,1,17,19,36
kafka,PR-10851,17,19,1003,158,1161
kafka,PR-11396,1,3,3,0,3
kafka,PR-11400,1,5,8,5,13
kafka,PR-11380,5,4,86,4,90
kafka,PR-11397,3,1,3,2,5
kafka,PR-11397,4,1,3,2,5
kafka,PR-11395,3,3,135,7,142
kafka,PR-11402,1,1,4,4,8
kafka,PR-11211,7,17,703,35,738
kafka,PR-11394,2,1,20,11,31
kafka,PR-11403,1,2,38,9,47
kafka,PR-11404,1,2,38,22,60
kafka,PR-11405,2,4,29,4,33
kafka,PR-11272,11,26,683,403,1086
kafka,PR-11407,1,1,1,1,2
kafka,PR-11405,3,5,63,36,99
kafka,PR-10726,7,19,325,66,391
kafka,PR-11376,2,2,28,7,35
kafka,PR-11408,1,1,1,1,2
kafka,PR-11409,1,1,12,12,24
kafka,PR-11356,3,4,84,66,150
kafka,PR-11356,4,4,84,66,150
kafka,PR-11410,1,4,317,119,436
kafka,PR-11411,1,1,4,2,6
kafka,PR-11405,4,10,117,67,184
kafka,PR-11405,5,9,97,43,140
kafka,PR-11405,6,10,129,53,182
kafka,PR-10772,4,8,151,24,175
kafka,PR-11405,8,5,63,36,99
kafka,PR-11414,1,5,2,1,3
kafka,PR-11412,3,46,553,441,994
kafka,PR-11416,1,6,109,42,151
kafka,PR-11385,3,1,8,2,10
kafka,PR-11410,2,4,317,119,436
kafka,PR-10772,5,8,137,10,147
kafka,PR-11411,2,1,4,2,6
kafka,PR-11046,3,4,317,218,535
kafka,PR-11405,9,10,133,54,187
kafka,PR-11405,10,10,138,54,192
kafka,PR-10772,6,8,155,10,165
kafka,PR-10772,7,8,155,10,165
kafka,PR-11405,11,10,138,54,192
kafka,PR-11418,1,1,7,2,9
kafka,PR-11419,1,1,15,8,23
kafka,PR-10907,14,119,10496,2020,12516
kafka,PR-10593,18,2,116,34,150
kafka,PR-10593,19,2,116,34,150
kafka,PR-11418,2,1,7,2,9
kafka,PR-11404,2,2,38,22,60
kafka,PR-11405,12,10,139,55,194
kafka,PR-10907,15,121,10544,2037,12581
kafka,PR-11420,1,5,111,5,116
kafka,PR-11422,1,3,14,4,18
kafka,PR-11423,1,1,1,1,2
kafka,PR-11424,1,65,739,215,954
kafka,PR-11425,1,1,1,1,2
kafka,PR-11331,7,42,1604,1351,2955
kafka,PR-11426,1,1,3,1,4
kafka,PR-11413,3,2,141,53,194
kafka,PR-11426,2,1,3,1,4
kafka,PR-11427,1,1,3,3,6
kafka,PR-11428,1,3,172,15,187
kafka,PR-11368,4,8,691,20,711
kafka,PR-11284,19,47,5610,5,5615
kafka,PR-11284,20,47,5603,5,5608
kafka,PR-11429,1,2,33,16,49
kafka,PR-11430,1,2,44,4,48
kafka,PR-11431,1,4,20,9,29
kafka,PR-10678,9,11,52,56,108
kafka,PR-10472,9,2,7,7,14
kafka,PR-10678,10,11,52,56,108
kafka,PR-11432,1,43,292,154,446
kafka,PR-11368,5,8,691,20,711
kafka,PR-11433,1,2,176,0,176
kafka,PR-11415,2,5,5,0,5
kafka,PR-11284,21,47,5657,5,5662
kafka,PR-11284,22,47,5658,5,5663
kafka,PR-11331,8,42,1604,1351,2955
kafka,PR-11284,23,47,5801,5,5806
kafka,PR-11434,1,1,2,1,3
kafka,PR-11416,2,6,109,42,151
kafka,PR-11436,1,1,4,1,5
kafka,PR-11331,9,42,1610,1380,2990
kafka,PR-11284,24,47,5878,5,5883
kafka,PR-11438,1,1,11,5,16
kafka,PR-11439,1,1,7,3,10
kafka,PR-11433,2,2,174,0,174
kafka,PR-11427,2,1,2,2,4
kafka,PR-11439,2,1,40,3,43
kafka,PR-11440,1,2,31,0,31
kafka,PR-11427,3,1,2,2,4
kafka,PR-11331,10,42,1610,1380,2990
kafka,PR-11345,7,2,17,1,18
kafka,PR-11441,1,3,164,0,164
kafka,PR-11284,25,47,5882,5,5887
kafka,PR-11382,3,3,65,1,66
kafka,PR-11442,1,3,74,9,83
kafka,PR-11441,2,3,166,0,166
kafka,PR-11435,3,6,132,17,149
kafka,PR-11331,11,42,1793,1384,3177
kafka,PR-11443,4,1,10,1,11
kafka,PR-11442,2,3,84,18,102
kafka,PR-11444,1,1,40,3,43
kafka,PR-11442,3,3,84,18,102
kafka,PR-11445,1,1,4,1,5
kafka,PR-11446,1,1,0,161,161
kafka,PR-11447,1,7,64,15,79
kafka,PR-11284,26,48,5896,5,5901
kafka,PR-11448,1,3,29,5,34
kafka,PR-11272,13,26,683,403,1086
kafka,PR-11401,3,2,39,1,40
kafka,PR-11439,3,1,40,3,43
kafka,PR-10830,4,16,164,12,176
kafka,PR-11439,5,2,110,3,113
kafka,PR-11424,3,65,740,216,956
kafka,PR-11451,1,1,1,0,1
kafka,PR-11424,4,65,740,216,956
kafka,PR-11449,3,2,27,13,40
kafka,PR-11448,2,5,122,11,133
kafka,PR-11452,1,4,71,6,77
kafka,PR-11401,4,3,82,1,83
kafka,PR-11417,12,109,946,539,1485
kafka,PR-11453,1,1,1,1,2
kafka,PR-11454,1,2,32,2,34
kafka,PR-11340,8,4,61,13,74
kafka,PR-7898,21,91,2233,1488,3721
kafka,PR-10827,6,2,132,60,192
kafka,PR-11455,1,1,3,1,4
kafka,PR-10851,18,19,1003,158,1161
kafka,PR-11430,2,2,60,6,66
kafka,PR-11456,2,2,264,18,282
kafka,PR-11457,1,1,11,1,12
kafka,PR-11323,9,7,610,193,803
kafka,PR-11368,6,8,695,20,715
kafka,PR-11272,14,27,689,407,1096
kafka,PR-9577,39,35,1103,50,1153
kafka,PR-11458,1,8,14,10,24
kafka,PR-11382,4,5,59,5,64
kafka,PR-11323,10,7,710,192,902
kafka,PR-10678,11,11,52,56,108
kafka,PR-11415,3,5,5,0,5
kafka,PR-11323,11,7,712,192,904
kafka,PR-11459,1,3,102,7,109
kafka,PR-11460,1,2,9,1,10
kafka,PR-11461,1,1,8,2,10
kafka,PR-11462,1,1,4,6,10
kafka,PR-10851,19,19,1051,158,1209
kafka,PR-11463,1,2,0,9,9
kafka,PR-11401,5,3,91,2,93
kafka,PR-11464,2,11,256,45,301
kafka,PR-11465,1,2,262,136,398
kafka,PR-11460,2,2,9,1,10
kafka,PR-11466,1,1,1,1,2
kafka,PR-11460,3,2,10,0,10
kafka,PR-11460,4,2,10,0,10
kafka,PR-11447,2,7,182,7,189
kafka,PR-11465,2,2,262,136,398
kafka,PR-11331,12,42,1793,1384,3177
kafka,PR-11401,6,3,92,2,94
kafka,PR-11331,13,42,1796,1399,3195
kafka,PR-11331,14,42,1772,1415,3187
kafka,PR-11462,2,1,4,6,10
kafka,PR-11469,1,2,11,1,12
kafka,PR-11470,1,1,5,3,8
kafka,PR-11430,3,2,57,5,62
kafka,PR-11471,1,3,26,34,60
kafka,PR-11345,8,2,17,0,17
kafka,PR-11430,4,2,52,5,57
kafka,PR-11261,6,12,69,58,127
kafka,PR-11454,2,2,37,1,38
kafka,PR-11473,1,1,25,0,25
kafka,PR-11474,1,1,30,5,35
kafka,PR-11475,1,2,3,7,10
kafka,PR-11442,4,3,84,18,102
kafka,PR-11331,15,43,2060,1463,3523
kafka,PR-11451,2,4,32,23,55
kafka,PR-11450,5,4,186,340,526
kafka,PR-11462,3,1,4,6,10
kafka,PR-11331,16,44,2409,1496,3905
kafka,PR-11345,9,2,17,0,17
kafka,PR-11476,1,1,30,20,50
kafka,PR-11401,7,3,87,2,89
kafka,PR-11412,4,46,578,441,1019
kafka,PR-11448,3,6,154,29,183
kafka,PR-11449,4,2,30,14,44
kafka,PR-11448,4,6,152,29,181
kafka,PR-11477,1,2,2,1,3
kafka,PR-11451,3,4,32,23,55
kafka,PR-11331,17,44,2427,1502,3929
kafka,PR-11449,5,3,33,15,48
kafka,PR-11467,3,2,10,11,21
kafka,PR-11403,2,2,38,9,47
kafka,PR-11449,6,3,33,15,48
kafka,PR-11448,5,6,154,31,185
kafka,PR-11465,3,2,252,137,389
kafka,PR-11447,5,26,1077,153,1230
kafka,PR-11465,4,7,336,159,495
kafka,PR-11456,3,2,264,18,282
kafka,PR-11401,8,4,104,3,107
kafka,PR-11465,5,11,336,171,507
kafka,PR-11422,2,4,35,7,42
kafka,PR-11272,15,28,692,406,1098
kafka,PR-11473,2,1,52,27,79
kafka,PR-11480,1,1,2,2,4
kafka,PR-11481,1,30,143,288,431
kafka,PR-11331,20,45,2822,1516,4338
kafka,PR-11481,2,30,152,293,445
kafka,PR-11331,21,45,2835,1516,4351
kafka,PR-11478,5,4,93,8,101
kafka,PR-11451,6,3,42,30,72
kafka,PR-11483,1,1,2,2,4
kafka,PR-10563,7,13,907,163,1070
kafka,PR-11484,1,1,2,0,2
kafka,PR-11485,1,2,3,3,6
kafka,PR-11456,4,2,264,18,282
kafka,PR-11479,8,7,303,33,336
kafka,PR-11486,1,1,245,137,382
kafka,PR-11487,1,5,84,22,106
kafka,PR-11488,1,1,1,1,2
kafka,PR-11489,1,4,0,10,10
kafka,PR-11479,9,7,317,38,355
kafka,PR-11004,2,7,160,95,255
kafka,PR-11331,23,45,2854,1515,4369
kafka,PR-11406,11,33,1811,4,1815
kafka,PR-11486,2,1,245,137,382
kafka,PR-11483,2,1,2,2,4
kafka,PR-11481,3,30,185,330,515
kafka,PR-11481,4,30,190,335,525
kafka,PR-11331,24,45,2854,1515,4369
kafka,PR-11468,4,3,80,14,94
kafka,PR-11331,26,45,2854,1515,4369
kafka,PR-11483,3,1,2,2,4
kafka,PR-11331,27,45,2854,1515,4369
kafka,PR-11468,5,3,80,14,94
kafka,PR-11482,7,9,173,62,235
kafka,PR-11331,28,45,2854,1515,4369
kafka,PR-11451,7,4,127,37,164
kafka,PR-11490,2,2,6,2,8
kafka,PR-11474,2,2,178,72,250
kafka,PR-11492,1,1,5,2,7
kafka,PR-11491,2,6,146,1,147
kafka,PR-11494,1,1,2,1,3
kafka,PR-11495,1,5,8,7,15
kafka,PR-11496,1,1,2,0,2
kafka,PR-11497,1,5,10,2,12
kafka,PR-11462,4,1,4,6,10
kafka,PR-11498,2,2,19,0,19
kafka,PR-11500,1,1,70,7,77
kafka,PR-11459,2,3,102,7,109
kafka,PR-11494,2,1,2,1,3
kafka,PR-11004,3,7,162,97,259
kafka,PR-11501,1,1,1,2,3
kafka,PR-10528,7,6,54,10,64
kafka,PR-11503,1,4,45,9,54
kafka,PR-11487,2,5,83,48,131
kafka,PR-11502,2,1,18,6,24
kafka,PR-11472,2,11,14,20,34
kafka,PR-11459,3,3,104,7,111
kafka,PR-11504,1,1,4,0,4
kafka,PR-11505,1,1,5,1,6
kafka,PR-11493,3,2,195,61,256
kafka,PR-11505,2,1,3,1,4
kafka,PR-11207,2,7,147,5,152
kafka,PR-11506,1,300,13734,3568,17302
kafka,PR-11390,11,34,1914,101,2015
kafka,PR-11498,3,2,19,0,19
kafka,PR-11506,2,300,13734,3568,17302
kafka,PR-11506,3,300,13734,3568,17302
kafka,PR-11498,4,2,19,0,19
kafka,PR-11502,3,1,18,6,24
kafka,PR-11504,2,1,4,0,4
kafka,PR-11459,4,3,102,7,109
kafka,PR-11506,4,300,13734,3568,17302
kafka,PR-11484,2,2,11,0,11
kafka,PR-11506,5,300,13734,3568,17302
kafka,PR-11508,1,3,151,2,153
kafka,PR-11004,4,7,154,100,254
kafka,PR-11479,10,7,316,38,354
kafka,PR-11404,3,2,127,106,233
kafka,PR-11004,5,6,153,92,245
kafka,PR-11452,2,5,115,49,164
kafka,PR-11479,11,7,314,39,353
kafka,PR-11490,3,2,14,2,16
kafka,PR-11506,6,300,13734,3568,17302
kafka,PR-11345,11,9,53,25,78
kafka,PR-11390,12,37,1935,105,2040
kafka,PR-11467,4,2,8,11,19
kafka,PR-11509,1,1,36,23,59
kafka,PR-11390,13,39,1964,109,2073
kafka,PR-11459,5,3,102,7,109
kafka,PR-11431,2,3,47,2,49
kafka,PR-11506,7,300,13734,3568,17302
kafka,PR-11390,14,39,1964,109,2073
kafka,PR-11506,8,300,13734,3568,17302
kafka,PR-11451,8,4,127,37,164
kafka,PR-11345,12,9,53,25,78
kafka,PR-11503,2,2,122,24,146
kafka,PR-11506,9,300,13734,3568,17302
kafka,PR-11510,1,1,1,1,2
kafka,PR-11459,6,3,102,7,109
kafka,PR-11506,10,300,13748,3578,17326
kafka,PR-11503,3,2,166,34,200
kafka,PR-11511,1,2,1,9,10
kafka,PR-11479,14,7,333,53,386
kafka,PR-11479,15,7,337,53,390
kafka,PR-11459,7,3,103,8,111
kafka,PR-11511,2,3,3,26,29
kafka,PR-11390,15,39,1965,109,2074
kafka,PR-11459,8,3,103,8,111
kafka,PR-11496,5,1,9,9,18
kafka,PR-11459,9,3,103,8,111
kafka,PR-11510,2,1,1,1,2
kafka,PR-11506,11,300,13748,3578,17326
kafka,PR-11478,7,5,95,8,103
kafka,PR-11500,2,1,69,4,73
kafka,PR-11506,12,300,13749,3579,17328
kafka,PR-11512,1,1,1,1,2
kafka,PR-11393,3,3,1028,763,1791
kafka,PR-11478,8,6,100,10,110
kafka,PR-11514,1,4,249,0,249
kafka,PR-11503,4,4,251,80,331
kafka,PR-11506,13,300,13749,3579,17328
kafka,PR-11515,1,28,276,131,407
kafka,PR-11479,16,7,338,57,395
kafka,PR-11479,19,7,363,37,400
kafka,PR-11506,14,300,13749,3579,17328
kafka,PR-11479,20,7,357,37,394
kafka,PR-11511,3,3,3,26,29
kafka,PR-11479,21,7,351,36,387
kafka,PR-11451,9,4,130,36,166
kafka,PR-11451,10,4,130,36,166
kafka,PR-11506,15,300,13749,3579,17328
kafka,PR-11432,2,43,291,153,444
kafka,PR-11516,1,1,2,2,4
kafka,PR-11517,1,1,1,1,2
kafka,PR-11422,3,4,35,7,42
kafka,PR-11496,6,1,9,9,18
kafka,PR-11518,1,3,157,108,265
kafka,PR-11422,4,4,35,7,42
kafka,PR-11382,5,5,59,5,64
kafka,PR-11506,16,300,13749,3579,17328
kafka,PR-11046,4,4,220,87,307
kafka,PR-11503,5,12,310,105,415
kafka,PR-11506,17,300,13749,3579,17328
kafka,PR-11503,6,15,311,107,418
kafka,PR-11046,5,4,220,87,307
kafka,PR-11382,6,5,58,5,63
kafka,PR-11514,3,6,228,0,228
kafka,PR-11519,1,1,1,1,2
kafka,PR-11345,13,9,47,25,72
kafka,PR-11520,1,1,39,35,74
kafka,PR-11481,5,30,189,335,524
kafka,PR-11481,6,30,189,335,524
kafka,PR-11473,3,1,37,12,49
kafka,PR-11473,4,1,36,11,47
kafka,PR-11521,1,24,43,73,116
kafka,PR-11506,18,300,13749,3579,17328
kafka,PR-11513,4,19,980,35,1015
kafka,PR-11476,2,1,30,20,50
kafka,PR-9492,7,2,296,84,380
kafka,PR-11522,2,11,154,41,195
kafka,PR-11476,3,1,30,20,50
kafka,PR-11514,4,7,301,0,301
kafka,PR-11506,19,300,13749,3579,17328
kafka,PR-10851,20,19,1051,158,1209
kafka,PR-11046,6,4,226,89,315
kafka,PR-11503,7,15,326,119,445
kafka,PR-11390,16,39,1958,102,2060
kafka,PR-11345,14,9,47,25,72
kafka,PR-11523,1,2,296,84,380
kafka,PR-11456,5,2,264,18,282
kafka,PR-11504,4,2,52,7,59
kafka,PR-11524,1,3,154,18,172
kafka,PR-11525,1,1,62,49,111
kafka,PR-11456,6,2,288,18,306
kafka,PR-11479,22,7,382,36,418
kafka,PR-11524,2,3,146,8,154
kafka,PR-11514,5,7,300,0,300
kafka,PR-11503,8,15,315,119,434
kafka,PR-11526,1,3,154,14,168
kafka,PR-11506,20,300,13749,3579,17328
kafka,PR-11527,1,8,321,41,362
kafka,PR-11457,2,1,23,1,24
kafka,PR-11481,7,30,241,381,622
kafka,PR-11345,16,13,64,32,96
kafka,PR-11503,9,15,354,122,476
kafka,PR-11527,2,8,321,41,362
kafka,PR-11455,3,3,19,5,24
kafka,PR-11506,21,300,13749,3579,17328
kafka,PR-11514,6,7,300,0,300
kafka,PR-11528,1,1,5,5,10
kafka,PR-11517,2,1,0,8,8
kafka,PR-11529,1,25,258,92,350
kafka,PR-11530,1,1,0,2,2
kafka,PR-11528,2,1,5,5,10
kafka,PR-11517,3,1,0,8,8
kafka,PR-11529,2,24,234,91,325
kafka,PR-11531,2,2,37,0,37
kafka,PR-11513,5,28,1252,63,1315
kafka,PR-11504,5,2,52,7,59
kafka,PR-11503,10,15,354,122,476
kafka,PR-11520,2,1,39,35,74
kafka,PR-11504,6,2,50,7,57
kafka,PR-11524,3,3,147,8,155
kafka,PR-10969,7,10,75,43,118
kafka,PR-11532,1,2,10,2,12
kafka,PR-11182,3,5,195,7,202
kafka,PR-11015,2,4,54,0,54
kafka,PR-11504,7,2,50,7,57
kafka,PR-11527,3,8,321,41,362
kafka,PR-11524,4,3,149,10,159
kafka,PR-11514,7,7,305,0,305
kafka,PR-11526,2,3,157,19,176
kafka,PR-11533,1,1,4,0,4
kafka,PR-10873,6,1,8,5,13
kafka,PR-11506,22,300,13749,3579,17328
kafka,PR-11530,2,1,0,2,2
kafka,PR-11514,8,7,307,0,307
kafka,PR-11534,1,54,591,674,1265
kafka,PR-11535,1,2,21,9,30
kafka,PR-11506,23,300,13749,3579,17328
kafka,PR-11479,23,7,382,36,418
kafka,PR-11536,1,1,41,40,81
kafka,PR-11537,2,5,43,0,43
kafka,PR-11514,9,7,307,0,307
kafka,PR-11536,2,1,41,44,85
kafka,PR-11506,24,300,13749,3579,17328
kafka,PR-11506,25,300,13749,3579,17328
kafka,PR-11532,2,2,10,2,12
kafka,PR-11506,26,300,13749,3579,17328
kafka,PR-11538,1,2,38,38,76
kafka,PR-11506,27,300,13749,3579,17328
kafka,PR-11538,2,2,38,38,76
kafka,PR-11539,1,1,44,0,44
kafka,PR-11540,1,1,8,5,13
kafka,PR-11539,2,2,47,3,50
kafka,PR-11541,1,3,58,10,68
kafka,PR-11540,2,1,8,5,13
kafka,PR-11536,3,1,41,40,81
kafka,PR-11541,2,3,47,2,49
kafka,PR-11506,28,300,13749,3579,17328
kafka,PR-11541,3,5,85,2,87
kafka,PR-11536,4,1,41,40,81
kafka,PR-11530,3,1,0,2,2
kafka,PR-11530,4,1,2,2,4
kafka,PR-11529,3,23,248,118,366
kafka,PR-11543,1,1,1,0,1
kafka,PR-11207,3,7,147,5,152
kafka,PR-11529,7,14,416,284,700
kafka,PR-11207,4,5,106,3,109
kafka,PR-11545,1,1,1,1,2
kafka,PR-11536,5,1,100,93,193
kafka,PR-11546,2,1,7,0,7
kafka,PR-11529,8,14,416,284,700
kafka,PR-11547,1,2,6,6,12
kafka,PR-11529,9,14,377,284,661
kafka,PR-11506,29,300,13749,3579,17328
kafka,PR-11548,1,6,138,16,154
kafka,PR-10851,21,19,1051,158,1209
kafka,PR-11541,4,8,140,7,147
kafka,PR-11515,2,28,276,131,407
kafka,PR-11506,30,300,13749,3579,17328
kafka,PR-11541,5,9,161,7,168
kafka,PR-11450,6,4,201,357,558
kafka,PR-11393,4,3,1067,800,1867
kafka,PR-11549,1,7,87,28,115
kafka,PR-11548,2,7,139,16,155
kafka,PR-11506,31,300,13749,3579,17328
kafka,PR-11550,1,62,1205,208,1413
kafka,PR-11548,3,7,136,16,152
kafka,PR-11529,10,14,377,284,661
kafka,PR-11551,1,1,1,1,2
kafka,PR-11552,1,3,92,6,98
kafka,PR-11207,5,5,106,3,109
kafka,PR-11541,6,11,216,7,223
kafka,PR-11541,7,13,269,6,275
kafka,PR-11554,1,1,1,1,2
kafka,PR-11554,2,2,5,0,5
kafka,PR-11555,1,1,8,2,10
kafka,PR-11506,32,300,13749,3579,17328
kafka,PR-11503,11,15,391,122,513
kafka,PR-11452,6,6,375,283,658
kafka,PR-11513,7,31,1227,109,1336
kafka,PR-11555,2,2,12,4,16
kafka,PR-11506,33,300,13753,3579,17332
kafka,PR-11556,1,1,1,1,2
kafka,PR-11416,3,6,109,42,151
kafka,PR-11503,12,15,397,122,519
kafka,PR-11479,26,7,452,38,490
kafka,PR-11345,17,13,67,34,101
kafka,PR-11557,2,36,2757,189,2946
kafka,PR-11506,34,300,13753,3579,17332
kafka,PR-11541,8,13,269,6,275
kafka,PR-11552,2,3,121,7,128
kafka,PR-11513,8,31,1237,110,1347
kafka,PR-11558,1,2,13,10,23
kafka,PR-11345,18,13,68,34,102
kafka,PR-11559,1,3,80,13,93
kafka,PR-11539,3,3,50,5,55
kafka,PR-11560,1,20,797,486,1283
kafka,PR-11557,5,38,2798,192,2990
kafka,PR-11506,35,300,13753,3579,17332
kafka,PR-11557,6,44,2836,235,3071
kafka,PR-11345,19,13,68,34,102
kafka,PR-11418,3,1,5,2,7
kafka,PR-11561,1,2,1,6,7
kafka,PR-11513,10,35,1576,181,1757
kafka,PR-11562,2,5,111,5,116
kafka,PR-11513,11,33,1554,216,1770
kafka,PR-11539,4,3,92,5,97
kafka,PR-11503,13,20,447,156,603
kafka,PR-11539,5,3,92,5,97
kafka,PR-11563,1,2,12,3,15
kafka,PR-11513,13,34,1576,238,1814
kafka,PR-11506,36,300,13753,3579,17332
kafka,PR-11416,5,9,229,42,271
kafka,PR-11416,6,9,232,42,274
kafka,PR-11564,1,1,24,15,39
kafka,PR-11506,37,300,13753,3579,17332
kafka,PR-11513,14,36,1610,281,1891
kafka,PR-11562,3,5,112,5,117
kafka,PR-11565,1,6,137,6,143
kafka,PR-11506,38,300,13753,3579,17332
kafka,PR-11503,14,20,445,156,601
kafka,PR-11046,7,4,224,90,314
kafka,PR-11506,39,300,13753,3579,17332
kafka,PR-11456,7,2,279,18,297
kafka,PR-11456,8,2,282,20,302
kafka,PR-11456,9,2,308,22,330
kafka,PR-11508,2,3,151,2,153
kafka,PR-9577,40,35,1106,50,1156
kafka,PR-11173,9,3,343,126,469
kafka,PR-11506,40,300,13753,3579,17332
kafka,PR-11506,41,300,13753,3579,17332
kafka,PR-11567,1,6,228,0,228
kafka,PR-11382,7,5,80,7,87
kafka,PR-11513,16,40,1706,346,2052
kafka,PR-11568,1,1,1,1,2
kafka,PR-11569,1,1,1,1,2
kafka,PR-11566,2,8,87,5,92
kafka,PR-11506,42,300,13753,3579,17332
kafka,PR-11570,2,4,20,10,30
kafka,PR-11390,17,39,1958,102,2060
kafka,PR-10910,3,11,53,15,68
kafka,PR-11571,1,7,76,8,84
kafka,PR-11173,10,3,393,188,581
kafka,PR-11173,11,3,400,195,595
kafka,PR-11513,17,40,1656,346,2002
kafka,PR-11572,1,39,559,196,755
kafka,PR-11573,1,2,22,2,24
kafka,PR-11574,1,1,37,24,61
kafka,PR-11565,2,6,140,6,146
kafka,PR-11575,1,1,42,5,47
kafka,PR-11503,15,21,471,157,628
kafka,PR-11046,8,4,224,90,314
kafka,PR-11565,3,8,142,6,148
kafka,PR-11506,43,300,13753,3579,17332
kafka,PR-11575,2,1,42,5,47
kafka,PR-11345,20,14,71,36,107
kafka,PR-11506,44,300,13749,3579,17328
kafka,PR-11513,18,40,1656,346,2002
kafka,PR-11573,2,2,22,2,24
kafka,PR-11576,1,2,8,3,11
kafka,PR-11046,9,4,225,90,315
kafka,PR-11503,16,21,482,159,641
kafka,PR-11456,10,2,311,24,335
kafka,PR-11566,3,8,93,5,98
kafka,PR-11573,3,2,39,2,41
kafka,PR-11578,1,1,2,2,4
kafka,PR-11513,19,40,1657,346,2003
kafka,PR-11567,4,7,503,0,503
kafka,PR-11567,5,7,535,0,535
kafka,PR-11567,6,7,550,0,550
kafka,PR-11506,45,300,13749,3579,17328
kafka,PR-11573,4,2,39,2,41
kafka,PR-11580,1,4,75,4,79
kafka,PR-11506,46,300,13749,3579,17328
kafka,PR-11573,5,2,39,2,41
kafka,PR-11506,47,300,13768,3590,17358
kafka,PR-11581,5,15,256,63,319
kafka,PR-11584,1,1,16,14,30
kafka,PR-11585,1,6,3,30,33
kafka,PR-11562,13,8,397,19,416
kafka,PR-11506,48,300,13768,3590,17358
kafka,PR-11567,7,8,584,0,584
kafka,PR-11503,17,21,482,159,641
kafka,PR-11506,49,300,13768,3590,17358
kafka,PR-11587,1,1,1,1,2
kafka,PR-11393,5,3,1069,802,1871
kafka,PR-11567,8,9,652,0,652
kafka,PR-11506,50,300,13768,3590,17358
kafka,PR-11588,1,3,25,2,27
kafka,PR-11503,18,21,482,159,641
kafka,PR-11581,6,16,284,87,371
kafka,PR-11585,2,6,3,30,33
kafka,PR-11506,51,300,13768,3590,17358
kafka,PR-11589,1,2,3,3,6
kafka,PR-11581,7,18,294,118,412
kafka,PR-11506,52,300,13768,3590,17358
kafka,PR-11581,8,24,327,153,480
kafka,PR-11591,1,5,70,14,84
kafka,PR-11592,1,3,203,1,204
kafka,PR-11567,9,9,643,0,643
kafka,PR-11560,2,20,797,486,1283
kafka,PR-11393,6,3,1069,802,1871
kafka,PR-11503,19,21,482,159,641
kafka,PR-11506,53,300,13771,3590,17361
kafka,PR-11560,3,12,577,284,861
kafka,PR-11536,6,1,100,93,193
kafka,PR-11593,1,9,64,21,85
kafka,PR-11577,2,9,425,283,708
kafka,PR-11589,2,2,3,3,6
kafka,PR-11591,2,5,51,14,65
kafka,PR-11544,2,5,24,34,58
kafka,PR-11581,9,24,327,153,480
kafka,PR-11544,3,5,24,34,58
kafka,PR-11593,4,9,85,22,107
kafka,PR-11588,2,3,25,2,27
kafka,PR-11595,1,1,5,2,7
kafka,PR-11596,1,1,3,3,6
kafka,PR-11456,11,2,307,25,332
kafka,PR-11582,5,6,324,10,334
kafka,PR-11390,19,39,1972,102,2074
kafka,PR-11560,5,12,578,284,862
kafka,PR-11390,20,39,1971,102,2073
kafka,PR-11597,1,4,74,13,87
kafka,PR-11390,21,39,1972,102,2074
kafka,PR-11390,22,39,1974,105,2079
kafka,PR-11598,1,9,642,143,785
kafka,PR-11572,2,39,557,194,751
kafka,PR-11599,1,6,18,9,27
kafka,PR-11572,3,39,557,194,751
kafka,PR-11600,2,5,100,56,156
kafka,PR-11600,3,5,100,56,156
kafka,PR-11602,1,1,1,0,1
kafka,PR-11598,2,9,471,20,491
kafka,PR-11601,2,6,149,60,209
kafka,PR-11603,3,3,41,1,42
kafka,PR-11600,4,5,108,59,167
kafka,PR-11598,3,9,582,29,611
kafka,PR-11601,3,6,148,63,211
kafka,PR-11589,3,2,3,3,6
kafka,PR-11601,4,7,155,70,225
kafka,PR-11571,2,8,79,9,88
kafka,PR-11589,4,2,3,3,6
kafka,PR-7898,22,91,2231,1486,3717
kafka,PR-11589,5,2,3,3,6
kafka,PR-11522,3,10,154,43,197
kafka,PR-11552,3,3,116,7,123
kafka,PR-11552,4,3,116,7,123
kafka,PR-10528,10,38,90,49,139
kafka,PR-11604,1,1,1,0,1
kafka,PR-11605,1,1,2,1,3
kafka,PR-11606,1,5,178,116,294
kafka,PR-11552,5,3,116,7,123
kafka,PR-11571,6,9,87,10,97
kafka,PR-11566,4,10,134,27,161
kafka,PR-11552,6,3,117,7,124
kafka,PR-11598,4,9,553,28,581
kafka,PR-11560,6,12,583,288,871
kafka,PR-11567,14,9,604,18,622
kafka,PR-11604,4,1,5,0,5
kafka,PR-11606,3,6,183,121,304
kafka,PR-11598,5,9,553,28,581
kafka,PR-11599,2,7,41,9,50
kafka,PR-11607,1,1,0,1,1
kafka,PR-11604,6,1,6,0,6
kafka,PR-11608,1,12,443,76,519
kafka,PR-11604,7,1,6,0,6
kafka,PR-11571,9,9,91,10,101
kafka,PR-11604,8,1,6,0,6
kafka,PR-11582,6,6,215,54,269
kafka,PR-11609,2,8,201,26,227
kafka,PR-11582,7,6,215,54,269
kafka,PR-11535,2,2,21,9,30
kafka,PR-11607,2,1,0,1,1
kafka,PR-11451,11,4,132,36,168
kafka,PR-11610,1,2,19,1,20
kafka,PR-11608,2,12,443,76,519
kafka,PR-11606,4,6,173,119,292
kafka,PR-11611,1,10,97,17,114
kafka,PR-11582,9,9,273,175,448
kafka,PR-11608,3,12,443,76,519
kafka,PR-11582,10,9,276,177,453
kafka,PR-11596,2,1,3,3,6
kafka,PR-11612,1,2,9,7,16
kafka,PR-11613,1,1,6,4,10
kafka,PR-10244,6,23,282,84,366
kafka,PR-11015,3,4,54,0,54
kafka,PR-11182,4,5,195,7,202
kafka,PR-10969,8,10,75,43,118
kafka,PR-11614,1,25,285,266,551
kafka,PR-11615,1,2,26,0,26
kafka,PR-10244,7,23,282,84,366
kafka,PR-7898,23,91,2231,1486,3717
kafka,PR-11616,1,6,33,29,62
kafka,PR-11616,2,6,33,29,62
kafka,PR-11616,3,7,37,30,67
kafka,PR-11617,1,3,67,17,84
kafka,PR-11618,1,1,13,3,16
kafka,PR-11617,2,5,362,99,461
kafka,PR-11617,3,6,349,99,448
kafka,PR-11345,21,14,107,36,143
kafka,PR-11345,22,14,108,37,145
kafka,PR-11571,10,9,91,11,102
kafka,PR-11571,11,9,91,11,102
kafka,PR-11564,2,1,24,15,39
kafka,PR-11567,15,9,604,18,622
kafka,PR-11390,26,43,2059,149,2208
kafka,PR-11456,12,2,337,25,362
kafka,PR-11619,1,1,2,0,2
kafka,PR-11620,1,2,15,0,15
kafka,PR-11610,2,2,21,2,23
kafka,PR-11622,1,1,13,12,25
kafka,PR-11345,23,14,115,39,154
kafka,PR-11566,6,10,130,27,157
kafka,PR-11345,24,14,115,38,153
kafka,PR-11390,27,43,2059,149,2208
kafka,PR-11345,25,14,115,38,153
kafka,PR-11390,28,43,2059,149,2208
kafka,PR-11390,29,43,2031,149,2180
kafka,PR-11623,1,45,2183,173,2356
kafka,PR-11390,30,43,2031,149,2180
kafka,PR-11623,2,45,2183,173,2356
kafka,PR-11535,3,2,21,9,30
kafka,PR-11567,23,9,666,44,710
kafka,PR-11567,24,9,666,44,710
kafka,PR-11345,26,14,115,38,153
kafka,PR-11433,3,3,191,1,192
kafka,PR-11624,2,2,227,98,325
kafka,PR-11625,1,1,2,2,4
kafka,PR-11603,4,2,52,1,53
kafka,PR-11603,5,2,52,1,53
kafka,PR-11626,1,3,9,9,18
kafka,PR-11518,2,3,157,108,265
kafka,PR-11518,3,3,157,108,265
kafka,PR-11473,5,1,36,11,47
kafka,PR-11474,3,2,181,72,253
kafka,PR-11430,5,2,52,5,57
kafka,PR-11454,3,2,37,1,38
kafka,PR-10827,7,2,132,60,192
kafka,PR-10472,10,2,7,7,14
kafka,PR-10244,8,23,282,84,366
kafka,PR-7898,24,91,2231,1486,3717
kafka,PR-11567,25,9,666,44,710
kafka,PR-11628,1,21,0,398,398
kafka,PR-11518,4,3,157,108,265
kafka,PR-11579,5,2,21,2,23
kafka,PR-11629,1,5,80,45,125
kafka,PR-11630,1,1,0,10,10
kafka,PR-11624,3,2,227,98,325
kafka,PR-11340,18,7,173,33,206
kafka,PR-11340,19,7,178,33,211
kafka,PR-11345,27,14,115,38,153
kafka,PR-11340,20,7,184,38,222
kafka,PR-11619,2,1,2,0,2
kafka,PR-11340,21,7,184,38,222
kafka,PR-10244,9,23,282,84,366
kafka,PR-11631,1,1,4,6,10
kafka,PR-11601,5,7,176,89,265
kafka,PR-11627,6,32,552,187,739
kafka,PR-11627,7,32,553,178,731
kafka,PR-11633,1,1,13,9,22
kafka,PR-11634,1,1,166,113,279
kafka,PR-11635,1,1,8,7,15
kafka,PR-11636,1,4,65,37,102
kafka,PR-11637,1,4,57,22,79
kafka,PR-11638,1,4,56,20,76
kafka,PR-11640,1,2,19,12,31
kafka,PR-11627,8,33,560,179,739
kafka,PR-11567,29,17,955,102,1057
kafka,PR-11567,30,17,1031,102,1133
kafka,PR-11641,1,1,2,2,4
kafka,PR-11627,10,33,565,181,746
kafka,PR-11627,11,33,580,196,776
kafka,PR-11627,12,33,647,205,852
kafka,PR-9577,41,35,1106,50,1156
kafka,PR-9577,42,36,1142,50,1192
kafka,PR-11642,1,3,182,182,364
kafka,PR-11564,3,1,23,14,37
kafka,PR-11644,1,2,24,10,34
kafka,PR-11642,2,3,182,206,388
kafka,PR-11647,1,39,916,251,1167
kafka,PR-11646,3,44,827,262,1089
kafka,PR-11333,6,4,61,2,63
kafka,PR-11333,7,4,61,2,63
kafka,PR-11648,1,1,3,1,4
kafka,PR-11340,22,7,184,38,222
kafka,PR-11340,23,7,184,38,222
kafka,PR-11340,24,7,184,38,222
kafka,PR-11345,28,14,115,38,153
kafka,PR-11452,7,8,417,316,733
kafka,PR-11456,13,2,335,24,359
kafka,PR-11624,4,2,238,110,348
kafka,PR-11651,1,1,6,0,6
kafka,PR-11650,2,1,121,8,129
kafka,PR-11652,1,1,24,5,29
kafka,PR-11653,1,2,20,3,23
kafka,PR-11452,8,8,419,316,735
kafka,PR-11624,5,2,238,110,348
kafka,PR-11641,2,1,3,2,5
kafka,PR-11637,2,7,189,91,280
kafka,PR-11650,3,1,122,9,131
kafka,PR-11651,2,2,33,1,34
kafka,PR-11629,2,5,94,36,130
kafka,PR-11637,3,7,190,92,282
kafka,PR-11452,9,9,421,318,739
kafka,PR-11650,5,1,121,8,129
kafka,PR-11647,2,39,921,252,1173
kafka,PR-11629,3,3,66,29,95
kafka,PR-11654,1,6,435,90,525
kafka,PR-11593,5,9,85,22,107
kafka,PR-11636,2,1,46,33,79
kafka,PR-11638,2,3,32,16,48
kafka,PR-11639,2,1,7,4,11
kafka,PR-11634,2,1,180,118,298
kafka,PR-11636,3,1,45,33,78
kafka,PR-11634,3,1,180,118,298
kafka,PR-11655,1,3,14,9,23
kafka,PR-11456,14,2,335,24,359
kafka,PR-11261,7,12,69,58,127
kafka,PR-11456,15,2,301,24,325
kafka,PR-11656,1,1,2,2,4
kafka,PR-11655,2,3,14,9,23
kafka,PR-11611,2,10,97,17,114
kafka,PR-11657,1,8,959,157,1116
kafka,PR-11611,3,10,97,17,114
kafka,PR-11611,4,10,97,17,114
kafka,PR-11656,2,1,3,3,6
kafka,PR-11658,1,6,1889,1,1890
kafka,PR-11658,2,29,25932,1,25933
kafka,PR-11659,1,5,57,19,76
kafka,PR-11658,3,32,26004,4,26008
kafka,PR-11660,1,1,1,1,2
kafka,PR-11658,4,34,26026,4,26030
kafka,PR-11658,5,35,26027,5,26032
kafka,PR-11658,6,34,26034,5,26039
kafka,PR-11661,1,34,26029,16,26045
kafka,PR-11661,2,35,26028,14,26042
kafka,PR-11663,1,1,4,3,7
kafka,PR-9584,10,3,28,5,33
kafka,PR-11664,1,1,11,6,17
kafka,PR-11566,7,11,133,27,160
kafka,PR-11571,12,9,93,11,104
kafka,PR-11611,5,12,112,17,129
kafka,PR-11611,6,12,130,25,155
kafka,PR-11345,29,14,118,38,156
kafka,PR-11657,2,12,1183,233,1416
kafka,PR-11638,3,3,32,24,56
kafka,PR-11345,30,14,120,38,158
kafka,PR-11663,2,1,4,3,7
kafka,PR-11661,3,36,26034,14,26048
kafka,PR-10851,22,19,1052,158,1210
kafka,PR-11661,4,37,26035,16,26051
kafka,PR-11665,1,1,0,3,3
kafka,PR-11666,1,1,13,11,24
kafka,PR-11610,3,2,21,2,23
kafka,PR-11571,13,9,129,11,140
kafka,PR-11566,8,11,136,28,164
kafka,PR-7082,5,2,36,0,36
kafka,PR-11606,5,6,179,119,298
kafka,PR-11657,3,14,1229,234,1463
kafka,PR-11657,4,14,1229,234,1463
kafka,PR-11667,1,6,122,93,215
kafka,PR-11668,1,2,58,26,84
kafka,PR-11600,6,5,164,80,244
kafka,PR-11634,4,1,180,118,298
kafka,PR-11669,1,1,6,7,13
kafka,PR-11670,1,1,1,1,2
kafka,PR-11671,1,3,37,4,41
kafka,PR-11566,9,11,136,28,164
kafka,PR-11671,2,3,37,4,41
kafka,PR-11672,1,15,1385,1782,3167
kafka,PR-11673,1,19,793,971,1764
kafka,PR-11571,14,9,103,11,114
kafka,PR-11672,2,15,1386,1785,3171
kafka,PR-11673,2,19,791,969,1760
kafka,PR-11675,1,2,22,2,24
kafka,PR-11550,3,72,1638,412,2050
kafka,PR-11657,5,16,1348,237,1585
kafka,PR-11661,5,37,26129,21,26150
kafka,PR-11658,7,37,26129,21,26150
kafka,PR-11666,2,1,10,11,21
kafka,PR-11671,3,3,37,4,41
kafka,PR-11452,10,9,421,318,739
kafka,PR-11571,15,9,103,11,114
kafka,PR-11566,10,11,136,28,164
kafka,PR-11677,1,73,1656,424,2080
kafka,PR-11677,2,70,1704,452,2156
kafka,PR-11669,2,1,6,7,13
kafka,PR-11600,8,6,207,94,301
kafka,PR-11678,1,15,504,401,905
kafka,PR-11657,6,18,1483,249,1732
kafka,PR-11679,1,2,2,2,4
kafka,PR-11600,9,6,215,94,309
kafka,PR-11658,8,38,26164,18,26182
kafka,PR-11661,6,40,26260,24,26284
kafka,PR-11658,9,40,26260,24,26284
kafka,PR-11676,4,40,253,128,381
kafka,PR-11676,5,40,253,128,381
kafka,PR-11390,31,43,2027,149,2176
kafka,PR-11665,2,1,11,3,14
kafka,PR-11676,6,40,341,128,469
kafka,PR-11390,32,43,2028,149,2177
kafka,PR-11665,3,1,11,3,14
kafka,PR-11676,7,40,364,128,492
kafka,PR-11665,4,1,11,3,14
kafka,PR-11680,1,1,3,9,12
kafka,PR-11665,5,1,11,3,14
kafka,PR-11665,6,1,11,3,14
kafka,PR-11657,7,18,1483,249,1732
kafka,PR-11452,11,9,421,318,739
kafka,PR-11657,8,22,1598,262,1860
kafka,PR-11616,4,7,38,30,68
kafka,PR-11661,7,39,26234,28,26262
kafka,PR-11661,8,40,26235,29,26264
kafka,PR-11681,1,4,32,11,43
kafka,PR-11681,2,4,32,11,43
kafka,PR-11456,16,2,312,23,335
kafka,PR-11657,9,23,1599,263,1862
kafka,PR-11665,7,1,11,3,14
kafka,PR-11390,33,43,2040,149,2189
kafka,PR-11683,1,4,239,26,265
kafka,PR-11676,8,41,544,128,672
kafka,PR-11683,2,5,251,33,284
kafka,PR-11682,2,16,117,17,134
kafka,PR-11684,1,3,0,116,116
kafka,PR-11390,34,43,2040,149,2189
kafka,PR-11456,17,2,332,22,354
kafka,PR-11390,35,43,2048,152,2200
kafka,PR-11600,10,7,272,95,367
kafka,PR-11600,11,7,264,92,356
kafka,PR-11686,1,7,321,103,424
kafka,PR-11390,36,43,2049,152,2201
kafka,PR-11600,12,6,218,91,309
kafka,PR-11676,9,41,571,128,699
kafka,PR-11686,2,7,326,103,429
kafka,PR-11687,1,1,14,15,29
kafka,PR-11610,4,2,20,2,22
kafka,PR-11682,3,15,88,17,105
kafka,PR-11610,5,2,18,1,19
kafka,PR-11676,10,42,1497,129,1626
kafka,PR-11682,4,26,260,100,360
kafka,PR-11390,37,43,2055,152,2207
kafka,PR-11657,10,23,1599,263,1862
kafka,PR-11688,1,14,200,80,280
kafka,PR-11676,11,44,1556,134,1690
kafka,PR-11606,6,6,181,119,300
kafka,PR-11689,1,4,71,5,76
kafka,PR-11690,1,2,91,1,92
kafka,PR-11686,3,4,108,12,120
kafka,PR-11493,4,2,195,61,256
kafka,PR-11689,2,4,70,5,75
kafka,PR-11687,2,1,14,15,29
kafka,PR-11689,3,4,70,6,76
kafka,PR-11686,4,8,188,241,429
kafka,PR-11452,12,9,421,318,739
kafka,PR-11691,1,9,261,112,373
kafka,PR-11671,4,3,37,4,41
kafka,PR-11691,2,9,208,91,299
kafka,PR-11676,12,44,1564,134,1698
kafka,PR-11610,6,2,18,1,19
kafka,PR-11682,5,26,260,100,360
kafka,PR-11615,2,2,25,0,25
kafka,PR-11671,5,3,37,4,41
kafka,PR-11688,2,14,301,81,382
kafka,PR-11682,6,26,257,107,364
kafka,PR-11615,3,2,24,0,24
kafka,PR-11682,7,29,284,107,391
kafka,PR-11675,2,2,22,2,24
kafka,PR-11692,1,1,1,1,2
kafka,PR-11676,13,44,1572,134,1706
kafka,PR-11683,3,5,259,33,292
kafka,PR-11693,1,9,185,187,372
kafka,PR-11676,14,47,1328,141,1469
kafka,PR-11694,1,2,7,3,10
kafka,PR-11687,3,1,18,19,37
kafka,PR-11657,11,23,1599,263,1862
kafka,PR-11345,31,14,120,38,158
kafka,PR-11683,4,5,260,33,293
kafka,PR-11657,12,23,1608,264,1872
kafka,PR-11691,3,20,238,102,340
kafka,PR-11691,4,20,282,117,399
kafka,PR-11692,2,1,1,1,2
kafka,PR-10851,23,19,1052,158,1210
kafka,PR-11683,5,6,229,35,264
kafka,PR-11686,6,10,297,294,591
kafka,PR-11665,8,1,58,43,101
kafka,PR-11692,3,1,1,1,2
kafka,PR-11676,15,47,1256,141,1397
kafka,PR-11661,9,42,26173,31,26204
kafka,PR-11691,5,19,282,116,398
kafka,PR-11676,16,47,1230,143,1373
kafka,PR-11676,17,47,1249,143,1392
kafka,PR-11695,1,2,138,15,153
kafka,PR-11657,13,23,1615,264,1879
kafka,PR-10851,24,19,1090,158,1248
kafka,PR-11689,5,4,61,6,67
kafka,PR-11696,1,1,6,0,6
kafka,PR-11657,14,22,1612,261,1873
kafka,PR-11534,3,54,591,675,1266
kafka,PR-11657,15,22,1620,261,1881
kafka,PR-11661,10,42,26167,25,26192
kafka,PR-11691,6,19,283,115,398
kafka,PR-11697,1,29,66,66,132
kafka,PR-11691,7,19,283,115,398
kafka,PR-11390,38,43,2057,155,2212
kafka,PR-11661,11,43,26240,28,26268
kafka,PR-11686,7,10,311,294,605
kafka,PR-11676,18,47,1251,145,1396
kafka,PR-11609,8,16,438,231,669
kafka,PR-11676,19,47,1277,145,1422
kafka,PR-10851,25,19,1104,158,1262
kafka,PR-11691,8,19,284,115,399
kafka,PR-11682,8,41,376,132,508
kafka,PR-11676,20,47,1333,145,1478
kafka,PR-10851,26,19,1104,158,1262
kafka,PR-11698,1,3,12,0,12
kafka,PR-11657,16,22,1616,261,1877
kafka,PR-11699,1,1,3,3,6
kafka,PR-11700,1,1,1,1,2
kafka,PR-11698,2,3,12,0,12
kafka,PR-11657,17,22,1612,263,1875
kafka,PR-11657,18,22,1617,266,1883
kafka,PR-11701,1,5,23,5,28
kafka,PR-11694,2,4,29,25,54
kafka,PR-11702,1,9,30,18,48
kafka,PR-11691,9,19,284,115,399
kafka,PR-11661,12,43,26255,31,26286
kafka,PR-11658,10,43,26255,31,26286
kafka,PR-10244,10,24,283,84,367
kafka,PR-11661,13,43,26255,31,26286
kafka,PR-11703,2,6,32,90,122
kafka,PR-11703,3,6,38,98,136
kafka,PR-11676,22,47,1339,145,1484
kafka,PR-11424,14,66,939,299,1238
kafka,PR-11697,2,25,56,56,112
kafka,PR-11704,1,8,29,29,58
kafka,PR-11676,23,47,1339,145,1484
kafka,PR-11676,24,46,1308,142,1450
kafka,PR-11424,15,66,939,299,1238
kafka,PR-11424,16,66,939,299,1238
kafka,PR-11609,9,17,449,239,688
kafka,PR-11686,8,10,311,294,605
kafka,PR-11390,39,43,2169,199,2368
kafka,PR-11609,10,17,453,241,694
kafka,PR-11686,9,10,311,294,605
kafka,PR-10851,27,19,1104,158,1262
kafka,PR-10851,28,19,1107,158,1265
kafka,PR-11682,9,41,376,132,508
kafka,PR-11390,40,43,2212,232,2444
kafka,PR-11682,10,41,414,132,546
kafka,PR-11706,1,1,1,1,2
kafka,PR-11390,41,43,2212,232,2444
kafka,PR-11707,1,1,24,0,24
kafka,PR-11703,5,7,49,113,162
kafka,PR-11708,1,1,1,1,2
kafka,PR-11609,11,17,454,244,698
kafka,PR-11709,1,1,1,1,2
kafka,PR-11676,26,46,1302,143,1445
kafka,PR-11345,32,14,118,38,156
kafka,PR-11710,1,1,8,8,16
kafka,PR-11455,4,4,23,9,32
kafka,PR-11711,1,2,44,5,49
kafka,PR-11455,5,4,27,7,34
kafka,PR-11609,14,19,627,283,910
kafka,PR-11694,3,4,31,30,61
kafka,PR-11584,4,3,103,17,120
kafka,PR-10851,29,19,1107,158,1265
kafka,PR-11695,2,2,138,15,153
kafka,PR-11682,11,44,438,135,573
kafka,PR-11599,3,7,41,9,50
kafka,PR-11702,3,10,115,18,133
kafka,PR-11686,12,10,314,298,612
kafka,PR-11712,1,4,157,4,161
kafka,PR-11713,1,4,17,18,35
kafka,PR-11584,5,3,103,17,120
kafka,PR-11508,3,3,151,2,153
kafka,PR-11714,1,3,81,8,89
kafka,PR-11682,13,45,441,127,568
kafka,PR-11705,4,21,617,122,739
kafka,PR-11705,5,20,624,98,722
kafka,PR-11705,6,20,951,98,1049
kafka,PR-11682,14,45,428,127,555
kafka,PR-11447,6,26,1077,152,1229
kafka,PR-11705,7,20,951,98,1049
kafka,PR-11715,1,1,2,2,4
kafka,PR-11691,10,19,284,114,398
kafka,PR-11693,2,9,185,187,372
kafka,PR-11716,3,14,2519,6,2525
kafka,PR-11382,8,5,90,9,99
kafka,PR-11676,27,26,1156,167,1323
kafka,PR-11676,28,30,1281,190,1471
kafka,PR-11716,4,14,2519,6,2525
kafka,PR-11717,1,2,0,6,6
kafka,PR-11599,4,7,42,9,51
kafka,PR-11382,9,5,94,11,105
kafka,PR-7898,25,89,2108,1485,3593
kafka,PR-10244,11,24,283,84,367
kafka,PR-7898,26,89,2108,1485,3593
kafka,PR-11345,35,14,119,38,157
kafka,PR-11424,17,66,966,297,1263
kafka,PR-11345,36,14,119,38,157
kafka,PR-11691,14,19,285,121,406
kafka,PR-11718,1,1,0,2,2
kafka,PR-10851,30,20,1264,173,1437
kafka,PR-11718,2,1,2,4,6
kafka,PR-11718,3,2,46,5,51
kafka,PR-11718,4,2,45,5,50
kafka,PR-11691,15,14,274,120,394
kafka,PR-11691,16,15,281,120,401
kafka,PR-11390,42,43,2218,237,2455
kafka,PR-11719,1,1,1,1,2
kafka,PR-11720,1,2,15,5,20
kafka,PR-11691,17,15,281,120,401
kafka,PR-11719,2,1,1,1,2
kafka,PR-11721,1,3,150,12,162
kafka,PR-11722,1,1,78,65,143
kafka,PR-11723,1,1,1,3,4
kafka,PR-11718,5,2,45,5,50
kafka,PR-11575,4,2,177,6,183
kafka,PR-11599,5,9,48,14,62
kafka,PR-11695,3,2,138,15,153
kafka,PR-11690,2,2,99,1,100
kafka,PR-11725,1,30,434,101,535
kafka,PR-11390,43,45,2514,239,2753
kafka,PR-11599,6,9,48,14,62
kafka,PR-11695,4,2,137,15,152
kafka,PR-11690,3,2,99,1,100
kafka,PR-11599,7,9,48,14,62
kafka,PR-11725,2,30,437,101,538
kafka,PR-11726,1,1,2,2,4
kafka,PR-11726,2,2,62,4,66
kafka,PR-7898,29,90,2116,1491,3607
kafka,PR-11656,3,1,3,3,6
kafka,PR-11727,1,1,3,3,6
kafka,PR-11689,6,4,62,6,68
kafka,PR-11729,1,1,1,1,2
kafka,PR-11677,3,71,1617,439,2056
kafka,PR-11721,4,3,158,12,170
kafka,PR-11677,4,70,1614,439,2053
kafka,PR-11730,1,3,32,3,35
kafka,PR-11730,2,2,3,3,6
kafka,PR-11390,44,45,2514,239,2753
kafka,PR-11726,3,2,58,4,62
kafka,PR-11390,45,45,2518,243,2761
kafka,PR-10851,31,20,1264,173,1437
kafka,PR-11688,3,14,301,81,382
kafka,PR-11672,3,15,1440,1787,3227
kafka,PR-11721,5,3,193,12,205
kafka,PR-11732,1,1,251,167,418
kafka,PR-11722,2,1,78,64,142
kafka,PR-11691,18,15,311,120,431
kafka,PR-11631,2,1,4,6,10
kafka,PR-10525,5,2,45,4,49
kafka,PR-11720,2,2,15,5,20
kafka,PR-11705,8,20,937,81,1018
kafka,PR-11705,9,19,936,80,1016
kafka,PR-11306,8,3,22,22,44
kafka,PR-11306,9,6,27,27,54
kafka,PR-11694,4,4,31,30,61
kafka,PR-11649,5,43,3244,63,3307
kafka,PR-11734,1,6,43,23,66
kafka,PR-11691,19,15,313,121,434
kafka,PR-11735,1,1,1,1,2
kafka,PR-11691,20,15,313,121,434
kafka,PR-11469,2,2,11,1,12
kafka,PR-11631,3,4,29,10,39
kafka,PR-11721,8,3,165,12,177
kafka,PR-11722,4,1,85,64,149
kafka,PR-11631,4,4,75,147,222
kafka,PR-11631,5,4,74,147,221
kafka,PR-11631,6,4,74,147,221
kafka,PR-11376,3,2,27,7,34
kafka,PR-11736,1,4,14,460,474
kafka,PR-11721,9,3,163,12,175
kafka,PR-11306,10,6,27,27,54
kafka,PR-10525,6,2,45,4,49
kafka,PR-11733,4,61,1102,590,1692
kafka,PR-10525,7,2,45,4,49
kafka,PR-11306,11,6,27,27,54
kafka,PR-11733,5,61,1098,590,1688
kafka,PR-11209,2,7,1168,87,1255
kafka,PR-11306,12,6,27,27,54
kafka,PR-11209,3,7,1212,87,1299
kafka,PR-10525,8,2,46,4,50
kafka,PR-11737,1,1,6,50,56
kafka,PR-11306,14,6,27,27,54
kafka,PR-11677,5,76,1707,907,2614
kafka,PR-11306,15,6,27,27,54
kafka,PR-11649,8,44,3660,263,3923
kafka,PR-11644,2,2,24,10,34
kafka,PR-11340,25,7,184,37,221
kafka,PR-11667,2,4,57,14,71
kafka,PR-11739,1,2,40,33,73
kafka,PR-11740,1,1,1,1,2
kafka,PR-11667,3,5,59,16,75
kafka,PR-11739,2,2,40,33,73
kafka,PR-10265,5,14,1122,8,1130
kafka,PR-11741,1,2,85,78,163
kafka,PR-11737,2,1,6,8,14
kafka,PR-10265,6,14,1122,8,1130
kafka,PR-11741,2,1,45,45,90
kafka,PR-11649,9,44,3681,263,3944
kafka,PR-11340,26,7,184,37,221
kafka,PR-11742,1,2,45,4,49
kafka,PR-11655,3,3,58,24,82
kafka,PR-11688,4,15,336,85,421
kafka,PR-11743,1,3,59,59,118
kafka,PR-11744,1,1,1,1,2
kafka,PR-11688,5,15,336,85,421
kafka,PR-11672,4,15,1440,1787,3227
kafka,PR-11742,2,2,45,4,49
kafka,PR-11667,4,7,110,24,134
kafka,PR-11688,6,15,335,85,420
kafka,PR-11688,7,15,335,85,420
kafka,PR-11743,2,3,59,59,118
kafka,PR-11673,3,19,813,997,1810
kafka,PR-11688,8,15,335,85,420
kafka,PR-11744,2,1,1,1,2
kafka,PR-11743,3,3,59,59,118
kafka,PR-11673,4,19,812,997,1809
kafka,PR-11534,4,54,591,675,1266
kafka,PR-11744,3,1,2,1,3
kafka,PR-11742,3,2,47,5,52
kafka,PR-11745,1,6,130,20,150
kafka,PR-11534,5,54,591,675,1266
kafka,PR-11742,4,2,47,5,52
kafka,PR-11546,3,1,7,0,7
kafka,PR-11667,5,7,109,24,133
kafka,PR-11655,4,3,46,16,62
kafka,PR-11603,6,2,59,1,60
kafka,PR-11616,5,8,38,34,72
kafka,PR-11534,6,54,592,676,1268
kafka,PR-11674,3,4,799,982,1781
kafka,PR-11616,6,7,36,32,68
kafka,PR-11492,2,1,5,2,7
kafka,PR-11746,1,1,1,1,2
kafka,PR-11492,3,4,25,19,44
kafka,PR-11688,9,15,344,84,428
kafka,PR-11558,2,1,5,5,10
kafka,PR-11747,1,12,88,76,164
kafka,PR-11584,7,5,150,37,187
kafka,PR-11732,2,1,253,168,421
kafka,PR-11478,9,6,100,10,110
kafka,PR-11747,2,13,141,76,217
kafka,PR-11616,7,7,36,32,68
kafka,PR-11534,7,54,592,676,1268
kafka,PR-11616,8,7,36,32,68
kafka,PR-11667,6,9,129,46,175
kafka,PR-11688,10,15,350,84,434
kafka,PR-11688,11,15,350,84,434
kafka,PR-11747,3,13,155,90,245
kafka,PR-11745,3,6,124,20,144
kafka,PR-11748,1,8,856,790,1646
kafka,PR-11749,1,10,23,33,56
kafka,PR-11748,2,7,147,81,228
kafka,PR-11667,7,10,135,54,189
kafka,PR-11603,9,2,50,1,51
kafka,PR-11616,9,7,38,34,72
kafka,PR-11667,8,10,128,52,180
kafka,PR-11616,10,7,38,34,72
kafka,PR-11751,1,1,4,3,7
kafka,PR-11750,3,5,123,23,146
kafka,PR-11746,2,1,1,1,2
kafka,PR-11746,3,1,1,0,1
kafka,PR-11753,1,6,87,72,159
kafka,PR-11688,12,15,350,85,435
kafka,PR-10832,2,1,6,6,12
kafka,PR-10851,32,20,1264,173,1437
kafka,PR-11579,6,2,21,2,23
kafka,PR-11755,1,1,4,4,8
kafka,PR-11751,2,1,4,3,7
kafka,PR-11756,1,76,181,251,432
kafka,PR-11757,1,1,19,0,19
kafka,PR-11751,3,1,4,3,7
kafka,PR-11757,2,1,19,0,19
kafka,PR-11758,1,1,5,3,8
kafka,PR-11759,1,1,105,8,113
kafka,PR-11759,2,1,109,10,119
kafka,PR-11667,9,10,128,52,180
kafka,PR-11667,10,11,130,52,182
kafka,PR-11667,11,11,130,52,182
kafka,PR-11760,1,4,182,48,230
kafka,PR-11761,1,1,15,0,15
kafka,PR-11754,2,1,7,15,22
kafka,PR-11762,1,1,9,3,12
kafka,PR-11763,1,1,0,2,2
kafka,PR-11764,1,1,1,1,2
kafka,PR-11616,11,7,41,34,75
kafka,PR-11752,2,5,34,47,81
kafka,PR-11750,6,7,166,58,224
kafka,PR-11762,2,1,9,3,12
kafka,PR-11766,1,6,5,175,180
kafka,PR-10907,18,122,11583,1884,13467
kafka,PR-11755,2,1,4,4,8
kafka,PR-11767,1,1,4,2,6
kafka,PR-11768,1,1,1,1,2
kafka,PR-11769,1,1,0,2,2
kafka,PR-11751,4,1,6,5,11
kafka,PR-11763,2,1,0,3,3
kafka,PR-10851,33,17,1264,130,1394
kafka,PR-11756,2,76,181,246,427
kafka,PR-10851,34,16,1258,123,1381
kafka,PR-11751,5,1,6,5,11
kafka,PR-11770,1,1,1,1,2
kafka,PR-11756,3,76,180,245,425
kafka,PR-11758,2,1,5,3,8
kafka,PR-11677,6,77,1732,914,2646
kafka,PR-11752,5,4,4,26,30
kafka,PR-11575,5,2,177,6,183
kafka,PR-11677,7,77,1778,928,2706
kafka,PR-11752,6,4,4,26,30
kafka,PR-11760,2,4,182,48,230
kafka,PR-11773,1,6,234,13,247
kafka,PR-11774,1,3,158,0,158
kafka,PR-11775,1,14,763,37,800
kafka,PR-11772,2,2,14,1,15
kafka,PR-11776,1,17,1196,102,1298
kafka,PR-11777,1,34,606,49,655
kafka,PR-11778,1,43,1385,164,1549
kafka,PR-11779,1,84,3704,417,4121
kafka,PR-11780,1,44,5638,1350,6988
kafka,PR-11781,1,48,6938,1417,8355
kafka,PR-11782,1,111,11334,1845,13179
kafka,PR-11783,1,116,11519,1895,13414
kafka,PR-11752,7,4,4,26,30
kafka,PR-11575,6,2,183,13,196
kafka,PR-11493,5,2,175,61,236
kafka,PR-11752,8,4,4,26,30
kafka,PR-10682,4,1,23,18,41
kafka,PR-11738,5,17,433,299,732
kafka,PR-11780,2,45,5640,1351,6991
kafka,PR-11781,2,49,6940,1418,8358
kafka,PR-11782,2,112,11336,1846,13182
kafka,PR-11783,2,117,11521,1896,13417
kafka,PR-11760,3,4,207,62,269
kafka,PR-11785,2,1,1,3,4
kafka,PR-11786,2,2,16,5,21
kafka,PR-10851,35,16,1237,121,1358
kafka,PR-10851,36,16,1237,121,1358
kafka,PR-11790,2,67,447,366,813
kafka,PR-11790,3,67,438,422,860
kafka,PR-11791,2,3,142,6,148
kafka,PR-11792,2,2,150,70,220
kafka,PR-11788,2,4,95,56,151
kafka,PR-11793,1,1,1,1,2
kafka,PR-11493,6,2,266,61,327
kafka,PR-11493,7,2,236,71,307
kafka,PR-11794,1,1,4,0,4
kafka,PR-11493,8,2,236,71,307
kafka,PR-10851,37,16,1296,121,1417
kafka,PR-11493,9,2,236,71,307
kafka,PR-10851,38,16,1295,121,1416
kafka,PR-11572,6,25,702,338,1040
kafka,PR-11572,7,25,702,338,1040
kafka,PR-11788,3,4,97,58,155
kafka,PR-11390,48,45,2520,267,2787
kafka,PR-11575,7,2,181,13,194
kafka,PR-11705,11,19,961,92,1053
kafka,PR-11575,8,2,200,17,217
kafka,PR-11795,2,3,29,18,47
kafka,PR-10851,39,16,1308,121,1429
kafka,PR-11575,9,2,200,21,221
kafka,PR-11733,6,60,1188,648,1836
kafka,PR-10851,40,16,1308,121,1429
kafka,PR-10851,41,16,1297,121,1418
kafka,PR-11733,8,61,1278,648,1926
kafka,PR-11791,3,3,142,6,148
kafka,PR-11493,10,2,236,71,307
kafka,PR-11787,3,6,297,8,305
kafka,PR-11791,4,3,145,6,151
kafka,PR-11797,1,6,252,14,266
kafka,PR-11790,4,70,442,445,887
kafka,PR-11791,6,4,153,8,161
kafka,PR-11788,4,4,96,58,154
kafka,PR-11791,8,4,158,8,166
kafka,PR-11787,4,6,298,8,306
kafka,PR-11787,5,6,303,13,316
kafka,PR-10851,42,16,1448,121,1569
kafka,PR-11499,3,1,69,0,69
kafka,PR-10851,43,16,1448,121,1569
kafka,PR-10851,44,16,1447,121,1568
kafka,PR-11733,9,61,1361,676,2037
kafka,PR-11797,2,8,254,55,309
kafka,PR-11799,1,1,18,13,31
kafka,PR-11790,5,70,442,446,888
kafka,PR-11788,5,4,118,67,185
kafka,PR-11800,1,7,65,2,67
kafka,PR-11787,7,10,508,101,609
kafka,PR-11800,2,7,76,6,82
kafka,PR-11787,8,8,307,101,408
kafka,PR-11800,3,7,145,15,160
kafka,PR-11733,10,61,1526,676,2202
kafka,PR-11733,11,61,1526,676,2202
kafka,PR-11797,3,8,254,55,309
kafka,PR-11787,9,8,307,101,408
kafka,PR-7082,6,2,36,0,36
kafka,PR-11801,1,2,4,5,9
kafka,PR-11804,1,2,5,5,10
kafka,PR-11733,12,61,1527,678,2205
kafka,PR-11804,2,2,5,5,10
kafka,PR-11805,1,5,50,14,64
kafka,PR-11733,13,61,1544,683,2227
kafka,PR-11777,2,34,606,49,655
kafka,PR-11800,4,7,150,15,165
kafka,PR-11800,5,7,142,15,157
kafka,PR-10851,45,16,1447,121,1568
kafka,PR-10802,11,11,133,34,167
kafka,PR-7082,7,2,36,0,36
kafka,PR-11803,5,3,79,0,79
kafka,PR-11705,12,30,973,105,1078
kafka,PR-11803,6,3,79,0,79
kafka,PR-11492,4,4,25,19,44
kafka,PR-7082,8,2,36,0,36
kafka,PR-11777,3,34,610,49,659
kafka,PR-11775,2,11,605,37,642
kafka,PR-11776,2,14,1038,102,1140
kafka,PR-11778,2,40,1227,164,1391
kafka,PR-11779,2,81,3546,417,3963
kafka,PR-11780,3,40,5468,1350,6818
kafka,PR-11781,3,44,6768,1417,8185
kafka,PR-11782,3,108,11164,1845,13009
kafka,PR-11783,3,113,11349,1895,13244
kafka,PR-11572,8,27,758,366,1124
kafka,PR-11733,14,65,1642,705,2347
kafka,PR-11806,1,3,107,9,116
kafka,PR-11797,4,8,294,55,349
kafka,PR-11804,3,2,8,6,14
kafka,PR-11572,9,27,762,367,1129
kafka,PR-11807,1,3,85,1,86
kafka,PR-11733,15,65,1687,707,2394
kafka,PR-7082,9,2,36,0,36
kafka,PR-11797,5,8,301,55,356
kafka,PR-11806,2,3,154,19,173
kafka,PR-11797,6,8,304,55,359
kafka,PR-11809,1,15,447,123,570
kafka,PR-11808,2,2,13,0,13
kafka,PR-11805,2,5,40,7,47
kafka,PR-11807,2,3,89,1,90
kafka,PR-11810,1,2,5,2,7
kafka,PR-11788,6,4,133,73,206
kafka,PR-11811,1,1,1,0,1
kafka,PR-11812,2,6,182,363,545
kafka,PR-11813,1,2,73,40,113
kafka,PR-11800,6,7,150,15,165
kafka,PR-11814,1,1,8,5,13
kafka,PR-11816,1,1,17,0,17
kafka,PR-11817,1,2,472,682,1154
kafka,PR-7082,10,2,36,0,36
kafka,PR-11796,3,70,944,196,1140
kafka,PR-11818,1,3,153,40,193
kafka,PR-7082,11,2,36,0,36
kafka,PR-11760,4,4,216,62,278
kafka,PR-11819,1,1,1,1,2
kafka,PR-11803,9,3,80,3,83
kafka,PR-11173,12,4,467,202,669
kafka,PR-11803,10,3,79,2,81
kafka,PR-11173,13,4,467,202,669
kafka,PR-10738,8,30,294,73,367
kafka,PR-11797,7,8,304,55,359
kafka,PR-11572,10,27,735,380,1115
kafka,PR-11813,2,2,89,41,130
kafka,PR-11809,2,15,448,123,571
kafka,PR-11809,3,15,448,123,571
kafka,PR-11812,3,6,184,363,547
kafka,PR-11821,1,1,27,4,31
kafka,PR-11812,4,6,184,363,547
kafka,PR-11822,1,15,1719,14,1733
kafka,PR-11173,14,3,394,199,593
kafka,PR-11821,2,1,27,4,31
kafka,PR-11812,5,6,184,363,547
kafka,PR-11823,1,1,11,2,13
kafka,PR-11822,2,18,2353,15,2368
kafka,PR-11824,1,1,10,10,20
kafka,PR-11815,2,4,13,31,44
kafka,PR-11824,2,1,16,14,30
kafka,PR-11822,3,22,3224,15,3239
kafka,PR-11821,3,1,29,4,33
kafka,PR-11681,3,3,17,9,26
kafka,PR-11681,4,3,18,9,27
kafka,PR-10738,9,32,330,92,422
kafka,PR-11821,5,1,39,4,43
kafka,PR-11823,2,1,11,2,13
kafka,PR-11828,1,1,8,10,18
kafka,PR-11821,6,1,39,4,43
kafka,PR-11797,8,8,302,55,357
kafka,PR-11788,7,4,137,76,213
kafka,PR-11777,5,34,611,50,661
kafka,PR-11773,2,6,234,13,247
kafka,PR-11821,7,2,46,9,55
kafka,PR-11773,3,6,235,13,248
kafka,PR-11827,2,1,46,39,85
kafka,PR-11830,1,3,17,12,29
kafka,PR-11813,5,2,97,42,139
kafka,PR-11827,3,1,112,99,211
kafka,PR-11827,4,1,113,99,212
kafka,PR-11831,1,1,5,3,8
kafka,PR-10851,46,16,1447,121,1568
kafka,PR-11833,1,1,18,0,18
kafka,PR-10738,10,34,339,102,441
kafka,PR-11832,4,1,18,20,38
kafka,PR-11833,2,1,18,0,18
kafka,PR-11832,5,1,18,20,38
kafka,PR-11572,11,27,729,380,1109
kafka,PR-11834,1,2,18,4,22
kafka,PR-11797,9,8,327,55,382
kafka,PR-11572,12,27,735,386,1121
kafka,PR-11833,3,1,18,0,18
kafka,PR-11811,2,1,1,0,1
kafka,PR-11809,5,15,476,123,599
kafka,PR-11821,8,2,46,9,55
kafka,PR-11811,3,1,1,0,1
kafka,PR-11835,1,5,88,39,127
kafka,PR-11788,8,5,141,80,221
kafka,PR-11517,4,1,0,8,8
kafka,PR-11797,11,8,365,55,420
kafka,PR-11788,9,4,137,76,213
kafka,PR-11813,6,2,97,42,139
kafka,PR-11836,1,2,19,4,23
kafka,PR-10802,12,11,132,34,166
kafka,PR-11813,7,2,97,42,139
kafka,PR-11831,2,1,4,3,7
kafka,PR-10802,13,11,132,34,166
kafka,PR-11517,5,1,0,8,8
kafka,PR-10738,11,34,339,102,441
kafka,PR-11833,4,1,18,0,18
kafka,PR-10738,12,34,339,102,441
kafka,PR-11773,4,6,235,13,248
kafka,PR-11776,3,14,1038,102,1140
kafka,PR-11778,3,40,1232,169,1401
kafka,PR-11779,3,48,2962,373,3335
kafka,PR-11780,4,40,5468,1350,6818
kafka,PR-11797,12,8,365,55,420
kafka,PR-11781,4,44,6768,1417,8185
kafka,PR-11782,4,75,10580,1801,12381
kafka,PR-11783,4,79,10763,1849,12612
kafka,PR-11838,2,1,3,0,3
kafka,PR-11839,1,1,1,0,1
kafka,PR-11773,5,6,235,13,248
kafka,PR-11840,1,22,135,134,269
kafka,PR-11797,13,8,371,55,426
kafka,PR-11842,1,2,19,4,23
kafka,PR-11843,1,1,3,3,6
kafka,PR-11797,14,8,385,55,440
kafka,PR-11844,1,1,3,0,3
kafka,PR-11797,15,8,400,55,455
kafka,PR-11821,9,3,98,23,121
kafka,PR-11475,2,2,3,7,10
kafka,PR-11830,2,3,17,12,29
kafka,PR-11830,3,3,17,12,29
kafka,PR-11797,16,8,398,55,453
kafka,PR-11845,1,2,40,55,95
kafka,PR-11173,15,3,400,199,599
kafka,PR-11842,4,1,11,4,15
kafka,PR-11846,1,1,1,0,1
kafka,PR-11833,5,1,18,0,18
kafka,PR-11816,2,1,17,0,17
kafka,PR-11847,1,4,53,34,87
kafka,PR-11797,17,8,398,55,453
kafka,PR-11841,3,2,6,5,11
kafka,PR-11797,18,8,407,55,462
kafka,PR-11841,4,2,7,5,12
kafka,PR-11797,19,8,402,55,457
kafka,PR-11848,1,1,58,70,128
kafka,PR-11851,1,1,1,1,2
kafka,PR-11852,1,1,1,0,1
kafka,PR-11841,5,2,7,5,12
kafka,PR-11841,6,2,7,5,12
kafka,PR-11841,7,2,7,5,12
kafka,PR-11853,1,1,9,4,13
kafka,PR-11853,2,2,13,9,22
kafka,PR-11733,16,65,1687,707,2394
kafka,PR-11854,3,27,938,177,1115
kafka,PR-11842,5,2,68,4,72
kafka,PR-11842,6,2,67,4,71
kafka,PR-11821,10,3,104,24,128
kafka,PR-11821,11,3,114,25,139
kafka,PR-11847,2,4,56,37,93
kafka,PR-11855,1,1,4,0,4
kafka,PR-11847,3,6,68,38,106
kafka,PR-11856,1,1,1,1,2
kafka,PR-11847,4,7,71,38,109
kafka,PR-11773,6,6,235,13,248
kafka,PR-11857,2,5,79,56,135
kafka,PR-11843,2,1,5,5,10
kafka,PR-11858,2,6,197,15,212
kafka,PR-11843,3,1,5,5,10
kafka,PR-11705,13,30,973,105,1078
kafka,PR-11864,1,2,17,0,17
kafka,PR-11805,3,5,40,7,47
kafka,PR-11843,4,1,5,5,10
kafka,PR-11173,16,3,401,196,597
kafka,PR-11861,1,1,3,1,4
kafka,PR-11865,1,1,2,2,4
kafka,PR-11864,2,2,17,0,17
kafka,PR-11864,3,2,19,2,21
kafka,PR-11821,12,3,118,26,144
kafka,PR-11867,1,1,3,2,5
kafka,PR-11211,8,10,259,113,372
kafka,PR-11821,13,3,125,26,151
kafka,PR-11867,2,3,11,7,18
kafka,PR-11796,5,71,1288,195,1483
kafka,PR-11865,2,1,12,12,24
kafka,PR-11869,1,1,2,2,4
kafka,PR-11866,4,1,6,3,9
kafka,PR-11870,1,1,2,2,4
kafka,PR-11797,20,8,402,55,457
kafka,PR-11802,8,13,2774,71,2845
kafka,PR-11871,1,2,13,8,21
kafka,PR-11873,1,2,6,8,14
kafka,PR-11874,1,2,6,4,10
kafka,PR-11796,6,71,1288,195,1483
kafka,PR-11864,4,2,17,4,21
kafka,PR-11796,7,71,1288,195,1483
kafka,PR-11802,11,17,2950,92,3042
kafka,PR-11855,2,1,9,0,9
kafka,PR-10802,14,11,132,34,166
kafka,PR-11868,3,4,114,82,196
kafka,PR-11873,2,2,6,8,14
kafka,PR-11865,3,1,12,12,24
kafka,PR-11873,3,2,6,8,14
kafka,PR-11876,1,1,1,1,2
kafka,PR-11877,1,2,38,0,38
kafka,PR-11878,1,1,27,28,55
kafka,PR-11879,1,1,0,1,1
kafka,PR-11842,7,2,67,4,71
kafka,PR-11880,1,1,3,3,6
kafka,PR-11881,1,1,1,2,3
kafka,PR-11882,1,1,3,2,5
kafka,PR-11837,2,1,9,0,9
kafka,PR-11883,1,2,2,2,4
kafka,PR-11884,1,2,3,3,6
kafka,PR-11881,2,1,2,3,5
kafka,PR-11433,4,3,190,1,191
kafka,PR-11886,1,3,42,2,44
kafka,PR-11760,5,4,217,62,279
kafka,PR-11887,1,1,55,103,158
kafka,PR-11855,3,2,84,0,84
kafka,PR-11855,4,2,84,0,84
kafka,PR-11733,17,65,1688,707,2395
kafka,PR-11888,1,1,1,1,2
kafka,PR-11817,4,3,484,798,1282
kafka,PR-11760,6,4,251,67,318
kafka,PR-11837,3,19,727,116,843
kafka,PR-11889,1,8,83,4,87
kafka,PR-11837,4,19,726,116,842
kafka,PR-11837,5,21,823,119,942
kafka,PR-11837,6,21,825,121,946
kafka,PR-11890,1,2,7,7,14
kafka,PR-11891,1,3,104,1,105
kafka,PR-11705,14,30,973,105,1078
kafka,PR-11892,1,2,77,2,79
kafka,PR-11893,1,10,500,98,598
kafka,PR-11888,2,1,1,1,2
kafka,PR-11894,1,2,101,22,123
kafka,PR-11895,1,5,12,3,15
kafka,PR-11705,15,30,973,105,1078
kafka,PR-11821,14,3,127,26,153
kafka,PR-11892,2,2,77,2,79
kafka,PR-11891,2,3,115,1,116
kafka,PR-11895,2,5,14,3,17
kafka,PR-11875,3,4,285,36,321
kafka,PR-11897,1,1,1,1,2
kafka,PR-11869,2,2,11,10,21
kafka,PR-11837,7,21,817,121,938
kafka,PR-11898,2,2,21,8,29
kafka,PR-11882,2,1,3,2,5
kafka,PR-11837,8,21,830,120,950
kafka,PR-11899,1,1,18,0,18
kafka,PR-11900,1,1,1,1,2
kafka,PR-11837,9,21,905,120,1025
kafka,PR-11869,3,2,11,10,21
kafka,PR-11901,1,2,15,7,22
kafka,PR-11837,10,21,915,120,1035
kafka,PR-11705,16,30,973,105,1078
kafka,PR-11891,3,3,115,1,116
kafka,PR-11835,2,5,88,41,129
kafka,PR-11901,2,2,15,7,22
kafka,PR-11705,17,30,973,105,1078
kafka,PR-11837,11,21,948,121,1069
kafka,PR-11891,4,3,117,1,118
kafka,PR-11902,1,1,5,1,6
kafka,PR-11796,8,71,1288,195,1483
kafka,PR-11705,18,30,973,105,1078
kafka,PR-11705,19,30,973,105,1078
kafka,PR-11796,9,71,1288,195,1483
kafka,PR-11903,1,1,7,0,7
kafka,PR-11898,3,2,21,8,29
kafka,PR-11821,15,3,127,26,153
kafka,PR-11705,20,30,1009,108,1117
kafka,PR-11471,2,3,25,32,57
kafka,PR-11837,12,21,947,121,1068
kafka,PR-11904,1,1,1,1,2
kafka,PR-11885,2,4,7,6,13
kafka,PR-11837,13,21,946,121,1067
kafka,PR-11905,1,1,1,1,2
kafka,PR-11906,1,1,1,1,2
kafka,PR-11837,14,21,947,121,1068
kafka,PR-10367,12,2,522,75,597
kafka,PR-11837,15,21,946,121,1067
kafka,PR-11893,2,12,652,218,870
kafka,PR-11908,1,1,2,2,4
kafka,PR-11821,16,3,128,27,155
kafka,PR-11909,1,2,14,0,14
kafka,PR-11430,6,2,52,5,57
kafka,PR-11579,7,2,21,2,23
kafka,PR-11471,3,3,21,33,54
kafka,PR-11822,4,25,5125,15,5140
kafka,PR-11173,17,3,417,196,613
kafka,PR-11822,5,30,5146,16,5162
kafka,PR-11910,1,3,214,120,334
kafka,PR-11911,1,2,72,0,72
kafka,PR-11471,4,3,26,45,71
kafka,PR-11912,1,3,3,3,6
kafka,PR-11173,18,3,415,196,611
kafka,PR-11913,1,5,11,36,47
kafka,PR-11822,6,30,5152,16,5168
kafka,PR-11909,2,2,14,0,14
kafka,PR-11912,2,4,19,8,27
kafka,PR-11914,1,1,0,1,1
kafka,PR-11904,2,1,1,1,2
kafka,PR-11733,18,65,1619,707,2326
kafka,PR-11905,2,2,2,2,4
kafka,PR-11893,4,12,707,221,928
kafka,PR-11893,5,12,727,220,947
kafka,PR-11908,2,4,35,14,49
kafka,PR-11786,3,2,12,5,17
kafka,PR-11893,6,12,727,220,947
kafka,PR-11915,1,1,1,1,2
kafka,PR-11908,3,5,39,16,55
kafka,PR-11910,2,3,217,120,337
kafka,PR-11822,7,31,7044,16,7060
kafka,PR-11908,4,5,50,16,66
kafka,PR-11822,8,31,7047,16,7063
kafka,PR-11916,1,2,8,5,13
kafka,PR-11912,3,4,19,8,27
kafka,PR-11916,2,3,12,19,31
kafka,PR-11912,4,4,24,10,34
kafka,PR-11912,5,4,24,10,34
kafka,PR-11908,5,5,49,16,65
kafka,PR-11908,6,5,54,16,70
kafka,PR-11893,7,12,754,231,985
kafka,PR-11908,7,5,56,17,73
kafka,PR-11792,4,4,225,140,365
kafka,PR-11918,1,4,14,2,16
kafka,PR-11821,17,3,170,38,208
kafka,PR-11879,2,1,0,1,1
kafka,PR-11879,3,1,0,1,1
kafka,PR-11919,1,1,2,7,9
kafka,PR-11920,1,1,0,1,1
kafka,PR-11920,2,2,9,7,16
kafka,PR-11888,3,2,39,1,40
kafka,PR-11898,4,2,21,9,30
kafka,PR-11898,5,2,21,8,29
kafka,PR-11822,9,32,7085,16,7101
kafka,PR-11921,1,1,9,9,18
kafka,PR-11796,10,71,1287,198,1485
kafka,PR-11922,1,1,1,1,2
kafka,PR-11923,1,4,43,2,45
kafka,PR-11924,1,1,2,2,4
kafka,PR-11900,2,1,1,1,2
kafka,PR-11900,4,3,55,1,56
kafka,PR-11908,8,6,57,17,74
kafka,PR-11925,1,8,15,11,26
kafka,PR-11912,6,5,90,10,100
kafka,PR-11912,7,5,90,10,100
kafka,PR-11926,1,6,78,43,121
kafka,PR-11923,2,4,50,2,52
kafka,PR-11892,3,2,112,0,112
kafka,PR-11920,3,2,9,7,16
kafka,PR-11927,1,1,0,2,2
kafka,PR-11928,1,2,305,1,306
kafka,PR-11929,1,1,18,0,18
kafka,PR-11922,2,2,4,4,8
kafka,PR-11927,2,1,0,2,2
kafka,PR-11930,1,1,4,4,8
kafka,PR-11922,3,2,4,4,8
kafka,PR-11929,2,1,15,0,15
kafka,PR-11931,1,1,31,30,61
kafka,PR-11927,3,1,0,2,2
kafka,PR-10967,2,2,6,2,8
kafka,PR-11932,1,2,4,0,4
kafka,PR-11933,1,5,34,1,35
kafka,PR-11933,2,5,30,1,31
kafka,PR-11920,4,2,9,7,16
kafka,PR-11933,3,6,38,1,39
kafka,PR-11935,1,3,2,70,72
kafka,PR-11936,1,2,13,2,15
kafka,PR-11933,4,6,38,1,39
kafka,PR-11927,4,1,0,2,2
kafka,PR-11920,5,2,10,8,18
kafka,PR-11937,1,1,20,18,38
kafka,PR-11920,6,2,13,10,23
kafka,PR-11927,5,1,0,2,2
kafka,PR-11935,2,3,2,70,72
kafka,PR-7898,33,90,2331,1538,3869
kafka,PR-11927,6,1,0,2,2
kafka,PR-11920,7,2,13,10,23
kafka,PR-11938,1,1,8,2,10
kafka,PR-11939,1,1,2,0,2
kafka,PR-11933,5,6,38,1,39
kafka,PR-11939,2,1,4,0,4
kafka,PR-11933,6,6,39,1,40
kafka,PR-11926,5,12,250,57,307
kafka,PR-11908,9,6,57,17,74
kafka,PR-11939,3,1,4,0,4
kafka,PR-11940,1,1,4,2,6
kafka,PR-11908,10,6,58,17,75
kafka,PR-11940,2,2,7,2,9
kafka,PR-11942,1,1,6,1,7
kafka,PR-11805,4,5,40,7,47
kafka,PR-11942,2,1,6,1,7
kafka,PR-11936,2,2,14,2,16
kafka,PR-11943,1,2,23,21,44
kafka,PR-11927,7,1,0,2,2
kafka,PR-11942,3,1,6,1,7
kafka,PR-11944,1,1,3,0,3
kafka,PR-11822,13,35,7626,56,7682
kafka,PR-11805,5,5,40,7,47
kafka,PR-11945,1,12,207,52,259
kafka,PR-11927,8,1,0,2,2
kafka,PR-11946,1,2,28,1,29
kafka,PR-11941,2,22,857,186,1043
kafka,PR-11792,5,4,272,195,467
kafka,PR-11942,4,2,58,8,66
kafka,PR-11760,7,4,251,67,318
kafka,PR-11936,3,2,16,1,17
kafka,PR-11760,8,4,301,67,368
kafka,PR-11947,1,1,4,2,6
kafka,PR-11936,4,2,16,1,17
kafka,PR-11842,8,2,67,4,71
kafka,PR-11822,14,35,7628,60,7688
kafka,PR-11927,9,1,0,2,2
kafka,PR-11948,1,1,5,3,8
kafka,PR-11949,1,1,2,5,7
kafka,PR-11936,5,2,16,1,17
kafka,PR-11945,2,11,497,60,557
kafka,PR-11942,5,3,13,5,18
kafka,PR-11948,2,1,4,2,6
kafka,PR-11927,10,1,0,2,2
kafka,PR-10738,13,35,451,115,566
kafka,PR-11942,6,2,67,2,69
kafka,PR-11950,1,3,96,17,113
kafka,PR-11927,11,1,0,2,2
kafka,PR-11858,4,9,228,0,228
kafka,PR-11942,7,2,70,9,79
kafka,PR-11908,11,7,64,20,84
kafka,PR-11952,1,3,129,10,139
kafka,PR-11950,2,3,96,17,113
kafka,PR-11951,1,6,38,14,52
kafka,PR-9770,2,18,2402,19,2421
kafka,PR-11953,1,2,93,4,97
kafka,PR-9770,3,19,2406,19,2425
kafka,PR-11953,2,2,97,4,101
kafka,PR-11951,2,6,38,14,52
kafka,PR-11951,3,8,65,30,95
kafka,PR-9770,4,21,2433,35,2468
kafka,PR-11917,2,14,1773,337,2110
kafka,PR-11954,1,1,1,1,2
kafka,PR-11951,4,8,77,42,119
kafka,PR-9770,5,20,2441,47,2488
kafka,PR-11942,8,2,70,9,79
kafka,PR-11942,9,2,71,9,80
kafka,PR-9770,6,25,2452,54,2506
kafka,PR-11760,9,4,303,67,370
kafka,PR-9770,8,26,2453,54,2507
kafka,PR-11951,6,7,62,39,101
kafka,PR-11942,10,2,74,9,83
kafka,PR-11942,11,2,75,9,84
kafka,PR-9770,11,24,2434,51,2485
kafka,PR-11951,7,7,62,39,101
kafka,PR-11923,3,4,60,2,62
kafka,PR-11945,4,15,722,67,789
kafka,PR-11955,1,2,69,1,70
kafka,PR-11956,1,3,6,5,11
kafka,PR-9770,12,24,2434,51,2485
kafka,PR-11942,12,2,75,9,84
kafka,PR-11743,4,4,60,59,119
kafka,PR-11957,1,9,157,157,314
kafka,PR-11923,4,4,60,2,62
kafka,PR-11953,3,3,119,10,129
kafka,PR-11743,5,4,67,61,128
kafka,PR-11957,2,10,164,163,327
kafka,PR-11958,1,1,5,3,8
kafka,PR-11941,3,22,907,193,1100
kafka,PR-11951,8,7,62,39,101
kafka,PR-11829,5,12,878,99,977
kafka,PR-9500,2,12,2455,7,2462
kafka,PR-11953,4,3,111,10,121
kafka,PR-9500,3,14,2455,397,2852
kafka,PR-11941,4,22,907,193,1100
kafka,PR-11953,5,3,116,10,126
kafka,PR-9500,4,24,5175,397,5572
kafka,PR-11743,7,4,68,61,129
kafka,PR-11960,1,1,2,0,2
kafka,PR-11961,1,4,6,25,31
kafka,PR-9500,5,24,5175,397,5572
kafka,PR-11962,1,1,2,1,3
kafka,PR-11953,6,3,128,7,135
kafka,PR-11963,1,1,4,2,6
kafka,PR-11211,9,14,390,204,594
kafka,PR-11936,6,2,13,2,15
kafka,PR-11923,5,4,60,2,62
kafka,PR-9500,6,24,5175,397,5572
kafka,PR-11956,2,4,8,5,13
kafka,PR-11965,1,2,59,2,61
kafka,PR-11936,7,2,13,2,15
kafka,PR-11967,1,1,1,1,2
kafka,PR-11966,2,5,176,49,225
kafka,PR-11968,1,1,5,0,5
kafka,PR-11829,6,12,878,99,977
kafka,PR-11966,3,5,180,49,229
kafka,PR-11966,4,5,180,49,229
kafka,PR-11959,3,7,85,54,139
kafka,PR-11969,1,22,576,373,949
kafka,PR-11950,3,3,96,17,113
kafka,PR-11908,12,7,69,20,89
kafka,PR-11959,4,8,110,54,164
kafka,PR-11908,13,7,73,20,93
kafka,PR-11959,5,8,108,54,162
kafka,PR-11908,14,6,57,17,74
kafka,PR-11962,2,1,2,1,3
kafka,PR-11959,6,9,114,113,227
kafka,PR-11963,2,1,5,2,7
kafka,PR-11959,7,9,114,113,227
kafka,PR-11743,8,4,9,6,15
kafka,PR-11953,7,3,128,7,135
kafka,PR-11971,1,5,97,24,121
kafka,PR-11967,2,1,1,1,2
kafka,PR-11963,3,1,6,2,8
kafka,PR-11962,3,2,3,2,5
kafka,PR-11953,8,3,140,7,147
kafka,PR-11743,9,4,9,6,15
kafka,PR-11971,2,5,97,24,121
kafka,PR-11962,4,2,3,2,5
kafka,PR-11743,10,4,9,6,15
kafka,PR-11972,1,2,2,2,4
kafka,PR-11963,4,1,6,2,8
kafka,PR-11953,9,3,140,7,147
kafka,PR-11928,2,2,305,1,306
kafka,PR-11973,1,1,1,1,2
kafka,PR-11965,2,2,59,2,61
kafka,PR-11953,10,3,144,8,152
kafka,PR-11928,3,2,305,1,306
kafka,PR-11936,8,2,13,2,15
kafka,PR-11970,3,38,420,117,537
kafka,PR-11953,11,3,144,8,152
kafka,PR-11829,7,12,842,99,941
kafka,PR-11971,3,5,108,27,135
kafka,PR-11974,1,1,531,605,1136
kafka,PR-11953,12,3,147,9,156
kafka,PR-11941,5,22,899,193,1092
kafka,PR-11965,3,3,98,2,100
kafka,PR-11972,2,2,2,2,4
kafka,PR-11965,4,3,98,2,100
kafka,PR-11935,3,3,2,70,72
kafka,PR-11935,4,3,2,70,72
kafka,PR-11896,2,22,2089,341,2430
kafka,PR-11971,4,5,101,25,126
kafka,PR-11953,13,3,145,9,154
kafka,PR-11975,1,1,3,3,6
kafka,PR-11976,1,1,2,2,4
kafka,PR-11977,1,1,8,0,8
kafka,PR-11965,5,3,70,4,74
kafka,PR-11971,5,5,101,25,126
kafka,PR-11965,6,3,70,4,74
kafka,PR-11953,14,3,145,9,154
kafka,PR-11935,5,3,2,70,72
kafka,PR-11945,5,15,721,80,801
kafka,PR-11978,1,1,3,1,4
kafka,PR-11979,1,2,5,15,20
kafka,PR-11955,2,2,69,1,70
kafka,PR-11965,7,3,70,4,74
kafka,PR-11829,8,12,842,99,941
kafka,PR-11917,3,14,1773,337,2110
kafka,PR-11896,3,22,2089,341,2430
kafka,PR-11980,1,2,305,1,306
kafka,PR-11969,2,23,727,405,1132
kafka,PR-11935,6,3,2,70,72
kafka,PR-11981,1,2,12,6,18
kafka,PR-11978,2,1,2,1,3
kafka,PR-11910,4,5,246,122,368
kafka,PR-11979,2,2,5,15,20
kafka,PR-9500,7,24,5175,397,5572
kafka,PR-9500,8,12,4680,126,4806
kafka,PR-11910,5,5,246,122,368
kafka,PR-11982,1,1,14,10,24
kafka,PR-11983,1,3,730,863,1593
kafka,PR-11984,1,4,9,9,18
kafka,PR-11896,4,10,1247,242,1489
kafka,PR-9500,9,12,4680,126,4806
kafka,PR-11910,7,5,246,122,368
kafka,PR-9500,10,12,4698,126,4824
kafka,PR-11986,1,29,222,134,356
kafka,PR-11985,3,3,11,4,15
kafka,PR-11987,1,1,1,1,2
kafka,PR-11988,1,1,1,1,2
kafka,PR-11985,4,5,23,5,28
kafka,PR-11985,5,5,36,5,41
kafka,PR-11991,1,2,63,2,65
kafka,PR-11992,1,1,1,1,2
kafka,PR-11993,4,49,1389,309,1698
kafka,PR-11965,8,3,70,4,74
kafka,PR-11991,2,2,63,2,65
kafka,PR-11965,9,3,70,4,74
kafka,PR-11965,10,3,68,3,71
kafka,PR-11984,2,4,9,9,18
kafka,PR-11994,1,1,3,0,3
kafka,PR-11390,49,46,2535,262,2797
kafka,PR-11974,2,1,575,652,1227
kafka,PR-11993,6,49,1563,354,1917
kafka,PR-11995,1,3,333,9,342
kafka,PR-11996,1,1,4,0,4
kafka,PR-11991,3,2,70,2,72
kafka,PR-11390,50,46,2532,262,2794
kafka,PR-11974,3,1,574,652,1226
kafka,PR-11983,2,3,769,905,1674
kafka,PR-11984,3,4,9,9,18
kafka,PR-11974,4,1,618,683,1301
kafka,PR-11896,5,12,1829,241,2070
kafka,PR-11997,1,1,1,1,2
kafka,PR-11998,1,2,11,3,14
kafka,PR-11999,1,2,11,9,20
kafka,PR-11980,2,2,305,1,306
kafka,PR-11998,2,2,11,3,14
kafka,PR-11997,2,1,1,1,2
kafka,PR-11842,10,2,67,4,71
kafka,PR-12000,1,5,15,15,30
kafka,PR-11432,3,42,291,153,444
kafka,PR-12001,1,1,16,0,16
kafka,PR-12000,2,5,17,13,30
kafka,PR-12002,1,2,3,3,6
kafka,PR-11984,4,4,9,9,18
kafka,PR-12003,1,1,115,47,162
kafka,PR-12004,1,2,23,21,44
kafka,PR-11998,3,2,11,3,14
kafka,PR-11998,4,2,11,3,14
kafka,PR-12005,3,14,1022,742,1764
kafka,PR-12006,1,1,1,1,2
kafka,PR-12007,1,2,3,3,6
kafka,PR-11955,3,2,69,1,70
kafka,PR-12007,2,2,3,3,6
kafka,PR-12008,1,2,12,10,22
kafka,PR-12007,3,2,3,3,6
kafka,PR-12009,1,2,3,3,6
kafka,PR-12010,1,24,320,9,329
kafka,PR-12007,4,2,3,3,6
kafka,PR-12011,1,1,12,2,14
kafka,PR-12010,2,24,324,13,337
kafka,PR-12012,1,1,12,2,14
kafka,PR-12013,2,5,14,15,29
kafka,PR-12014,1,1,2,2,4
kafka,PR-12013,3,5,14,15,29
kafka,PR-12006,2,1,1,1,2
kafka,PR-12015,1,1,17,13,30
kafka,PR-12016,1,1,11,6,17
kafka,PR-12010,3,24,320,13,333
kafka,PR-12017,1,3,158,5,163
kafka,PR-12017,2,2,30,3,33
kafka,PR-11983,3,3,312,383,695
kafka,PR-12018,1,2,5,6,11
kafka,PR-12019,1,8,1144,942,2086
kafka,PR-11986,2,30,313,188,501
kafka,PR-12020,1,4,411,10,421
kafka,PR-12017,3,2,30,3,33
kafka,PR-11986,3,30,314,190,504
kafka,PR-12013,4,5,14,15,29
kafka,PR-12021,1,1,9,9,18
kafka,PR-12020,2,4,409,10,419
kafka,PR-12022,1,1,0,8,8
kafka,PR-12012,2,1,12,2,14
kafka,PR-12012,3,1,12,2,14
kafka,PR-12013,5,5,14,15,29
kafka,PR-12024,1,4,344,291,635
kafka,PR-11644,3,2,24,10,34
kafka,PR-11993,7,49,1563,354,1917
kafka,PR-12025,1,1,3,1,4
kafka,PR-12023,4,7,839,1122,1961
kafka,PR-12026,1,1,1,1,2
kafka,PR-12019,2,8,1273,975,2248
kafka,PR-12022,2,1,0,8,8
kafka,PR-12027,1,1,1,1,2
kafka,PR-12013,6,5,14,15,29
kafka,PR-12028,1,1,2,2,4
kafka,PR-12029,1,4,12,10,22
kafka,PR-12013,7,5,14,15,29
kafka,PR-12030,1,11,2227,45,2272
kafka,PR-11896,6,12,1829,241,2070
kafka,PR-11917,4,14,1773,337,2110
kafka,PR-12031,1,5,341,69,410
kafka,PR-12020,3,4,409,10,419
kafka,PR-12031,2,5,341,69,410
kafka,PR-11993,8,51,1959,354,2313
kafka,PR-11896,8,22,4111,296,4407
kafka,PR-12032,1,2,289,59,348
kafka,PR-12033,1,22,886,372,1258
kafka,PR-12031,3,5,343,69,412
kafka,PR-11644,4,2,24,10,34
kafka,PR-12028,2,1,2,2,4
kafka,PR-12027,2,2,15,8,23
kafka,PR-12027,3,2,15,8,23
kafka,PR-12013,8,5,11,12,23
kafka,PR-12019,3,8,1273,975,2248
kafka,PR-12034,1,15,309,91,400
kafka,PR-12013,9,5,11,12,23
kafka,PR-12035,1,2,196,0,196
kafka,PR-12013,10,5,11,12,23
kafka,PR-12018,2,2,5,6,11
kafka,PR-12033,2,24,909,382,1291
kafka,PR-12030,2,11,2230,44,2274
kafka,PR-11916,3,3,12,19,31
kafka,PR-12005,4,14,1001,721,1722
kafka,PR-11917,5,14,1773,337,2110
kafka,PR-12031,4,5,347,69,416
kafka,PR-11896,11,22,4134,295,4429
kafka,PR-12038,1,1,0,1,1
kafka,PR-12039,1,43,101,83,184
kafka,PR-12005,5,14,1087,784,1871
kafka,PR-11985,6,5,24,5,29
kafka,PR-12040,1,1,8,0,8
kafka,PR-12019,4,8,1273,975,2248
kafka,PR-11896,12,22,4133,295,4428
kafka,PR-11914,2,2,3,3,6
kafka,PR-11773,7,6,235,13,248
kafka,PR-12041,1,1,7,2,9
kafka,PR-12010,4,24,319,14,333
kafka,PR-12029,2,5,72,53,125
kafka,PR-12042,1,1,2,1,3
kafka,PR-12043,1,2,26,13,39
kafka,PR-12018,3,2,5,6,11
kafka,PR-12013,11,5,11,12,23
kafka,PR-12045,1,12,282,95,377
kafka,PR-12046,1,22,213,27,240
kafka,PR-12038,2,1,1,2,3
kafka,PR-10967,3,2,6,2,8
kafka,PR-12036,3,48,910,838,1748
kafka,PR-12036,4,49,1010,838,1848
kafka,PR-11775,8,11,597,37,634
kafka,PR-12047,1,1,3,0,3
kafka,PR-12024,2,4,344,294,638
kafka,PR-12024,3,4,289,221,510
kafka,PR-12013,12,5,11,12,23
kafka,PR-12048,1,1,1,1,2
kafka,PR-11478,10,6,103,13,116
kafka,PR-12013,13,5,11,12,23
kafka,PR-12036,6,50,1027,865,1892
kafka,PR-12049,1,17,1568,313,1881
kafka,PR-11945,6,15,455,66,521
kafka,PR-12050,1,46,881,123,1004
kafka,PR-12030,3,11,2230,44,2274
kafka,PR-11945,7,15,458,67,525
kafka,PR-12052,1,1,1,0,1
kafka,PR-12024,4,4,289,221,510
kafka,PR-12053,1,2,19,4,23
kafka,PR-12054,1,1,1,1,2
kafka,PR-12055,1,2,44,1,45
kafka,PR-12024,5,4,289,221,510
kafka,PR-12056,1,1,1,1,2
kafka,PR-12054,2,1,1,1,2
kafka,PR-12057,1,1,1,1,2
kafka,PR-12058,1,40,128,132,260
kafka,PR-12050,2,43,889,118,1007
kafka,PR-12033,4,34,1189,485,1674
kafka,PR-12029,3,5,111,62,173
kafka,PR-12030,7,11,2262,43,2305
kafka,PR-11896,13,22,4167,294,4461
kafka,PR-12033,5,34,1190,486,1676
kafka,PR-12038,3,1,1,3,4
kafka,PR-12059,1,1,6,0,6
kafka,PR-12060,1,1,3,0,3
kafka,PR-12061,1,1,1,1,2
kafka,PR-12010,5,23,288,13,301
kafka,PR-12050,5,44,889,119,1008
kafka,PR-12003,2,1,115,47,162
kafka,PR-11681,5,3,18,9,27
kafka,PR-12063,1,5,168,32,200
kafka,PR-12064,1,1,4,5,9
kafka,PR-12010,6,23,293,13,306
kafka,PR-12063,2,5,152,31,183
kafka,PR-11681,6,3,19,13,32
kafka,PR-12065,1,2,209,20,229
kafka,PR-11919,2,1,7,2,9
kafka,PR-12000,3,3,3,3,6
kafka,PR-12065,2,3,211,22,233
kafka,PR-12063,3,5,162,32,194
kafka,PR-12060,2,1,5,2,7
kafka,PR-11993,11,51,2037,376,2413
kafka,PR-12068,1,1,28,28,56
kafka,PR-11951,10,9,214,49,263
kafka,PR-12065,3,3,211,22,233
kafka,PR-12058,2,40,126,130,256
kafka,PR-12063,4,5,162,32,194
kafka,PR-12050,7,45,892,122,1014
kafka,PR-12004,3,2,24,22,46
kafka,PR-12058,3,39,121,125,246
kafka,PR-12071,2,35,197,192,389
kafka,PR-12050,9,45,892,122,1014
kafka,PR-12010,9,20,272,10,282
kafka,PR-12010,10,20,205,10,215
kafka,PR-12050,13,46,894,122,1016
kafka,PR-12073,2,4,26,0,26
kafka,PR-12074,1,1,9,8,17
kafka,PR-12064,4,3,15,7,22
kafka,PR-12050,14,46,894,122,1016
kafka,PR-12075,1,4,48,7,55
kafka,PR-12069,1,1,2,2,4
kafka,PR-12076,1,1,2,2,4
kafka,PR-12077,1,2,11,3,14
kafka,PR-12078,1,1,3,3,6
kafka,PR-12016,2,1,11,6,17
kafka,PR-12028,3,1,2,2,4
kafka,PR-12079,1,1,1,1,2
kafka,PR-12066,8,2,75,6,81
kafka,PR-12080,1,2,42,4,46
kafka,PR-12016,3,1,11,6,17
kafka,PR-12081,1,7,701,246,947
kafka,PR-12071,3,35,197,192,389
kafka,PR-12071,4,35,197,192,389
kafka,PR-12050,15,45,893,122,1015
kafka,PR-12071,5,35,200,192,392
kafka,PR-12072,4,57,834,451,1285
kafka,PR-12082,1,12,536,457,993
kafka,PR-11951,11,8,152,32,184
kafka,PR-12010,11,22,309,10,319
kafka,PR-12072,5,57,1148,449,1597
kafka,PR-12071,6,35,214,206,420
kafka,PR-12084,1,4,94,18,112
kafka,PR-10738,15,35,451,115,566
kafka,PR-12010,12,22,309,10,319
kafka,PR-12050,16,45,893,122,1015
kafka,PR-12012,4,2,20,3,23
kafka,PR-12085,1,39,1247,468,1715
kafka,PR-12086,1,1,1,1,2
kafka,PR-12072,6,60,1317,449,1766
kafka,PR-12012,5,2,19,2,21
kafka,PR-12064,5,3,15,7,22
kafka,PR-11732,3,2,255,169,424
kafka,PR-12082,2,12,538,460,998
kafka,PR-12064,6,3,15,7,22
kafka,PR-12064,7,3,15,7,22
kafka,PR-12064,8,3,15,7,22
kafka,PR-12089,1,25,121,119,240
kafka,PR-12032,2,2,286,59,345
kafka,PR-11951,12,8,152,32,184
kafka,PR-12029,4,5,114,61,175
kafka,PR-12081,2,7,655,247,902
kafka,PR-12090,1,1,2,2,4
kafka,PR-12087,2,1,169,0,169
kafka,PR-12091,1,1,2,2,4
kafka,PR-12089,2,25,152,150,302
kafka,PR-12032,3,2,285,59,344
kafka,PR-12070,1,2,9,18,27
kafka,PR-12077,2,2,11,3,14
kafka,PR-12070,2,2,10,17,27
kafka,PR-12092,2,2,75,6,81
kafka,PR-12090,2,2,10,10,20
kafka,PR-12092,3,1,19,7,26
kafka,PR-12093,1,9,201,19,220
kafka,PR-12091,2,1,2,2,4
kafka,PR-12053,2,2,14,4,18
kafka,PR-12053,3,2,13,7,20
kafka,PR-12087,3,1,177,0,177
kafka,PR-11211,11,14,410,206,616
kafka,PR-11211,12,15,514,250,764
kafka,PR-11983,4,3,324,383,707
kafka,PR-12072,8,72,1382,507,1889
kafka,PR-12064,9,3,15,7,22
kafka,PR-12089,3,26,153,151,304
kafka,PR-12072,9,73,1385,1294,2679
kafka,PR-11732,4,2,15,10,25
kafka,PR-12064,10,3,15,7,22
kafka,PR-11732,5,1,12,8,20
kafka,PR-12094,1,4,8,8,16
kafka,PR-12072,10,73,1385,1294,2679
kafka,PR-12072,11,73,1395,1294,2689
kafka,PR-11438,2,1,11,5,16
kafka,PR-12065,4,3,212,15,227
kafka,PR-12095,1,2,64,0,64
kafka,PR-10738,16,35,470,125,595
kafka,PR-12072,12,73,1395,1294,2689
kafka,PR-12096,1,1,2,5,7
kafka,PR-12097,1,3,154,105,259
kafka,PR-12072,13,73,1414,1294,2708
kafka,PR-12072,14,73,1413,1294,2707
kafka,PR-12098,2,1,30,19,49
kafka,PR-12072,15,73,1375,1294,2669
kafka,PR-12099,1,1,1,1,2
kafka,PR-11896,14,13,1914,259,2173
kafka,PR-12100,1,13,1914,259,2173
kafka,PR-11955,4,2,75,1,76
kafka,PR-12101,1,1,1,1,2
kafka,PR-12038,4,1,1,3,4
kafka,PR-12072,16,73,1372,1294,2666
kafka,PR-12102,1,1,3,2,5
kafka,PR-12098,3,2,31,20,51
kafka,PR-12098,4,2,31,20,51
kafka,PR-12096,2,1,8,5,13
kafka,PR-12029,6,5,135,61,196
kafka,PR-12098,5,2,34,22,56
kafka,PR-12103,2,4,86,38,124
kafka,PR-12104,1,1,9,3,12
kafka,PR-11955,5,2,75,1,76
kafka,PR-12096,3,1,8,5,13
kafka,PR-12029,7,5,134,65,199
kafka,PR-12097,2,3,160,108,268
kafka,PR-11983,5,8,486,397,883
kafka,PR-12106,1,8,67,20,87
kafka,PR-12005,6,17,1395,1011,2406
kafka,PR-12072,17,73,1391,1299,2690
kafka,PR-7898,34,91,2393,1544,3937
kafka,PR-12029,8,5,131,65,196
kafka,PR-12029,9,5,118,57,175
kafka,PR-12005,7,17,1419,1011,2430
kafka,PR-12107,1,1,2,2,4
kafka,PR-12072,18,73,1381,1299,2680
kafka,PR-12108,1,3,60,21,81
kafka,PR-12067,4,9,99,16,115
kafka,PR-12109,1,3,83,16,99
kafka,PR-12110,1,2,395,247,642
kafka,PR-12056,2,1,1,2,3
kafka,PR-12111,1,1,0,1,1
kafka,PR-12110,2,2,409,254,663
kafka,PR-12109,2,3,98,18,116
kafka,PR-12112,1,1,5,2,7
kafka,PR-11889,2,13,89,12,101
kafka,PR-12110,3,2,408,254,662
kafka,PR-12109,3,3,98,18,116
kafka,PR-12104,2,9,131,35,166
kafka,PR-12104,3,1,9,3,12
kafka,PR-12113,1,5,19,19,38
kafka,PR-11916,4,5,14,21,35
kafka,PR-12045,2,5,215,79,294
kafka,PR-12114,1,1,5,1,6
kafka,PR-12072,19,74,1407,1299,2706
kafka,PR-12072,20,74,1407,1299,2706
kafka,PR-12045,3,5,212,78,290
kafka,PR-12114,2,1,7,1,8
kafka,PR-12106,2,8,129,38,167
kafka,PR-12106,3,8,149,38,187
kafka,PR-12100,2,13,1914,259,2173
kafka,PR-11896,15,13,1914,259,2173
kafka,PR-12115,1,1,4,1,5
kafka,PR-12100,3,13,1914,259,2173
kafka,PR-11896,16,13,1914,259,2173
kafka,PR-11983,6,10,563,479,1042
kafka,PR-12106,4,8,134,43,177
kafka,PR-12062,3,23,409,569,978
kafka,PR-12116,1,3,42,118,160
kafka,PR-12106,5,8,132,43,175
kafka,PR-12117,1,1,7,1,8
kafka,PR-11983,7,11,572,479,1051
kafka,PR-12118,1,1,1,1,2
kafka,PR-12106,6,8,139,44,183
kafka,PR-11874,2,2,6,5,11
kafka,PR-12119,1,1,1,1,2
kafka,PR-12116,2,4,42,120,162
kafka,PR-12108,2,3,60,21,81
kafka,PR-12109,4,3,97,18,115
kafka,PR-11874,3,2,7,6,13
kafka,PR-12010,13,21,255,9,264
kafka,PR-12110,4,2,464,259,723
kafka,PR-12106,7,8,139,44,183
kafka,PR-12108,3,3,111,28,139
kafka,PR-12062,4,23,403,560,963
kafka,PR-12062,5,23,403,560,963
kafka,PR-12110,5,2,476,262,738
kafka,PR-12104,4,1,10,3,13
kafka,PR-11211,13,15,514,250,764
kafka,PR-12121,1,3,109,6,115
kafka,PR-12123,1,45,893,122,1015
kafka,PR-12049,6,27,1569,360,1929
kafka,PR-12049,7,27,1571,360,1931
kafka,PR-12108,4,4,153,26,179
kafka,PR-9500,12,6,1470,0,1470
kafka,PR-12085,2,4,388,78,466
kafka,PR-12125,1,4,88,2,90
kafka,PR-12085,3,4,505,79,584
kafka,PR-12122,3,8,313,132,445
kafka,PR-12108,5,5,155,30,185
kafka,PR-12050,17,52,1222,174,1396
kafka,PR-12127,1,21,1757,285,2042
kafka,PR-12005,9,17,1411,1011,2422
kafka,PR-12128,1,6,804,6,810
kafka,PR-12112,2,2,32,6,38
kafka,PR-12129,1,1,2,2,4
kafka,PR-12122,4,8,344,139,483
kafka,PR-12010,14,22,251,10,261
kafka,PR-12130,1,1,1,1,2
kafka,PR-12131,1,2,24,15,39
kafka,PR-12010,15,22,246,10,256
kafka,PR-12108,6,8,168,26,194
kafka,PR-12132,1,1,1,1,2
kafka,PR-12133,1,1,1,1,2
kafka,PR-12134,1,1,1,1,2
kafka,PR-11735,2,2,28,4,32
kafka,PR-12135,1,14,3143,787,3930
kafka,PR-11735,3,1,1,1,2
kafka,PR-12135,2,15,3165,818,3983
kafka,PR-12121,2,3,109,6,115
kafka,PR-10738,17,35,470,125,595
kafka,PR-11983,8,8,515,453,968
kafka,PR-11775,9,7,366,27,393
kafka,PR-12136,1,2,99,22,121
kafka,PR-12136,2,2,99,22,121
kafka,PR-12085,4,4,510,79,589
kafka,PR-12138,1,5,94,9,103
kafka,PR-11390,52,48,3020,240,3260
kafka,PR-12139,1,2,22,21,43
kafka,PR-11478,11,6,100,10,110
kafka,PR-10738,18,34,469,124,593
kafka,PR-12138,2,5,94,9,103
kafka,PR-12140,1,1,1,0,1
kafka,PR-12141,1,7,86,33,119
kafka,PR-12142,1,1,21,2,23
kafka,PR-12131,2,3,48,22,70
kafka,PR-12141,2,7,91,33,124
kafka,PR-11776,4,10,805,94,899
kafka,PR-11778,4,33,1002,163,1165
kafka,PR-12141,3,7,81,34,115
kafka,PR-12070,3,2,10,17,27
kafka,PR-12132,2,1,1,1,2
kafka,PR-11780,5,33,5085,1329,6414
kafka,PR-11778,5,33,993,163,1156
kafka,PR-12108,7,8,171,26,197
kafka,PR-11780,6,33,5084,1329,6413
kafka,PR-12035,2,2,276,0,276
kafka,PR-12122,5,18,856,303,1159
kafka,PR-12143,1,3,6,0,6
kafka,PR-12137,2,4,33,20,53
kafka,PR-11775,10,7,365,28,393
kafka,PR-12140,2,1,1,0,1
kafka,PR-12137,3,3,32,19,51
kafka,PR-12144,1,1,19,13,32
kafka,PR-12082,3,12,538,461,999
kafka,PR-12050,18,52,1292,174,1466
kafka,PR-12145,1,2,37,1,38
kafka,PR-12146,1,1,1,3,4
kafka,PR-11969,4,24,833,392,1225
kafka,PR-11969,5,24,833,392,1225
kafka,PR-12112,3,1,11,2,13
kafka,PR-12062,6,23,404,559,963
kafka,PR-12097,3,3,183,131,314
kafka,PR-12110,6,2,431,259,690
kafka,PR-12097,4,3,183,131,314
kafka,PR-12147,1,1,13,13,26
kafka,PR-12137,4,3,33,19,52
kafka,PR-12138,3,5,94,9,103
kafka,PR-12104,5,1,13,1,14
kafka,PR-12122,6,18,856,302,1158
kafka,PR-11786,4,2,12,5,17
kafka,PR-12097,5,3,183,131,314
kafka,PR-12146,2,1,5,4,9
kafka,PR-12050,19,59,1363,212,1575
kafka,PR-12141,4,7,91,34,125
kafka,PR-12149,1,1,3,0,3
kafka,PR-12150,1,12,578,403,981
kafka,PR-12151,1,1,1,1,2
kafka,PR-12150,2,12,583,404,987
kafka,PR-12147,2,2,82,82,164
kafka,PR-12087,4,1,170,0,170
kafka,PR-12050,20,59,1363,212,1575
kafka,PR-12050,21,59,1361,212,1573
kafka,PR-11644,5,2,24,10,34
kafka,PR-12152,1,1,1,1,2
kafka,PR-12153,1,1,1,1,2
kafka,PR-11969,6,24,833,392,1225
kafka,PR-12087,5,1,170,0,170
kafka,PR-12050,22,59,1393,215,1608
kafka,PR-12150,3,14,739,481,1220
kafka,PR-12149,2,2,30,2,32
kafka,PR-12005,10,17,1416,1015,2431
kafka,PR-12155,1,4,69,47,116
kafka,PR-12158,1,1,0,8,8
kafka,PR-12122,7,18,962,322,1284
kafka,PR-12153,2,1,4,2,6
kafka,PR-12159,1,5,7,16,23
kafka,PR-12050,24,61,1503,227,1730
kafka,PR-12160,1,2,115,1,116
kafka,PR-12161,1,10,1036,11,1047
kafka,PR-12162,1,3,65,48,113
kafka,PR-12162,2,4,92,56,148
kafka,PR-12161,2,10,583,11,594
kafka,PR-12050,25,61,1510,228,1738
kafka,PR-12135,3,15,3197,836,4033
kafka,PR-12164,1,1,1,1,2
kafka,PR-12135,4,15,3197,836,4033
kafka,PR-12160,2,2,115,1,116
kafka,PR-12162,3,5,123,63,186
kafka,PR-12121,3,3,110,6,116
kafka,PR-12159,2,5,29,29,58
kafka,PR-12140,3,2,68,0,68
kafka,PR-12159,3,4,25,31,56
kafka,PR-12159,4,4,22,30,52
kafka,PR-12109,5,6,95,20,115
kafka,PR-12159,5,4,29,37,66
kafka,PR-12159,6,4,23,36,59
kafka,PR-12159,7,4,33,36,69
kafka,PR-12165,1,1,11,10,21
kafka,PR-11748,3,7,146,81,227
kafka,PR-12166,1,2,104,3,107
kafka,PR-12161,3,10,579,11,590
kafka,PR-12167,1,1,102,0,102
kafka,PR-12050,26,61,1510,228,1738
kafka,PR-12161,4,10,580,11,591
kafka,PR-12168,1,1,0,5,5
kafka,PR-12167,2,1,102,0,102
kafka,PR-12169,1,1,3,1,4
kafka,PR-12159,8,5,36,38,74
kafka,PR-12170,1,1,1,1,2
kafka,PR-12162,4,5,123,63,186
kafka,PR-12158,2,1,31,45,76
kafka,PR-12171,1,6,287,192,479
kafka,PR-12165,2,1,23,11,34
kafka,PR-12109,6,6,95,20,115
kafka,PR-12110,7,2,322,209,531
kafka,PR-12110,8,3,320,248,568
kafka,PR-12172,1,1,2,1,3
kafka,PR-12138,4,5,120,27,147
kafka,PR-12160,3,2,115,1,116
kafka,PR-12138,5,5,120,27,147
kafka,PR-12109,7,6,95,20,115
kafka,PR-12173,2,10,1266,6,1272
kafka,PR-11776,5,3,439,65,504
kafka,PR-11778,6,29,633,138,771
kafka,PR-11780,7,28,4724,1304,6028
kafka,PR-12170,2,1,1,1,2
kafka,PR-12173,3,11,1268,7,1275
kafka,PR-12110,9,3,322,252,574
kafka,PR-12050,27,66,1502,235,1737
kafka,PR-12174,1,2,13,4,17
kafka,PR-11780,8,27,4684,1265,5949
kafka,PR-12159,9,5,37,40,77
kafka,PR-12175,1,4,67,3,70
kafka,PR-12149,3,2,37,2,39
kafka,PR-12158,3,1,31,45,76
kafka,PR-12050,28,72,1548,236,1784
kafka,PR-12150,5,14,742,512,1254
kafka,PR-12174,2,2,7,3,10
kafka,PR-12109,8,6,95,20,115
kafka,PR-12125,2,4,88,2,90
kafka,PR-12149,4,3,40,2,42
kafka,PR-12110,10,3,324,254,578
kafka,PR-12159,10,5,37,40,77
kafka,PR-12161,5,10,581,11,592
kafka,PR-12160,4,2,115,1,116
kafka,PR-12121,4,3,81,6,87
kafka,PR-12150,6,14,760,512,1272
kafka,PR-12176,1,1,96,82,178
kafka,PR-12177,1,2,97,19,116
kafka,PR-12160,5,2,151,1,152
kafka,PR-12150,7,14,760,512,1272
kafka,PR-12178,1,1,2,2,4
kafka,PR-12160,6,2,149,1,150
kafka,PR-12109,9,6,89,31,120
kafka,PR-12062,7,23,404,559,963
kafka,PR-12149,5,3,40,3,43
kafka,PR-11845,2,2,40,55,95
kafka,PR-12177,2,2,97,19,116
kafka,PR-10726,8,19,324,65,389
kafka,PR-12179,1,6,114,20,134
kafka,PR-12109,10,6,87,27,114
kafka,PR-12136,3,3,85,22,107
kafka,PR-12180,1,1,2,3,5
kafka,PR-12181,1,12,315,13,328
kafka,PR-12177,3,2,97,19,116
kafka,PR-12182,1,5,31,25,56
kafka,PR-12160,7,2,149,1,150
kafka,PR-12136,4,3,86,22,108
kafka,PR-12159,11,5,43,48,91
kafka,PR-12181,2,13,356,20,376
kafka,PR-12149,6,4,48,8,56
kafka,PR-12184,1,3,75,4,79
kafka,PR-12182,2,25,120,56,176
kafka,PR-12121,5,2,75,4,79
kafka,PR-12159,12,5,43,48,91
kafka,PR-12005,12,20,1441,1058,2499
kafka,PR-12185,1,4,95,96,191
kafka,PR-12159,13,5,44,49,93
kafka,PR-12187,1,3,123,37,160
kafka,PR-12188,1,10,203,34,237
kafka,PR-12189,1,1,13,0,13
kafka,PR-12184,2,3,75,4,79
kafka,PR-12187,2,3,126,37,163
kafka,PR-12174,3,6,20,11,31
kafka,PR-12183,2,24,805,191,996
kafka,PR-12185,2,4,95,96,191
kafka,PR-12149,7,4,48,8,56
kafka,PR-12189,2,4,32,30,62
kafka,PR-12005,13,20,1434,1054,2488
kafka,PR-12190,1,2,27,18,45
kafka,PR-12183,3,26,831,200,1031
kafka,PR-12005,14,20,1453,1071,2524
kafka,PR-12191,1,2,9,12,21
kafka,PR-12159,14,5,44,49,93
kafka,PR-12189,3,4,32,30,62
kafka,PR-12184,3,3,75,4,79
kafka,PR-12192,1,2,4,9,13
kafka,PR-12191,2,2,9,12,21
kafka,PR-12193,1,1,1,0,1
kafka,PR-12035,3,2,276,0,276
kafka,PR-12194,1,1,7,5,12
kafka,PR-12191,3,2,9,12,21
kafka,PR-12195,1,6,149,54,203
kafka,PR-12191,4,2,9,12,21
kafka,PR-12184,4,3,75,4,79
kafka,PR-12197,1,15,50,38,88
kafka,PR-12187,3,4,206,50,256
kafka,PR-12174,4,7,20,12,32
kafka,PR-12197,2,15,50,38,88
kafka,PR-12173,4,11,1271,9,1280
kafka,PR-12167,3,1,123,0,123
kafka,PR-12190,2,2,26,18,44
kafka,PR-12198,1,1,2,2,4
kafka,PR-12161,7,11,676,59,735
kafka,PR-12195,2,6,149,54,203
kafka,PR-12198,2,2,3,3,6
kafka,PR-12187,4,4,207,51,258
kafka,PR-12159,15,5,44,49,93
kafka,PR-12161,8,15,998,60,1058
kafka,PR-12136,5,3,83,22,105
kafka,PR-12159,16,5,44,49,93
kafka,PR-12187,5,4,218,61,279
kafka,PR-12199,1,6,17,21,38
kafka,PR-12175,2,4,67,3,70
kafka,PR-12181,3,13,392,30,422
kafka,PR-12159,17,5,45,50,95
kafka,PR-12199,2,7,20,25,45
kafka,PR-12200,1,4,290,82,372
kafka,PR-12191,5,2,9,12,21
kafka,PR-12202,1,1,5,4,9
kafka,PR-12183,4,26,831,200,1031
kafka,PR-12203,1,1,1,1,2
kafka,PR-12204,1,17,344,274,618
kafka,PR-12062,8,23,404,559,963
kafka,PR-12200,2,4,290,82,372
kafka,PR-12183,5,26,830,200,1030
kafka,PR-12161,9,15,938,12,950
kafka,PR-12205,1,2,55,0,55
kafka,PR-12005,15,20,1449,1071,2520
kafka,PR-12161,10,15,937,12,949
kafka,PR-12207,1,5,190,208,398
kafka,PR-12183,6,26,832,201,1033
kafka,PR-12005,16,20,1448,1071,2519
kafka,PR-12183,7,26,832,201,1033
kafka,PR-12206,2,13,461,8,469
kafka,PR-12208,1,1,22,19,41
kafka,PR-12159,18,5,45,50,95
kafka,PR-12210,1,4,19,4,23
kafka,PR-12211,1,1,1,0,1
kafka,PR-12212,1,17,535,36,571
kafka,PR-12187,6,4,218,61,279
kafka,PR-12204,2,18,361,274,635
kafka,PR-12213,1,1,3,1,4
kafka,PR-12214,1,55,414,396,810
kafka,PR-12215,1,1,3,0,3
kafka,PR-12206,3,15,570,8,578
kafka,PR-12213,2,1,3,1,4
kafka,PR-12136,6,3,83,22,105
kafka,PR-12215,2,1,3,0,3
kafka,PR-12216,1,72,254,21,275
kafka,PR-12217,1,5,38,31,69
kafka,PR-12218,1,1,1,1,2
kafka,PR-12213,3,1,3,1,4
kafka,PR-12206,4,15,622,33,655
kafka,PR-12084,2,5,106,21,127
kafka,PR-12084,3,5,106,21,127
kafka,PR-12220,1,1,1,1,2
kafka,PR-12214,3,31,293,339,632
kafka,PR-12213,4,1,3,1,4
kafka,PR-12217,2,5,38,31,69
kafka,PR-12214,4,31,295,340,635
kafka,PR-12205,2,3,55,1,56
kafka,PR-12183,10,26,823,199,1022
kafka,PR-12220,9,1,48,14,62
kafka,PR-12206,5,15,623,33,656
kafka,PR-12183,11,26,823,199,1022
kafka,PR-12205,3,4,56,1,57
kafka,PR-12217,3,5,38,31,69
kafka,PR-12183,12,26,826,199,1025
kafka,PR-12182,3,37,218,141,359
kafka,PR-12084,4,5,106,21,127
kafka,PR-12197,3,15,50,38,88
kafka,PR-11473,6,1,37,12,49
kafka,PR-11687,5,1,16,17,33
kafka,PR-12221,1,1,0,4,4
kafka,PR-12222,1,1,2,0,2
kafka,PR-11473,7,1,43,18,61
kafka,PR-12208,2,1,22,19,41
kafka,PR-11687,6,1,35,36,71
kafka,PR-12121,6,4,92,12,104
kafka,PR-12223,1,5,9,3,12
kafka,PR-12175,3,4,67,3,70
kafka,PR-12224,1,1,34,7,41
kafka,PR-12136,7,4,84,36,120
kafka,PR-12225,1,1,1,1,2
kafka,PR-12226,1,1,2,2,4
kafka,PR-12136,8,4,100,28,128
kafka,PR-12136,10,4,103,27,130
kafka,PR-12227,1,1,9,23,32
kafka,PR-12136,11,4,103,27,130
kafka,PR-12185,3,4,98,100,198
kafka,PR-12217,4,5,38,31,69
kafka,PR-12228,1,15,246,178,424
kafka,PR-12229,1,7,7,7,14
kafka,PR-12230,1,4,17,8,25
kafka,PR-12231,1,74,0,0,0
kafka,PR-12191,6,2,9,12,21
kafka,PR-12223,2,5,10,2,12
kafka,PR-12228,2,14,251,177,428
kafka,PR-12231,2,78,0,0,0
kafka,PR-11687,7,1,10,10,20
kafka,PR-12227,2,1,14,26,40
kafka,PR-12182,4,37,218,141,359
kafka,PR-12232,1,1,3,18,21
kafka,PR-11780,9,27,4688,1266,5954
kafka,PR-12233,1,6,68,65,133
kafka,PR-12159,19,5,45,50,95
kafka,PR-12179,2,5,253,36,289
kafka,PR-12136,12,4,107,27,134
kafka,PR-12084,5,5,106,21,127
kafka,PR-12179,3,5,253,36,289
kafka,PR-12234,1,10,28,17,45
kafka,PR-12191,7,2,9,12,21
kafka,PR-12210,2,5,24,5,29
kafka,PR-12209,3,11,1350,4,1354
kafka,PR-12179,4,5,253,36,289
kafka,PR-12159,20,5,45,50,95
kafka,PR-12005,17,20,1448,1071,2519
kafka,PR-12223,3,5,10,2,12
kafka,PR-12161,11,15,936,12,948
kafka,PR-11687,8,1,35,40,75
kafka,PR-12182,5,37,219,161,380
kafka,PR-12217,5,5,38,31,69
kafka,PR-11776,6,3,466,66,532
kafka,PR-11778,7,29,633,138,771
kafka,PR-12207,5,9,253,274,527
kafka,PR-12235,4,15,335,99,434
kafka,PR-12005,18,20,1447,1071,2518
kafka,PR-12235,5,16,330,75,405
kafka,PR-12236,1,4,9,8,17
kafka,PR-12237,1,1,4,5,9
kafka,PR-11778,8,29,633,138,771
kafka,PR-12238,1,1,1,1,2
kafka,PR-12237,2,3,43,54,97
kafka,PR-12239,1,1,4,4,8
kafka,PR-12209,4,11,1352,6,1358
kafka,PR-12235,6,18,272,91,363
kafka,PR-12236,2,5,14,12,26
kafka,PR-12235,7,20,301,114,415
kafka,PR-12226,2,1,2,2,4
kafka,PR-12237,3,3,43,54,97
kafka,PR-11778,9,29,632,138,770
kafka,PR-12240,2,16,678,107,785
kafka,PR-12210,3,6,25,6,31
kafka,PR-12241,1,1,1,1,2
kafka,PR-11780,10,26,4678,1266,5944
kafka,PR-12005,19,20,1447,1071,2518
kafka,PR-12242,1,1,1,1,2
kafka,PR-12209,5,11,1352,6,1358
kafka,PR-12210,4,5,24,5,29
kafka,PR-12206,8,14,605,33,638
kafka,PR-12245,1,2,44,15,59
kafka,PR-12246,1,1,1,1,2
kafka,PR-12161,13,18,1145,86,1231
kafka,PR-12244,1,3,10,4,14
kafka,PR-12226,3,1,2,2,4
kafka,PR-12240,3,21,709,124,833
kafka,PR-12236,3,6,18,16,34
kafka,PR-12161,14,18,1263,143,1406
kafka,PR-12005,20,20,1447,1071,2518
kafka,PR-12244,2,3,56,5,61
kafka,PR-12247,1,2,2,2,4
kafka,PR-12209,6,11,1360,6,1366
kafka,PR-12240,4,19,709,120,829
kafka,PR-12243,1,1,4,4,8
kafka,PR-12235,9,30,1016,207,1223
kafka,PR-12181,7,48,1970,569,2539
kafka,PR-11779,4,36,2312,316,2628
kafka,PR-12170,3,1,1,1,2
kafka,PR-12235,10,31,1018,207,1225
kafka,PR-12181,8,47,1953,569,2522
kafka,PR-12248,1,8,150,7,157
kafka,PR-12182,6,36,204,122,326
kafka,PR-12249,1,2,11,1,12
kafka,PR-12245,2,2,44,15,59
kafka,PR-12236,4,6,18,16,34
kafka,PR-12235,11,32,1052,233,1285
kafka,PR-12244,3,3,73,8,81
kafka,PR-12161,15,20,1175,144,1319
kafka,PR-12251,1,1,7,7,14
kafka,PR-12236,5,6,18,16,34
kafka,PR-12250,2,30,205,135,340
kafka,PR-12182,7,36,204,122,326
kafka,PR-12235,12,33,1092,262,1354
kafka,PR-12252,1,1,1,1,2
kafka,PR-12231,3,78,0,0,0
kafka,PR-11779,5,37,2308,316,2624
kafka,PR-11778,10,29,633,138,771
kafka,PR-11473,8,1,43,18,61
kafka,PR-12253,1,2,1,3,4
kafka,PR-11579,8,2,37,2,39
kafka,PR-12255,1,1,5,4,9
kafka,PR-12235,13,34,1095,265,1360
kafka,PR-12256,1,1,1,1,2
kafka,PR-12257,1,2,3,3,6
kafka,PR-12240,5,19,812,149,961
kafka,PR-12235,14,33,1092,262,1354
kafka,PR-12257,2,202,364,26878,27242
kafka,PR-12240,6,19,812,149,961
kafka,PR-12255,2,1,6,4,10
kafka,PR-12250,3,30,205,135,340
kafka,PR-12086,2,1,7,5,12
kafka,PR-11687,9,1,35,40,75
kafka,PR-12253,2,2,1,3,4
kafka,PR-12245,3,2,28,16,44
kafka,PR-12258,1,2,84,53,137
kafka,PR-12259,1,3,73,8,81
kafka,PR-12206,10,14,588,33,621
kafka,PR-12258,2,2,87,56,143
kafka,PR-12245,4,2,28,16,44
kafka,PR-12260,1,1,3,0,3
kafka,PR-12250,5,31,223,144,367
kafka,PR-12235,15,33,1098,262,1360
kafka,PR-12255,3,1,6,4,10
kafka,PR-11778,11,30,657,138,795
kafka,PR-11780,11,26,4679,1266,5945
kafka,PR-12255,4,1,6,4,10
kafka,PR-11779,6,39,2416,322,2738
kafka,PR-12261,1,2,5,1,6
kafka,PR-12240,7,20,922,165,1087
kafka,PR-12260,2,1,7,0,7
kafka,PR-12250,6,31,223,144,367
kafka,PR-12240,8,20,922,165,1087
kafka,PR-12248,3,8,149,7,156
kafka,PR-12262,1,2,3,6,9
kafka,PR-12263,1,1,6,2,8
kafka,PR-12181,9,32,1244,449,1693
kafka,PR-12086,3,1,7,5,12
kafka,PR-12206,11,14,561,33,594
kafka,PR-12250,7,34,226,156,382
kafka,PR-12262,2,1,3,6,9
kafka,PR-12249,2,2,11,1,12
kafka,PR-12206,12,14,561,33,594
kafka,PR-11779,8,26,1786,190,1976
kafka,PR-12260,3,1,6,0,6
kafka,PR-12250,8,34,228,157,385
kafka,PR-12258,3,2,87,56,143
kafka,PR-12261,2,2,6,2,8
kafka,PR-12236,6,7,63,15,78
kafka,PR-12264,1,1,7,2,9
kafka,PR-11780,12,26,4678,1265,5943
kafka,PR-12265,1,2,62,15,77
kafka,PR-12229,2,7,7,7,14
kafka,PR-12224,2,1,41,11,52
kafka,PR-12197,4,15,50,38,88
kafka,PR-12184,5,3,75,4,79
kafka,PR-12265,2,2,83,19,102
kafka,PR-12046,3,22,299,57,356
kafka,PR-12181,10,32,1448,533,1981
kafka,PR-12261,3,2,6,2,8
kafka,PR-12248,4,8,149,7,156
kafka,PR-12267,1,8,17,17,34
kafka,PR-12264,2,1,7,2,9
kafka,PR-11779,9,26,2014,377,2391
kafka,PR-12230,2,4,17,8,25
kafka,PR-12233,2,6,68,65,133
kafka,PR-12067,5,9,105,19,124
kafka,PR-12250,9,34,230,157,387
kafka,PR-12206,13,14,561,33,594
kafka,PR-12268,1,1,2,2,4
kafka,PR-12121,7,4,92,12,104
kafka,PR-12236,7,7,63,15,78
kafka,PR-12269,1,1,12,7,19
kafka,PR-12248,5,8,161,7,168
kafka,PR-12250,10,36,279,169,448
kafka,PR-12268,2,1,2,2,4
kafka,PR-12270,1,5,595,166,761
kafka,PR-12269,2,1,10,3,13
kafka,PR-12206,14,14,572,34,606
kafka,PR-12271,1,5,192,73,265
kafka,PR-12270,2,5,595,166,761
kafka,PR-12250,11,36,279,169,448
kafka,PR-12271,2,5,192,73,265
kafka,PR-11781,5,31,5983,1371,7354
kafka,PR-12272,1,1,1,1,2
kafka,PR-12273,1,1,1,1,2
kafka,PR-12179,5,5,266,52,318
kafka,PR-12274,1,2,2,2,4
kafka,PR-12161,16,20,1173,144,1317
kafka,PR-12181,11,37,1670,569,2239
kafka,PR-12276,1,1,1,18,19
kafka,PR-12175,4,4,67,3,70
kafka,PR-12046,5,22,331,61,392
kafka,PR-12276,2,1,1,18,19
kafka,PR-12161,17,20,1081,46,1127
kafka,PR-12250,12,37,347,177,524
kafka,PR-12046,6,22,331,59,390
kafka,PR-12161,18,20,1090,49,1139
kafka,PR-12206,15,13,572,34,606
kafka,PR-12279,1,3,166,9,175
kafka,PR-12250,13,37,347,177,524
kafka,PR-11781,6,31,5983,1371,7354
kafka,PR-11780,13,26,4678,1265,5943
kafka,PR-11779,10,26,2022,385,2407
kafka,PR-12264,3,1,6,2,8
kafka,PR-12280,1,2,3,6,9
kafka,PR-11781,7,31,5984,1371,7355
kafka,PR-12280,2,3,4,3,7
kafka,PR-12179,6,5,266,52,318
kafka,PR-12181,12,34,1647,597,2244
kafka,PR-12224,3,1,41,11,52
kafka,PR-12067,6,9,107,19,126
kafka,PR-12281,1,2,5,9,14
kafka,PR-12181,13,32,1740,597,2337
kafka,PR-12248,6,10,167,7,174
kafka,PR-12181,14,32,1739,597,2336
kafka,PR-12282,1,3,20,9,29
kafka,PR-12280,3,3,4,3,7
kafka,PR-12283,1,1,2,1,3
kafka,PR-11780,14,26,4656,1262,5918
kafka,PR-11781,8,31,5960,1366,7326
kafka,PR-11782,5,38,7074,1403,8477
kafka,PR-12250,14,38,379,182,561
kafka,PR-12284,1,2,4,1,5
kafka,PR-12277,3,1,10,15,25
kafka,PR-11579,9,2,48,2,50
kafka,PR-11473,9,1,43,18,61
kafka,PR-12281,2,2,5,9,14
kafka,PR-12285,1,300,3583,3919,7502
kafka,PR-12140,4,2,68,0,68
kafka,PR-12140,5,2,68,0,68
kafka,PR-11782,6,39,7075,1403,8478
kafka,PR-11783,5,44,7263,1452,8715
kafka,PR-11781,9,30,5936,1342,7278
kafka,PR-11780,15,26,4656,1262,5918
kafka,PR-12286,1,1,1,0,1
kafka,PR-12250,15,38,379,182,561
kafka,PR-11781,10,8,1292,91,1383
kafka,PR-11782,7,16,2407,128,2535
kafka,PR-11783,6,20,2589,175,2764
kafka,PR-11782,8,16,2407,128,2535
kafka,PR-12206,16,13,566,34,600
kafka,PR-12287,1,3,8,11,19
kafka,PR-12284,2,2,4,1,5
kafka,PR-11781,11,8,1297,91,1388
kafka,PR-12286,2,1,1,0,1
kafka,PR-12271,6,14,1704,339,2043
kafka,PR-12288,3,2,45,5,50
kafka,PR-12290,1,1,18,13,31
kafka,PR-11781,12,8,1299,91,1390
kafka,PR-12291,1,11,148,55,203
kafka,PR-12271,7,14,1832,383,2215
kafka,PR-12288,5,3,50,16,66
kafka,PR-12291,2,11,148,55,203
kafka,PR-12271,8,13,1870,409,2279
kafka,PR-12181,15,32,1738,597,2335
kafka,PR-12292,1,1,2,1,3
kafka,PR-12293,1,1,1,0,1
kafka,PR-12274,2,3,4,3,7
kafka,PR-12234,2,9,27,16,43
kafka,PR-12294,1,10,54,17,71
kafka,PR-11782,9,16,2405,137,2542
kafka,PR-11781,13,8,1293,100,1393
kafka,PR-11783,7,20,2587,184,2771
kafka,PR-12206,17,13,530,38,568
kafka,PR-12289,2,1,61,34,95
kafka,PR-12206,18,13,531,39,570
kafka,PR-12287,2,3,8,11,19
kafka,PR-12287,3,3,8,11,19
kafka,PR-12161,19,20,1104,49,1153
kafka,PR-12295,1,1,9,5,14
kafka,PR-12206,19,12,524,32,556
kafka,PR-12169,2,1,3,1,4
kafka,PR-12045,4,5,211,77,288
kafka,PR-12284,3,2,4,1,5
kafka,PR-12228,3,13,194,128,322
kafka,PR-12045,5,5,211,77,288
kafka,PR-12233,3,6,68,65,133
kafka,PR-12161,21,20,1125,49,1174
kafka,PR-10738,20,32,435,123,558
kafka,PR-11238,3,1,15,1,16
kafka,PR-12296,1,3,61,4,65
kafka,PR-12284,4,1,1,1,2
kafka,PR-12161,22,20,1125,49,1174
kafka,PR-12298,1,1,7,2,9
kafka,PR-12299,1,1,1,1,2
kafka,PR-12233,4,6,68,65,133
kafka,PR-12286,4,3,28,6,34
kafka,PR-12296,2,3,61,4,65
kafka,PR-12274,3,5,10,6,16
kafka,PR-12236,8,7,63,15,78
kafka,PR-12285,3,16,342,387,729
kafka,PR-12297,1,2,60,8,68
kafka,PR-12285,4,16,330,356,686
kafka,PR-12298,2,1,6,2,8
kafka,PR-12300,1,3,4,4,8
kafka,PR-12279,2,3,157,9,166
kafka,PR-12301,1,13,195,232,427
kafka,PR-12302,1,12,170,179,349
kafka,PR-12303,1,1,1,1,2
kafka,PR-12298,3,1,6,2,8
kafka,PR-12304,2,6,29,21,50
kafka,PR-11781,14,16,1377,172,1549
kafka,PR-11442,5,3,84,18,102
kafka,PR-12298,4,1,6,2,8
kafka,PR-12279,3,7,158,17,175
kafka,PR-12305,1,1,1,1,2
kafka,PR-12269,4,3,91,7,98
kafka,PR-12304,3,6,29,21,50
kafka,PR-11782,11,25,2632,222,2854
kafka,PR-11781,15,17,1426,179,1605
kafka,PR-11783,8,29,2814,269,3083
kafka,PR-12304,4,6,29,21,50
kafka,PR-12149,8,5,47,8,55
kafka,PR-12149,9,6,48,11,59
kafka,PR-12307,1,2,152,84,236
kafka,PR-11781,16,17,1426,179,1605
kafka,PR-11782,12,25,2664,223,2887
kafka,PR-11783,9,29,2846,270,3116
kafka,PR-11781,17,17,1458,180,1638
kafka,PR-12310,2,6,74,87,161
kafka,PR-12311,1,1,14,14,28
kafka,PR-12312,2,3,449,48,497
kafka,PR-12313,1,1,12,4,16
kafka,PR-12298,5,2,8,4,12
kafka,PR-12298,6,2,8,4,12
kafka,PR-12314,1,6,112,14,126
kafka,PR-12300,2,3,4,4,8
kafka,PR-11783,10,29,2847,271,3118
kafka,PR-11782,13,25,2665,224,2889
kafka,PR-11781,18,17,1459,181,1640
kafka,PR-12315,1,13,582,202,784
kafka,PR-12286,5,3,28,6,34
kafka,PR-12295,2,2,74,5,79
kafka,PR-12309,1,9,37,2,39
kafka,PR-12314,3,7,108,5,113
kafka,PR-12317,1,2,18,8,26
kafka,PR-12310,3,6,74,87,161
kafka,PR-12318,1,2,27,8,35
kafka,PR-12317,2,2,18,8,26
kafka,PR-12209,7,13,1365,10,1375
kafka,PR-12309,2,10,41,2,43
kafka,PR-12320,2,2,148,10,158
kafka,PR-12321,1,2,8,3,11
kafka,PR-11782,14,7,1149,22,1171
kafka,PR-12322,1,1,23,11,34
kafka,PR-12295,3,2,80,6,86
kafka,PR-12321,2,1,2,0,2
kafka,PR-12309,3,10,42,2,44
kafka,PR-12323,1,1,72,84,156
kafka,PR-12269,5,3,100,10,110
kafka,PR-12228,4,16,211,132,343
kafka,PR-12317,3,2,18,8,26
kafka,PR-12279,4,6,140,17,157
kafka,PR-12324,1,1,7,0,7
kafka,PR-12325,1,1,165,166,331
kafka,PR-12326,1,1,2,0,2
kafka,PR-12328,1,3,44,6,50
kafka,PR-11783,11,11,1331,69,1400
kafka,PR-12295,4,2,80,6,86
kafka,PR-12269,6,3,105,10,115
kafka,PR-12316,2,3,13,3,16
kafka,PR-12325,2,1,198,151,349
kafka,PR-12329,2,4,193,17,210
kafka,PR-12323,2,1,102,94,196
kafka,PR-12322,2,1,20,14,34
kafka,PR-12330,1,3,81,0,81
kafka,PR-12312,4,3,448,47,495
kafka,PR-12291,3,11,148,55,203
kafka,PR-12329,3,3,112,11,123
kafka,PR-12228,5,17,217,132,349
kafka,PR-12224,4,3,50,15,65
kafka,PR-12291,4,11,148,55,203
kafka,PR-12229,3,6,6,6,12
kafka,PR-12230,3,4,24,36,60
kafka,PR-12281,3,1,2,2,4
kafka,PR-12332,1,1,1,1,2
kafka,PR-12333,1,1,2,1,3
kafka,PR-12269,8,3,105,10,115
kafka,PR-12149,12,5,46,11,57
kafka,PR-12149,13,5,46,11,57
kafka,PR-12333,2,1,1,1,2
kafka,PR-12329,4,4,151,11,162
kafka,PR-12329,5,4,152,11,163
kafka,PR-12291,5,11,148,55,203
kafka,PR-12334,1,3,125,2,127
kafka,PR-12337,1,10,136,57,193
kafka,PR-12338,1,16,339,284,623
kafka,PR-12335,1,1,1,1,2
kafka,PR-12339,1,1,3,1,4
kafka,PR-12338,2,16,335,284,619
kafka,PR-12312,5,3,436,106,542
kafka,PR-12341,1,1,3,1,4
kafka,PR-12139,2,2,22,21,43
kafka,PR-12312,6,3,436,106,542
kafka,PR-12329,6,4,175,12,187
kafka,PR-12336,1,3,51,28,79
kafka,PR-12345,1,1,17,18,35
kafka,PR-12204,4,23,400,286,686
kafka,PR-12345,2,1,14,19,33
kafka,PR-12346,1,1,12,7,19
kafka,PR-12347,1,5,68,17,85
kafka,PR-12347,2,4,68,14,82
kafka,PR-10967,4,2,6,2,8
kafka,PR-12348,2,4,26,72,98
kafka,PR-12349,1,1,4,0,4
kafka,PR-12277,4,1,10,15,25
kafka,PR-12321,3,2,12,3,15
kafka,PR-12289,5,1,66,40,106
kafka,PR-12350,1,1,2,1,3
kafka,PR-12351,1,1,1,2,3
kafka,PR-12352,1,3,8,76,84
kafka,PR-12313,2,1,8,0,8
kafka,PR-12353,1,1,4,4,8
kafka,PR-12297,2,2,25,8,33
kafka,PR-12297,3,2,19,8,27
kafka,PR-12349,2,2,46,0,46
kafka,PR-12336,2,4,78,50,128
kafka,PR-12355,1,2,34,0,34
kafka,PR-12204,6,30,722,414,1136
kafka,PR-12265,3,2,77,16,93
kafka,PR-12329,7,4,194,31,225
kafka,PR-12356,1,2,13,0,13
kafka,PR-11894,2,2,101,22,123
kafka,PR-11782,15,7,1149,22,1171
kafka,PR-11783,12,11,1368,69,1437
kafka,PR-12139,3,2,22,21,43
kafka,PR-11782,16,7,1186,22,1208
kafka,PR-12204,7,30,728,414,1142
kafka,PR-12308,1,4,48,9,57
kafka,PR-12139,4,2,22,21,43
kafka,PR-12139,5,2,21,21,42
kafka,PR-12204,8,28,676,406,1082
kafka,PR-12357,1,4,13,6,19
kafka,PR-12358,1,1,17,2,19
kafka,PR-12359,1,2,4,4,8
kafka,PR-12344,3,2,21,17,38
kafka,PR-12360,1,1,4,1,5
kafka,PR-12361,1,4,189,17,206
kafka,PR-12362,1,4,189,17,206
kafka,PR-12362,2,4,190,17,207
kafka,PR-12344,4,2,22,17,39
kafka,PR-12363,1,4,12,9,21
kafka,PR-12363,2,4,20,12,32
kafka,PR-12364,1,1,4,2,6
kafka,PR-12365,1,1,9,4,13
kafka,PR-11783,13,11,1368,69,1437
kafka,PR-11782,18,7,1198,22,1220
kafka,PR-12363,3,4,21,12,33
kafka,PR-11894,3,2,154,27,181
kafka,PR-12363,4,4,23,12,35
kafka,PR-12355,2,2,34,0,34
kafka,PR-12366,1,2,12,0,12
kafka,PR-12367,1,1,1,1,2
kafka,PR-9500,13,3,93,21,114
kafka,PR-12368,1,2,0,39,39
kafka,PR-12364,2,1,4,2,6
kafka,PR-12368,2,2,0,46,46
kafka,PR-12369,1,1,14,0,14
kafka,PR-12370,1,9,241,21,262
kafka,PR-12371,1,2,32,9,41
kafka,PR-12372,1,2,46,6,52
kafka,PR-12371,2,2,32,9,41
kafka,PR-12337,3,13,179,71,250
kafka,PR-12368,3,2,0,65,65
kafka,PR-12318,2,2,28,8,36
kafka,PR-12373,1,1,149,117,266
kafka,PR-11784,8,14,128,61,189
kafka,PR-12374,1,2,28,12,40
kafka,PR-11894,4,2,229,32,261
kafka,PR-11782,19,7,1204,23,1227
kafka,PR-11783,14,11,1386,70,1456
kafka,PR-12360,2,2,11,2,13
kafka,PR-12321,4,2,21,1,22
kafka,PR-12306,3,6,332,17,349
kafka,PR-12308,2,5,41,10,51
kafka,PR-12363,5,5,22,13,35
kafka,PR-12349,3,7,152,18,170
kafka,PR-12337,4,15,202,84,286
kafka,PR-12347,6,8,268,29,297
kafka,PR-12318,3,2,32,8,40
kafka,PR-12265,4,3,96,22,118
kafka,PR-12346,2,1,18,10,28
kafka,PR-12289,8,1,34,21,55
kafka,PR-12289,9,1,26,13,39
kafka,PR-12346,3,1,36,10,46
kafka,PR-12289,10,1,26,13,39
kafka,PR-12346,4,1,33,9,42
kafka,PR-12376,1,1,3,3,6
kafka,PR-12376,2,1,3,3,6
kafka,PR-12296,3,3,61,4,65
kafka,PR-12296,4,3,62,5,67
kafka,PR-12377,1,1,20,0,20
kafka,PR-12378,1,1,1,1,2
kafka,PR-12379,1,2,9,35,44
kafka,PR-12296,5,4,84,8,92
kafka,PR-11784,9,14,128,61,189
kafka,PR-12380,1,1,0,18,18
kafka,PR-12381,1,4,56,34,90
kafka,PR-11782,20,8,1410,23,1433
kafka,PR-12343,2,8,65,20,85
kafka,PR-12331,8,3,57,21,78
kafka,PR-12382,1,1,18,0,18
kafka,PR-11782,21,8,1418,23,1441
kafka,PR-12224,5,3,52,15,67
kafka,PR-12224,6,3,52,15,67
kafka,PR-12383,1,75,190,1089,1279
kafka,PR-12380,2,1,0,18,18
kafka,PR-11783,15,4,200,48,248
kafka,PR-12265,5,4,117,23,140
kafka,PR-12360,3,3,15,5,20
kafka,PR-12359,2,2,24,12,36
kafka,PR-12384,1,6,336,50,386
kafka,PR-12296,6,4,91,8,99
kafka,PR-12381,2,4,58,34,92
kafka,PR-12359,3,2,24,12,36
kafka,PR-12331,9,3,57,21,78
kafka,PR-12383,2,75,189,1080,1269
kafka,PR-12385,1,2,5,0,5
kafka,PR-12337,5,13,188,81,269
kafka,PR-12338,3,10,231,234,465
kafka,PR-12296,7,4,93,8,101
kafka,PR-12382,2,1,18,0,18
kafka,PR-12388,1,2,20,5,25
kafka,PR-12175,5,4,67,3,70
kafka,PR-12265,6,5,106,37,143
kafka,PR-12320,12,2,274,10,284
kafka,PR-12381,3,4,59,34,93
kafka,PR-12282,2,3,20,9,29
kafka,PR-12389,1,1,5,4,9
kafka,PR-12385,2,2,5,0,5
kafka,PR-12359,4,2,19,12,31
kafka,PR-12386,2,5,253,10,263
kafka,PR-12387,2,5,383,13,396
kafka,PR-12338,4,10,230,233,463
kafka,PR-12390,1,2,69,11,80
kafka,PR-12370,2,9,248,22,270
kafka,PR-12359,5,2,19,12,31
kafka,PR-12370,3,9,291,106,397
kafka,PR-12296,8,4,93,8,101
kafka,PR-12388,2,2,51,5,56
kafka,PR-12296,9,4,95,8,103
kafka,PR-12265,7,5,104,37,141
kafka,PR-12392,1,2,194,20,214
kafka,PR-12388,3,2,44,7,51
kafka,PR-12394,1,1,3,2,5
kafka,PR-12265,8,5,104,37,141
kafka,PR-12331,10,3,57,21,78
kafka,PR-12388,4,5,57,8,65
kafka,PR-12395,1,1,3,3,6
kafka,PR-12390,2,2,69,11,80
kafka,PR-12396,1,2,44,15,59
kafka,PR-10826,6,110,1513,962,2475
kafka,PR-12397,1,17,439,427,866
kafka,PR-12393,3,76,2172,390,2562
kafka,PR-12393,4,78,2175,414,2589
kafka,PR-12396,2,2,46,15,61
kafka,PR-12390,3,2,69,11,80
kafka,PR-12380,3,1,0,66,66
kafka,PR-12398,1,1,0,13,13
kafka,PR-12349,4,7,189,26,215
kafka,PR-12398,2,2,46,25,71
kafka,PR-12349,5,7,192,26,218
kafka,PR-12347,7,8,320,31,351
kafka,PR-12393,5,78,2175,414,2589
kafka,PR-10964,12,17,509,151,660
kafka,PR-12388,5,5,59,8,67
kafka,PR-12265,9,5,104,37,141
kafka,PR-12400,1,1,9,6,15
kafka,PR-12388,6,5,58,8,66
kafka,PR-12401,1,2,1,1,2
kafka,PR-12398,3,5,126,28,154
kafka,PR-12401,2,2,1,1,2
kafka,PR-12365,2,2,21,11,32
kafka,PR-11144,4,1,3,2,5
kafka,PR-12374,2,3,64,16,80
kafka,PR-12324,5,2,13,0,13
kafka,PR-11783,16,4,202,49,251
kafka,PR-12395,2,1,3,3,6
kafka,PR-12365,3,2,25,11,36
kafka,PR-12402,1,9,1,36,37
kafka,PR-10964,13,19,717,157,874
kafka,PR-11390,54,48,2504,205,2709
kafka,PR-12377,2,1,20,0,20
kafka,PR-10964,14,19,714,157,871
kafka,PR-12347,8,8,336,40,376
kafka,PR-10964,15,19,721,155,876
kafka,PR-11211,15,19,835,350,1185
kafka,PR-12403,1,3,124,59,183
kafka,PR-10964,16,19,767,155,922
kafka,PR-12318,4,3,180,80,260
kafka,PR-12393,7,133,2451,630,3081
kafka,PR-10964,17,20,813,157,970
kafka,PR-12404,1,1,4,5,9
kafka,PR-12392,2,5,143,76,219
kafka,PR-12347,10,8,315,39,354
kafka,PR-12393,8,131,2413,617,3030
kafka,PR-12405,1,2,19,1,20
kafka,PR-12347,11,8,320,39,359
kafka,PR-12406,1,2,40,19,59
kafka,PR-12407,1,1,1,1,2
kafka,PR-12409,1,4,631,746,1377
kafka,PR-12410,1,9,19,281,300
kafka,PR-11783,17,4,203,50,253
kafka,PR-12349,6,7,192,26,218
kafka,PR-12411,1,2,53,9,62
kafka,PR-11608,4,17,618,304,922
kafka,PR-12365,4,2,28,12,40
kafka,PR-10967,5,2,6,2,8
kafka,PR-12349,7,7,192,26,218
kafka,PR-12412,1,2,26,4,30
kafka,PR-12349,8,7,192,26,218
kafka,PR-12349,9,7,271,26,297
kafka,PR-12405,2,2,27,3,30
kafka,PR-12414,1,5,24,8,32
kafka,PR-12349,10,7,377,26,403
kafka,PR-12314,5,10,165,47,212
kafka,PR-12412,2,2,22,3,25
kafka,PR-12415,1,2,23,3,26
kafka,PR-12416,1,2,100,5,105
kafka,PR-12412,3,2,22,3,25
kafka,PR-12416,2,2,100,2,102
kafka,PR-12405,3,2,31,3,34
kafka,PR-12417,1,1,2,3,5
kafka,PR-12408,2,2,226,31,257
kafka,PR-12393,9,131,2413,617,3030
kafka,PR-11478,12,6,100,10,110
kafka,PR-12386,3,5,253,10,263
kafka,PR-12387,3,5,383,13,396
kafka,PR-12349,11,7,411,26,437
kafka,PR-12392,3,5,147,79,226
kafka,PR-11478,13,6,109,10,119
kafka,PR-12418,1,3,174,194,368
kafka,PR-12420,1,1,1,1,2
kafka,PR-12421,1,4,11,78,89
kafka,PR-12365,5,2,26,12,38
kafka,PR-12413,2,3,5,5,10
kafka,PR-12386,4,6,379,10,389
kafka,PR-12387,4,5,196,7,203
kafka,PR-12413,3,3,5,5,10
kafka,PR-12416,3,2,101,2,103
kafka,PR-12392,4,5,149,81,230
kafka,PR-12331,13,4,64,26,90
kafka,PR-12416,4,2,101,2,103
kafka,PR-12349,12,7,251,49,300
kafka,PR-12392,5,5,160,88,248
kafka,PR-12422,1,2,36,35,71
kafka,PR-12331,14,5,71,32,103
kafka,PR-12387,5,5,229,8,237
kafka,PR-12413,4,3,5,5,10
kafka,PR-12365,6,2,30,13,43
kafka,PR-12397,2,17,439,427,866
kafka,PR-12414,2,6,23,14,37
kafka,PR-11783,18,5,215,57,272
kafka,PR-12397,3,17,439,427,866
kafka,PR-12324,6,2,13,0,13
kafka,PR-12416,5,2,96,2,98
kafka,PR-12408,3,2,224,31,255
kafka,PR-12416,6,2,101,2,103
kafka,PR-12365,7,2,30,13,43
kafka,PR-12331,15,5,71,32,103
kafka,PR-12422,2,2,48,39,87
kafka,PR-12423,1,2,24,21,45
kafka,PR-12401,3,2,1,1,2
kafka,PR-12413,5,4,6,5,11
kafka,PR-12347,12,8,319,39,358
kafka,PR-12424,1,1,15,1,16
kafka,PR-12408,4,2,234,30,264
kafka,PR-12424,2,1,17,1,18
kafka,PR-12397,4,16,452,451,903
kafka,PR-12408,5,2,229,33,262
kafka,PR-12424,3,1,17,1,18
kafka,PR-12408,6,2,229,36,265
kafka,PR-11783,19,8,286,67,353
kafka,PR-12408,7,2,229,36,265
kafka,PR-12294,2,10,54,17,71
kafka,PR-12408,8,2,229,36,265
kafka,PR-12397,5,16,452,451,903
kafka,PR-12425,1,1,129,1,130
kafka,PR-12426,1,2,5,5,10
kafka,PR-12413,6,4,7,5,12
kafka,PR-12408,10,2,231,36,267
kafka,PR-12285,5,15,296,332,628
kafka,PR-12427,1,12,381,139,520
kafka,PR-12417,2,1,2,3,5
kafka,PR-12428,1,1,9,10,19
kafka,PR-12343,3,8,65,20,85
kafka,PR-12396,3,2,46,15,61
kafka,PR-11565,5,8,162,15,177
kafka,PR-12425,2,1,120,1,121
kafka,PR-12417,3,1,2,3,5
kafka,PR-12416,7,2,96,2,98
kafka,PR-11565,6,8,162,15,177
kafka,PR-12429,2,4,132,46,178
kafka,PR-12430,1,1,1,1,2
kafka,PR-11442,6,3,160,59,219
kafka,PR-12413,7,4,7,5,12
kafka,PR-12431,1,1,1,1,2
kafka,PR-11478,14,6,109,10,119
kafka,PR-11390,55,48,2504,205,2709
kafka,PR-12432,1,2,15,1,16
kafka,PR-12425,3,1,128,1,129
kafka,PR-12425,4,1,131,1,132
kafka,PR-12413,8,4,7,5,12
kafka,PR-12433,1,1,12,5,17
kafka,PR-11565,7,9,232,70,302
kafka,PR-11478,15,6,101,8,109
kafka,PR-11478,16,6,101,8,109
kafka,PR-12434,2,1,5,8,13
kafka,PR-12413,9,4,7,5,12
kafka,PR-12308,3,6,67,13,80
kafka,PR-12435,1,2,2,3,5
kafka,PR-12366,2,2,146,0,146
kafka,PR-12366,3,2,146,0,146
kafka,PR-12331,16,5,71,32,103
kafka,PR-11478,17,6,96,8,104
kafka,PR-12414,3,6,23,14,37
kafka,PR-11478,18,6,101,8,109
kafka,PR-12436,1,2,125,170,295
kafka,PR-11478,19,6,108,8,116
kafka,PR-12437,1,4,410,12,422
kafka,PR-11478,20,6,110,8,118
kafka,PR-12411,2,2,66,11,77
kafka,PR-12438,1,1,18,25,43
kafka,PR-12439,1,17,272,394,666
kafka,PR-12416,8,2,96,2,98
kafka,PR-10528,11,42,95,53,148
kafka,PR-12429,3,4,155,55,210
kafka,PR-12439,2,17,363,438,801
kafka,PR-12416,9,2,74,2,76
kafka,PR-11478,21,6,110,8,118
kafka,PR-12440,1,1,1,1,2
kafka,PR-12442,1,6,207,85,292
kafka,PR-12438,2,1,18,25,43
kafka,PR-12443,2,4,63,50,113
kafka,PR-12429,4,4,155,55,210
kafka,PR-12444,1,11,212,98,310
kafka,PR-12443,3,4,63,50,113
kafka,PR-12445,1,1,0,3,3
kafka,PR-12443,4,4,64,51,115
kafka,PR-12439,3,18,513,553,1066
kafka,PR-12437,2,4,410,12,422
kafka,PR-12437,3,4,416,12,428
kafka,PR-12306,4,6,332,18,350
kafka,PR-12393,10,131,2405,611,3016
kafka,PR-12446,1,1,1,1,2
kafka,PR-12284,5,1,1,1,2
kafka,PR-11478,22,6,110,8,118
kafka,PR-12437,4,4,416,12,428
kafka,PR-12439,4,18,513,553,1066
kafka,PR-12447,1,8,390,136,526
kafka,PR-12448,1,10,98,5,103
kafka,PR-12334,2,3,127,2,129
kafka,PR-12449,1,1,10,12,22
kafka,PR-12434,4,5,167,8,175
kafka,PR-12450,1,5,31,29,60
kafka,PR-12451,1,1,3,5,8
kafka,PR-12452,1,1,3,1,4
kafka,PR-12442,2,6,212,100,312
kafka,PR-12434,5,5,210,42,252
kafka,PR-12149,15,5,46,11,57
kafka,PR-12453,1,2,0,38,38
kafka,PR-12448,2,11,101,7,108
kafka,PR-12454,1,1,224,198,422
kafka,PR-12455,1,7,149,76,225
kafka,PR-12442,3,6,212,100,312
kafka,PR-12321,5,2,21,1,22
kafka,PR-12456,1,7,233,110,343
kafka,PR-12457,1,3,17,1,18
kafka,PR-12447,2,9,430,139,569
kafka,PR-12458,1,10,119,62,181
kafka,PR-12274,4,6,42,21,63
kafka,PR-12318,5,3,112,12,124
kafka,PR-12434,6,5,261,89,350
kafka,PR-12453,2,2,0,18,18
kafka,PR-12434,7,5,261,92,353
kafka,PR-12441,2,68,160,208,368
kafka,PR-12414,4,6,28,14,42
kafka,PR-12453,3,2,0,18,18
kafka,PR-12441,4,15,56,50,106
kafka,PR-12455,2,8,145,77,222
kafka,PR-12434,8,5,224,65,289
kafka,PR-12432,2,2,16,3,19
kafka,PR-12455,3,8,144,76,220
kafka,PR-12459,1,1,388,454,842
kafka,PR-12434,9,5,236,66,302
kafka,PR-11390,56,51,2621,213,2834
kafka,PR-12460,1,1,1,1,2
kafka,PR-12448,3,12,156,7,163
kafka,PR-10528,12,42,95,53,148
kafka,PR-12434,10,5,218,67,285
kafka,PR-12461,1,1,1,1,2
kafka,PR-12456,2,7,226,122,348
kafka,PR-12458,2,10,108,53,161
kafka,PR-12447,3,17,549,153,702
kafka,PR-12458,3,10,107,52,159
kafka,PR-12459,2,1,388,454,842
kafka,PR-12434,11,4,91,67,158
kafka,PR-12460,2,1,1,1,2
kafka,PR-12434,12,5,94,67,161
kafka,PR-12450,2,7,81,85,166
kafka,PR-12434,13,5,94,67,161
kafka,PR-12459,3,1,374,457,831
kafka,PR-11608,5,17,692,304,996
kafka,PR-12444,2,11,218,105,323
kafka,PR-12462,1,5,71,13,84
kafka,PR-12463,1,8,14,10,24
kafka,PR-12464,1,1,5,1,6
kafka,PR-12462,2,5,71,13,84
kafka,PR-12465,1,5,308,353,661
kafka,PR-12458,4,10,109,53,162
kafka,PR-12447,4,17,552,156,708
kafka,PR-12467,1,4,122,60,182
kafka,PR-12468,1,2,7,6,13
kafka,PR-12469,1,6,225,0,225
kafka,PR-12274,5,7,55,23,78
kafka,PR-12471,1,1,25,25,50
kafka,PR-12459,4,1,374,457,831
kafka,PR-12472,1,1,188,367,555
kafka,PR-12465,2,5,308,353,661
kafka,PR-12473,1,2,165,270,435
kafka,PR-12467,2,4,123,56,179
kafka,PR-12474,1,2,131,240,371
kafka,PR-12475,1,13,36,35,71
kafka,PR-12449,8,1,130,164,294
kafka,PR-12475,2,13,36,35,71
kafka,PR-12457,2,11,74,23,97
kafka,PR-12468,2,2,8,8,16
kafka,PR-12103,4,4,164,38,202
kafka,PR-12469,2,6,225,0,225
kafka,PR-12476,2,4,586,434,1020
kafka,PR-12468,3,2,8,8,16
kafka,PR-12472,2,1,168,367,535
kafka,PR-12468,4,2,8,8,16
kafka,PR-12473,2,2,166,271,437
kafka,PR-12477,1,2,2,2,4
kafka,PR-12455,4,8,145,76,221
kafka,PR-12478,1,2,28,5,33
kafka,PR-12479,1,4,419,244,663
kafka,PR-12480,1,14,74,81,155
kafka,PR-12479,2,4,419,244,663
kafka,PR-12481,1,3,33,2,35
kafka,PR-12476,3,3,582,433,1015
kafka,PR-12471,2,1,25,25,50
kafka,PR-12449,9,1,131,162,293
kafka,PR-12476,4,3,579,433,1012
kafka,PR-12483,1,2,50,37,87
kafka,PR-12457,3,12,90,24,114
kafka,PR-12448,4,12,156,7,163
kafka,PR-12479,3,5,632,423,1055
kafka,PR-12479,4,4,476,265,741
kafka,PR-12483,2,2,44,23,67
kafka,PR-12229,4,6,6,6,12
kafka,PR-11783,20,8,286,67,353
kafka,PR-12450,3,7,80,86,166
kafka,PR-12484,1,2,12,23,35
kafka,PR-12447,5,17,552,156,708
kafka,PR-12457,4,12,94,24,118
kafka,PR-12485,2,1,4,0,4
kafka,PR-12448,5,12,156,7,163
kafka,PR-12483,3,2,44,23,67
kafka,PR-12479,5,5,537,266,803
kafka,PR-12457,5,12,92,23,115
kafka,PR-12447,6,17,578,165,743
kafka,PR-12448,6,12,156,7,163
kafka,PR-12479,6,5,558,261,819
kafka,PR-12458,5,10,110,54,164
kafka,PR-12447,7,17,586,169,755
kafka,PR-12486,1,2,55,1,56
kafka,PR-12480,2,14,71,78,149
kafka,PR-12487,1,4,118,14,132
kafka,PR-12488,1,1,2,0,2
kafka,PR-12486,2,3,67,2,69
kafka,PR-12489,1,2,48,36,84
kafka,PR-12414,7,8,103,17,120
kafka,PR-12489,2,2,49,37,86
kafka,PR-12489,3,2,50,37,87
kafka,PR-12175,6,4,67,3,70
kafka,PR-12274,6,9,73,39,112
kafka,PR-12490,1,2,5,0,5
kafka,PR-12491,1,1,2,2,4
kafka,PR-12492,1,9,186,195,381
kafka,PR-11390,57,51,2620,213,2833
kafka,PR-12493,1,2,49,53,102
kafka,PR-12486,3,3,67,2,69
kafka,PR-12487,2,4,118,14,132
kafka,PR-12487,3,4,130,16,146
kafka,PR-12494,1,1,72,21,93
kafka,PR-12416,10,2,74,2,76
kafka,PR-12489,4,2,50,37,87
kafka,PR-12495,2,4,16,10,26
kafka,PR-12448,7,16,267,49,316
kafka,PR-12496,1,21,592,231,823
kafka,PR-12416,11,2,74,2,76
kafka,PR-12496,2,21,593,232,825
kafka,PR-12416,12,2,72,2,74
kafka,PR-12450,4,7,105,80,185
kafka,PR-12490,2,1,1,0,1
kafka,PR-12472,3,1,169,371,540
kafka,PR-12489,5,3,58,40,98
kafka,PR-12497,1,4,415,2,417
kafka,PR-12494,2,5,72,21,93
kafka,PR-12450,5,7,104,81,185
kafka,PR-12495,3,4,15,9,24
kafka,PR-12487,6,4,137,40,177
kafka,PR-12496,3,24,653,278,931
kafka,PR-12494,3,5,72,21,93
kafka,PR-12494,4,5,72,21,93
kafka,PR-12458,6,10,110,54,164
kafka,PR-12498,1,2,4,10,14
kafka,PR-12416,13,2,39,2,41
kafka,PR-12499,1,9,262,128,390
kafka,PR-12458,7,10,110,54,164
kafka,PR-12497,2,5,423,30,453
kafka,PR-12414,8,8,95,17,112
kafka,PR-12494,5,5,72,21,93
kafka,PR-11390,58,51,2620,213,2833
kafka,PR-12497,4,5,430,35,465
kafka,PR-12499,2,10,352,168,520
kafka,PR-12498,2,6,51,15,66
kafka,PR-12499,3,13,495,186,681
kafka,PR-12501,1,3,44,3,47
kafka,PR-12416,14,2,48,2,50
kafka,PR-12274,7,9,73,39,112
kafka,PR-12466,2,11,336,188,524
kafka,PR-12497,5,5,430,35,465
kafka,PR-12274,8,9,86,39,125
kafka,PR-12502,1,2,18,2,20
kafka,PR-12503,1,2,24,3,27
kafka,PR-11390,59,51,2620,213,2833
kafka,PR-12504,1,5,162,32,194
kafka,PR-12416,15,2,60,2,62
kafka,PR-12506,1,2,30,6,36
kafka,PR-12498,3,6,51,15,66
kafka,PR-12507,2,2,50,1,51
kafka,PR-12506,2,2,30,6,36
kafka,PR-12416,16,2,43,2,45
kafka,PR-12508,1,5,252,36,288
kafka,PR-12274,9,9,92,52,144
kafka,PR-12497,6,5,430,35,465
kafka,PR-12509,1,4,69,140,209
kafka,PR-12459,5,1,374,457,831
kafka,PR-12502,2,2,19,2,21
kafka,PR-12503,2,2,24,3,27
kafka,PR-12497,7,5,430,35,465
kafka,PR-12501,2,3,44,3,47
kafka,PR-12510,1,1,5,0,5
kafka,PR-12502,3,2,19,2,21
kafka,PR-12511,1,1,5,16,21
kafka,PR-12163,8,2,127,1,128
kafka,PR-12260,8,1,19,11,30
kafka,PR-12509,2,4,69,140,209
kafka,PR-12503,3,2,24,3,27
kafka,PR-12503,4,2,35,2,37
kafka,PR-12230,4,4,23,35,58
kafka,PR-12513,1,24,1227,625,1852
kafka,PR-12469,3,11,398,2,400
kafka,PR-12503,5,2,35,2,37
kafka,PR-12510,2,1,5,0,5
kafka,PR-12514,1,2,30,3,33
kafka,PR-12515,1,1,2,2,4
kafka,PR-12515,2,1,2,2,4
kafka,PR-12517,1,5,82,14,96
kafka,PR-12466,3,11,471,196,667
kafka,PR-12517,2,5,82,14,96
kafka,PR-12519,1,4,82,48,130
kafka,PR-12518,2,6,192,17,209
kafka,PR-12513,3,29,1299,635,1934
kafka,PR-12519,2,4,82,48,130
kafka,PR-12469,4,13,473,47,520
kafka,PR-12469,5,13,474,47,521
kafka,PR-12175,7,4,67,3,70
kafka,PR-12520,1,2,97,0,97
kafka,PR-12175,8,4,67,3,70
kafka,PR-12508,2,5,255,61,316
kafka,PR-12513,4,31,1304,640,1944
kafka,PR-12520,2,2,98,0,98
kafka,PR-12492,2,9,179,195,374
kafka,PR-12523,1,1,1,1,2
kafka,PR-12505,2,12,282,389,671
kafka,PR-12524,1,5,610,840,1450
kafka,PR-12525,1,1,1,2,3
kafka,PR-12469,7,14,471,48,519
kafka,PR-12526,1,1,1,1,2
kafka,PR-12527,1,6,196,400,596
kafka,PR-12290,4,1,56,21,77
kafka,PR-12513,5,31,1306,640,1946
kafka,PR-12528,1,3,58,8,66
kafka,PR-12517,4,5,85,15,100
kafka,PR-12479,10,9,628,379,1007
kafka,PR-12502,4,4,37,5,42
kafka,PR-12530,2,2,1,14,15
kafka,PR-12532,1,3,12,178,190
kafka,PR-12518,6,8,205,23,228
kafka,PR-12479,11,8,560,379,939
kafka,PR-12508,4,5,251,59,310
kafka,PR-12469,8,14,471,48,519
kafka,PR-12508,5,5,248,59,307
kafka,PR-12533,1,4,48,14,62
kafka,PR-12469,9,14,471,48,519
kafka,PR-12469,10,14,473,48,521
kafka,PR-12490,3,2,4,1,5
kafka,PR-12524,2,5,613,840,1453
kafka,PR-11478,23,6,110,8,118
kafka,PR-12534,1,1,31,31,62
kafka,PR-12524,3,5,613,840,1453
kafka,PR-12535,1,4,555,3,558
kafka,PR-12469,11,14,473,48,521
kafka,PR-12528,2,3,58,8,66
kafka,PR-12536,1,11,67,27,94
kafka,PR-11390,60,51,2620,213,2833
kafka,PR-12508,6,6,255,61,316
kafka,PR-12509,3,4,86,157,243
kafka,PR-12533,2,4,42,7,49
kafka,PR-12537,1,1,19,3,22
kafka,PR-12534,2,69,162,162,324
kafka,PR-12508,7,6,255,61,316
kafka,PR-12538,1,4,22,18,40
kafka,PR-12198,3,2,3,3,6
kafka,PR-12533,3,4,39,4,43
kafka,PR-12534,3,69,161,161,322
kafka,PR-12501,3,19,308,34,342
kafka,PR-12538,2,4,35,18,53
kafka,PR-12537,2,1,19,3,22
kafka,PR-12508,8,7,273,65,338
kafka,PR-12513,6,31,1310,641,1951
kafka,PR-12509,4,4,89,160,249
kafka,PR-12537,3,1,19,3,22
kafka,PR-12469,12,14,487,48,535
kafka,PR-12539,1,1,1,1,2
kafka,PR-12541,1,1,5,3,8
kafka,PR-12542,1,1,15,29,44
kafka,PR-12469,13,14,488,48,536
kafka,PR-12543,1,2,36,3,39
kafka,PR-12478,2,3,64,8,72
kafka,PR-12469,14,14,489,48,537
kafka,PR-12490,4,2,6,1,7
kafka,PR-12502,5,4,44,5,49
kafka,PR-12501,4,19,344,39,383
kafka,PR-12508,10,8,281,66,347
kafka,PR-12469,15,14,488,48,536
kafka,PR-12469,16,14,474,48,522
kafka,PR-12543,2,2,36,3,39
kafka,PR-12544,1,8,192,5,197
kafka,PR-12307,2,1,72,45,117
kafka,PR-12475,3,13,41,36,77
kafka,PR-12475,4,14,46,37,83
kafka,PR-12545,1,6,112,25,137
kafka,PR-12546,1,1,7,0,7
kafka,PR-12475,5,14,46,37,83
kafka,PR-12543,3,2,36,3,39
kafka,PR-12414,10,8,93,18,111
kafka,PR-12175,9,4,76,10,86
kafka,PR-12539,2,3,0,3,3
kafka,PR-12547,1,3,165,12,177
kafka,PR-12230,5,4,23,35,58
kafka,PR-12513,9,35,1511,679,2190
kafka,PR-12513,10,36,1438,675,2113
kafka,PR-12548,2,12,445,249,694
kafka,PR-12502,6,4,41,5,46
kafka,PR-12543,4,2,36,3,39
kafka,PR-12459,6,1,249,382,631
kafka,PR-12536,2,16,160,127,287
kafka,PR-12534,4,69,161,161,322
kafka,PR-12473,3,2,189,303,492
kafka,PR-11478,24,6,110,8,118
kafka,PR-12513,11,36,1438,675,2113
kafka,PR-12228,6,18,224,151,375
kafka,PR-12549,1,8,172,45,217
kafka,PR-12550,1,1,2,1,3
kafka,PR-12550,2,2,44,1,45
kafka,PR-12548,3,10,431,269,700
kafka,PR-12551,2,1,12,4,16
kafka,PR-12475,6,13,37,36,73
kafka,PR-12513,12,37,1460,688,2148
kafka,PR-12548,5,11,459,279,738
kafka,PR-12551,3,1,14,4,18
kafka,PR-12552,1,2,11,4,15
kafka,PR-12294,3,10,68,28,96
kafka,PR-12553,1,1,12,0,12
kafka,PR-12103,5,4,164,38,202
kafka,PR-12478,3,3,142,40,182
kafka,PR-12103,6,5,164,39,203
kafka,PR-12478,4,3,144,43,187
kafka,PR-12103,7,4,164,1,165
kafka,PR-12046,10,24,406,98,504
kafka,PR-12554,1,6,479,65,544
kafka,PR-12475,7,13,37,36,73
kafka,PR-12551,4,1,14,4,18
kafka,PR-11478,25,6,110,8,118
kafka,PR-12494,6,5,72,21,93
kafka,PR-12554,2,7,637,69,706
kafka,PR-12548,6,11,456,279,735
kafka,PR-12458,8,10,110,54,164
kafka,PR-12543,5,2,36,3,39
kafka,PR-12556,1,1,7,2,9
kafka,PR-12557,1,1,1,1,2
kafka,PR-12103,8,4,164,1,165
kafka,PR-12480,3,14,71,78,149
kafka,PR-12558,1,15,20,23,43
kafka,PR-12554,3,7,637,69,706
kafka,PR-12478,5,3,144,45,189
kafka,PR-12513,15,38,1481,704,2185
kafka,PR-11390,61,51,2620,213,2833
kafka,PR-12554,4,7,637,69,706
kafka,PR-12559,1,1,12,4,16
kafka,PR-12560,1,1,3,4,7
kafka,PR-12561,1,2,103,28,131
kafka,PR-12562,1,2,103,9,112
kafka,PR-12554,5,7,637,69,706
kafka,PR-12562,2,2,116,22,138
kafka,PR-12563,1,5,27,24,51
kafka,PR-12564,1,15,21,21,42
kafka,PR-12565,1,9,135,59,194
kafka,PR-12565,2,9,135,59,194
kafka,PR-12565,3,10,250,66,316
kafka,PR-12565,4,10,251,66,317
kafka,PR-12561,2,2,116,30,146
kafka,PR-12053,4,2,15,8,23
kafka,PR-12567,1,1,26,24,50
kafka,PR-12053,5,2,14,8,22
kafka,PR-12567,2,3,91,56,147
kafka,PR-12562,3,2,116,22,138
kafka,PR-12568,1,2,78,24,102
kafka,PR-12475,8,13,37,36,73
kafka,PR-12569,1,5,157,15,172
kafka,PR-12570,1,2,91,11,102
kafka,PR-12569,2,7,158,16,174
kafka,PR-12571,1,6,597,283,880
kafka,PR-12566,2,2,29,1,30
kafka,PR-12571,2,6,597,283,880
kafka,PR-12294,4,10,56,17,73
kafka,PR-12539,3,3,0,3,3
kafka,PR-12059,2,1,6,0,6
kafka,PR-12543,6,2,35,3,38
kafka,PR-12475,9,13,40,36,76
kafka,PR-10338,6,1,20,3,23
kafka,PR-12059,3,1,6,0,6
kafka,PR-12459,7,1,249,382,631
kafka,PR-12571,3,9,740,288,1028
kafka,PR-12571,4,9,740,287,1027
kafka,PR-12571,5,9,742,287,1029
kafka,PR-12570,2,3,122,11,133
kafka,PR-12569,3,7,158,16,174
kafka,PR-12519,3,5,220,121,341
kafka,PR-12573,1,2,0,6,6
kafka,PR-12574,1,1,2,0,2
kafka,PR-12294,5,10,56,17,73
kafka,PR-12575,1,1,2,1,3
kafka,PR-12576,1,1,17,3,20
kafka,PR-12576,2,1,15,2,17
kafka,PR-12543,7,2,52,3,55
kafka,PR-12569,4,7,158,16,174
kafka,PR-12561,3,2,139,36,175
kafka,PR-12577,1,11,433,29,462
kafka,PR-12577,2,11,433,29,462
kafka,PR-12519,4,5,232,123,355
kafka,PR-12573,2,2,0,6,6
kafka,PR-12578,1,2,48,12,60
kafka,PR-12578,2,2,49,12,61
kafka,PR-12580,1,1,1,0,1
kafka,PR-12573,3,2,0,6,6
kafka,PR-12478,6,3,147,74,221
kafka,PR-12582,1,1,5,1,6
kafka,PR-12580,2,1,1,0,1
kafka,PR-12578,3,2,49,12,61
kafka,PR-12561,4,2,139,36,175
kafka,PR-12583,1,4,301,266,567
kafka,PR-12584,1,2,19,1,20
kafka,PR-12414,11,8,93,16,109
kafka,PR-12414,12,8,95,16,111
kafka,PR-12578,5,2,49,12,61
kafka,PR-12519,5,5,232,123,355
kafka,PR-12585,1,2,7,10,17
kafka,PR-12540,3,3,6331,0,6331
kafka,PR-12543,8,2,63,3,66
kafka,PR-12478,7,3,144,74,218
kafka,PR-12584,2,2,19,1,20
kafka,PR-12586,1,2,78,57,135
kafka,PR-12584,3,2,14,1,15
kafka,PR-12586,3,3,88,59,147
kafka,PR-12587,1,1,30,21,51
kafka,PR-12588,3,1,1,1,2
kafka,PR-12478,8,3,147,76,223
kafka,PR-12568,2,2,77,23,100
kafka,PR-12561,5,2,232,47,279
kafka,PR-12020,4,4,409,10,419
kafka,PR-12561,6,2,231,47,278
kafka,PR-12583,3,4,303,267,570
kafka,PR-12589,1,2,33,4,37
kafka,PR-12590,1,8,335,163,498
kafka,PR-12583,4,4,303,267,570
kafka,PR-12465,3,5,309,354,663
kafka,PR-12555,9,16,1289,54,1343
kafka,PR-12588,4,1,1,1,2
kafka,PR-12590,3,8,352,167,519
kafka,PR-12561,7,3,233,50,283
kafka,PR-12592,1,1,1,1,2
kafka,PR-12590,4,8,361,167,528
kafka,PR-12478,9,3,169,76,245
kafka,PR-12594,1,1,12,16,28
kafka,PR-12595,2,2,165,42,207
kafka,PR-12596,1,2,18,3,21
kafka,PR-12597,1,1,21,0,21
kafka,PR-12594,3,2,18,18,36
kafka,PR-12588,6,1,1,1,2
kafka,PR-12567,3,3,34,29,63
kafka,PR-12583,5,4,303,267,570
kafka,PR-12590,5,8,361,167,528
kafka,PR-12598,1,2,29,1,30
kafka,PR-12599,1,2,30,1,31
kafka,PR-12567,4,3,34,29,63
kafka,PR-12561,8,3,227,50,277
kafka,PR-12600,1,4,711,132,843
kafka,PR-12414,14,8,95,16,111
kafka,PR-12596,2,2,90,13,103
kafka,PR-12601,2,1,1,6,7
kafka,PR-12595,3,2,165,42,207
kafka,PR-12602,1,1,4,0,4
kafka,PR-12601,3,1,1,6,7
kafka,PR-12604,1,1,31,1,32
kafka,PR-12605,1,1,0,1,1
kafka,PR-12603,2,1,17,2,19
kafka,PR-12596,3,2,83,5,88
kafka,PR-12478,10,3,147,76,223
kafka,PR-12606,1,1,5,5,10
kafka,PR-12608,2,2,23,1,24
kafka,PR-12598,2,2,28,1,29
kafka,PR-12609,1,1,3,2,5
kafka,PR-12414,15,8,95,16,111
kafka,PR-12603,4,2,75,38,113
kafka,PR-12610,2,1,15,18,33
kafka,PR-12609,2,1,4,2,6
kafka,PR-12603,6,2,75,38,113
kafka,PR-12611,1,2,41,1,42
kafka,PR-12612,1,1,0,62,62
kafka,PR-12613,1,1,2,2,4
kafka,PR-12608,4,3,97,23,120
kafka,PR-12615,1,4,203,291,494
kafka,PR-12600,3,4,700,155,855
kafka,PR-12596,5,2,83,5,88
kafka,PR-12609,3,1,4,2,6
kafka,PR-12561,9,3,237,38,275
kafka,PR-12555,11,17,1498,53,1551
kafka,PR-12597,3,1,21,0,21
kafka,PR-12611,2,2,41,1,42
kafka,PR-12611,3,2,41,1,42
kafka,PR-12611,7,2,41,1,42
kafka,PR-12617,1,1,2,2,4
kafka,PR-12618,1,1,0,4,4
kafka,PR-12619,1,4,81,1,82
kafka,PR-12603,10,4,144,35,179
kafka,PR-12614,2,2,115,33,148
kafka,PR-12620,1,1,1,1,2
kafka,PR-12621,2,3,36,31,67
kafka,PR-12591,2,32,66,84,150
kafka,PR-12622,1,1,1,3,4
kafka,PR-12596,6,2,83,5,88
kafka,PR-12616,3,1,9,3,12
kafka,PR-12590,7,7,364,161,525
kafka,PR-12623,2,1,15,12,27
kafka,PR-12603,11,4,144,35,179
kafka,PR-12624,2,71,402,6,408
kafka,PR-12625,1,2,75,38,113
kafka,PR-12626,1,4,55,9,64
kafka,PR-12596,7,2,89,5,94
kafka,PR-12624,3,71,412,6,418
kafka,PR-12626,2,4,55,9,64
kafka,PR-12625,3,2,112,51,163
kafka,PR-12597,4,1,21,0,21
kafka,PR-12603,22,4,108,1,109
kafka,PR-12624,4,71,412,6,418
kafka,PR-12626,3,4,55,9,64
kafka,PR-12630,1,1,5,0,5
kafka,PR-12631,1,2,383,249,632
kafka,PR-12629,2,1,1,3,4
kafka,PR-12600,6,6,931,171,1102
kafka,PR-12590,9,7,362,161,523
kafka,PR-12614,3,2,110,33,143
kafka,PR-12622,2,1,1,3,4
kafka,PR-12600,7,6,931,171,1102
kafka,PR-12632,1,4,25,12,37
kafka,PR-12634,1,2,7,3,10
kafka,PR-12630,4,1,5,0,5
kafka,PR-12635,1,1,2,0,2
kafka,PR-12637,1,8,636,69,705
kafka,PR-12634,2,3,8,10,18
kafka,PR-12631,2,3,383,371,754
kafka,PR-12634,3,4,10,11,21
kafka,PR-12615,4,7,252,369,621
kafka,PR-12631,3,6,390,378,768
kafka,PR-12632,3,4,26,12,38
kafka,PR-12631,4,2,3,2,5
kafka,PR-12639,1,1,4,0,4
kafka,PR-12640,1,1,1,0,1
kafka,PR-12637,2,8,697,65,762
kafka,PR-12641,1,4,135,19,154
kafka,PR-12636,4,10,381,162,543
kafka,PR-12634,4,4,9,11,20
kafka,PR-12602,3,2,58,21,79
kafka,PR-12639,2,1,4,0,4
kafka,PR-12636,5,10,372,163,535
kafka,PR-12636,6,10,372,163,535
kafka,PR-12639,3,1,4,0,4
kafka,PR-12638,3,19,154,55,209
kafka,PR-12641,2,4,135,19,154
kafka,PR-12644,1,11,1213,52,1265
kafka,PR-12645,1,1,9,6,15
kafka,PR-12645,2,1,9,6,15
kafka,PR-12646,2,40,308,2743,3051
kafka,PR-12638,4,19,154,55,209
kafka,PR-12637,3,15,1261,90,1351
kafka,PR-12647,1,3,75,0,75
kafka,PR-12646,3,39,304,2740,3044
kafka,PR-12648,1,1,4,3,7
kafka,PR-12649,1,1,1,1,2
kafka,PR-12638,5,19,154,55,209
kafka,PR-12632,4,5,27,13,40
kafka,PR-12651,1,2,96,5,101
kafka,PR-12632,6,5,32,14,46
kafka,PR-12652,1,1,2,2,4
kafka,PR-12637,4,15,1266,90,1356
kafka,PR-12654,1,4,89,7,96
kafka,PR-12655,3,2,72,8,80
kafka,PR-12653,6,5,132,24,156
kafka,PR-12655,4,2,72,8,80
kafka,PR-12653,7,5,132,24,156
kafka,PR-12645,3,1,9,6,15
kafka,PR-12639,4,1,4,0,4
kafka,PR-12656,1,1,1,1,2
kafka,PR-12653,9,5,132,24,156
kafka,PR-12656,3,4,4,4,8
kafka,PR-12657,1,1,3,0,3
kafka,PR-12658,1,1,2,1,3
kafka,PR-12659,1,3,41,0,41
kafka,PR-12639,5,1,4,0,4
kafka,PR-12660,2,3,9,7,16
kafka,PR-12661,1,4,23,18,41
kafka,PR-12650,3,2,39,21,60
kafka,PR-12632,7,5,31,13,44
kafka,PR-12656,4,3,3,3,6
kafka,PR-12653,11,5,132,24,156
kafka,PR-12652,2,1,2,2,4
kafka,PR-12636,7,10,262,163,425
kafka,PR-12628,6,3,156,89,245
kafka,PR-12664,1,2,17,1,18
kafka,PR-12663,4,4,113,0,113
kafka,PR-12628,7,2,102,78,180
kafka,PR-12614,4,2,110,33,143
kafka,PR-12628,8,2,128,78,206
kafka,PR-12590,10,7,362,161,523
kafka,PR-12665,1,1,1,1,2
kafka,PR-12664,2,3,20,3,23
kafka,PR-12637,8,15,1390,97,1487
kafka,PR-12667,1,1,15,9,24
kafka,PR-12628,9,2,129,86,215
kafka,PR-12666,3,4,440,2,442
kafka,PR-12668,1,1,23,23,46
kafka,PR-12647,2,3,75,0,75
kafka,PR-12643,1,31,172,94,266
kafka,PR-12665,2,1,1,1,2
kafka,PR-12652,3,1,2,2,4
kafka,PR-12669,1,1,39,30,69
kafka,PR-12637,11,16,1528,113,1641
kafka,PR-12641,6,5,157,23,180
kafka,PR-12671,1,2,17,6,23
kafka,PR-12668,2,1,24,24,48
kafka,PR-12666,4,4,449,2,451
kafka,PR-12643,2,31,172,94,266
kafka,PR-12663,5,4,122,0,122
kafka,PR-12663,10,4,152,0,152
kafka,PR-12673,7,2,29,4,33
kafka,PR-12663,11,4,152,0,152
kafka,PR-12594,6,2,22,18,40
kafka,PR-12674,1,5,96,20,116
kafka,PR-12590,11,7,335,161,496
kafka,PR-12675,4,5,6,6,12
kafka,PR-12676,1,3,331,0,331
kafka,PR-12677,1,1,59,125,184
kafka,PR-12678,1,2,26,10,36
kafka,PR-12678,2,2,29,10,39
kafka,PR-12679,2,1,156,0,156
kafka,PR-12674,12,6,139,134,273
kafka,PR-12670,12,2,88,156,244
kafka,PR-12680,1,49,1293,2755,4048
kafka,PR-12669,2,1,40,31,71
kafka,PR-12677,2,1,68,126,194
kafka,PR-12659,5,7,122,182,304
kafka,PR-12681,2,2,14,3,17
kafka,PR-12666,5,5,643,2,645
kafka,PR-12682,5,1,109,17,126
kafka,PR-12679,7,3,207,4,211
kafka,PR-12683,1,2,28,8,36
kafka,PR-12684,1,2,4,3,7
kafka,PR-12685,1,15,287,59,346
kafka,PR-12644,5,11,1112,38,1150
kafka,PR-12687,2,2,23,4,27
kafka,PR-12666,6,5,643,2,645
kafka,PR-12680,2,49,1293,2755,4048
kafka,PR-12688,1,1,0,177,177
kafka,PR-12637,12,15,1555,110,1665
kafka,PR-12682,7,1,112,17,129
kafka,PR-12642,3,2,120,14,134
kafka,PR-12690,1,1,26,10,36
kafka,PR-12683,2,2,28,8,36
kafka,PR-12683,5,2,28,8,36
kafka,PR-12683,7,2,28,8,36
kafka,PR-12663,12,5,262,0,262
kafka,PR-12682,10,1,144,17,161
kafka,PR-12691,1,1,2,2,4
kafka,PR-12689,2,1,41,0,41
kafka,PR-12637,13,16,1760,121,1881
kafka,PR-12637,14,17,1891,121,2012
kafka,PR-12692,1,5,95,5,100
kafka,PR-12691,2,1,2,2,4
kafka,PR-12659,8,7,115,185,300
kafka,PR-12693,1,1,7,1,8
kafka,PR-12669,3,1,38,44,82
kafka,PR-12637,16,18,2504,251,2755
kafka,PR-12688,2,1,0,168,168
kafka,PR-12590,12,7,362,161,523
kafka,PR-12669,4,1,38,44,82
kafka,PR-12637,17,18,2534,260,2794
kafka,PR-12680,4,53,1519,3245,4764
kafka,PR-12663,20,5,268,0,268
kafka,PR-12672,5,7,575,0,575
kafka,PR-12637,18,18,2569,260,2829
kafka,PR-12634,5,4,12,14,26
kafka,PR-12659,9,7,110,196,306
kafka,PR-12694,4,2,11,8,19
kafka,PR-12695,1,1,42,11,53
kafka,PR-12695,2,3,84,13,97
kafka,PR-12637,20,18,2727,260,2987
kafka,PR-12639,6,1,24,9,33
kafka,PR-12694,5,2,11,8,19
kafka,PR-12697,1,2,11,8,19
kafka,PR-12672,6,7,641,0,641
kafka,PR-12698,4,2,169,0,169
kafka,PR-12683,8,2,42,8,50
kafka,PR-12663,23,5,279,0,279
kafka,PR-12699,1,4,208,0,208
kafka,PR-12700,1,1,1,1,2
kafka,PR-12704,1,2,6,6,12
kafka,PR-12700,2,1,1,1,2
kafka,PR-12705,1,2,373,0,373
kafka,PR-12685,3,15,300,63,363
kafka,PR-12706,2,1,253,0,253
kafka,PR-12703,3,5,325,9,334
kafka,PR-12685,4,15,304,68,372
kafka,PR-12699,2,4,208,0,208
kafka,PR-12663,24,5,276,0,276
kafka,PR-12698,6,3,173,1,174
kafka,PR-12672,10,8,654,0,654
kafka,PR-12703,4,7,329,13,342
kafka,PR-12663,26,5,278,0,278
kafka,PR-12685,5,15,317,69,386
kafka,PR-12707,1,3,6,3,9
kafka,PR-12700,3,1,1,1,2
kafka,PR-12672,11,8,777,0,777
kafka,PR-12672,16,9,603,12,615
kafka,PR-12708,1,8,10,9,19
kafka,PR-12709,1,7,3,34,37
kafka,PR-12672,19,9,619,12,631
kafka,PR-12710,1,1,1,1,2
kafka,PR-12711,1,5,162,1,163
kafka,PR-12712,1,3,81,0,81
kafka,PR-12713,1,1,1,1,2
kafka,PR-12710,2,1,1,1,2
kafka,PR-12644,6,11,1102,38,1140
kafka,PR-12644,7,11,1103,39,1142
kafka,PR-12672,22,9,612,12,624
kafka,PR-12672,25,11,674,12,686
kafka,PR-12714,1,4,7,1,8
kafka,PR-12715,2,40,834,207,1041
kafka,PR-12716,3,2,22,2,24
kafka,PR-12715,3,41,835,208,1043
kafka,PR-12717,1,3,285,264,549
kafka,PR-12718,1,1,1,1,2
kafka,PR-12637,21,18,2727,260,2987
kafka,PR-12719,1,4,11,6,17
kafka,PR-12637,22,18,2744,260,3004
kafka,PR-12720,2,4,603,486,1089
kafka,PR-12676,3,3,331,0,331
kafka,PR-12721,1,1,10,4,14
kafka,PR-12722,1,1,5,5,10
kafka,PR-12672,26,11,701,12,713
kafka,PR-12723,1,3,3,3,6
kafka,PR-12724,1,2,3,3,6
kafka,PR-12637,24,18,2748,260,3008
kafka,PR-12707,2,3,6,3,9
kafka,PR-12692,3,3,67,5,72
kafka,PR-12725,1,2,266,466,732
kafka,PR-12727,1,1,30,7,37
kafka,PR-12726,2,2,47,22,69
kafka,PR-12709,4,5,41,28,69
kafka,PR-12728,2,2,241,337,578
kafka,PR-12725,3,2,266,466,732
kafka,PR-12727,2,2,127,23,150
kafka,PR-12727,3,5,91,10,101
kafka,PR-12709,5,5,49,28,77
kafka,PR-12684,2,2,20,4,24
kafka,PR-12728,3,2,239,340,579
kafka,PR-12729,1,5,91,10,101
kafka,PR-12709,7,5,51,28,79
kafka,PR-12577,4,11,441,29,470
kafka,PR-12709,9,5,66,37,103
kafka,PR-12634,6,4,12,14,26
kafka,PR-12709,10,5,66,37,103
kafka,PR-12637,25,19,2777,260,3037
kafka,PR-12577,5,11,441,29,470
kafka,PR-12730,1,2,54,2,56
kafka,PR-12731,1,1,1,1,2
kafka,PR-12726,3,2,48,23,71
kafka,PR-12672,34,10,695,16,711
kafka,PR-12732,1,1,2,3,5
kafka,PR-12733,1,5,63,37,100
kafka,PR-12672,37,10,722,16,738
kafka,PR-12637,26,19,2882,260,3142
kafka,PR-12734,1,2,76,0,76
kafka,PR-12736,1,2,30,1,31
kafka,PR-12672,38,10,723,16,739
kafka,PR-12738,2,1,12,12,24
kafka,PR-12737,2,2,157,0,157
kafka,PR-12715,8,40,863,216,1079
kafka,PR-12738,3,1,20,11,31
kafka,PR-12736,4,3,54,19,73
kafka,PR-12739,2,1,66,58,124
kafka,PR-12740,1,7,42,34,76
kafka,PR-12741,1,2,28,25,53
kafka,PR-12742,1,10,201,34,235
kafka,PR-12637,27,19,3010,260,3270
kafka,PR-12735,5,1,124,170,294
kafka,PR-12739,3,1,67,58,125
kafka,PR-12743,1,3,62,14,76
kafka,PR-12744,1,4,303,4,307
kafka,PR-12672,39,10,723,16,739
kafka,PR-12741,2,2,28,25,53
kafka,PR-12736,5,3,56,19,75
kafka,PR-12745,1,19,350,835,1185
kafka,PR-12743,3,3,66,15,81
kafka,PR-12741,3,2,28,25,53
kafka,PR-12738,5,1,26,13,39
kafka,PR-12747,2,4,111,20,131
kafka,PR-12688,3,1,0,168,168
kafka,PR-12744,4,4,303,4,307
kafka,PR-12744,3,4,303,4,307
kafka,PR-12744,7,4,303,4,307
kafka,PR-12739,4,1,67,59,126
kafka,PR-12735,6,1,124,168,292
kafka,PR-12743,4,3,66,15,81
kafka,PR-12748,3,7,149,16,165
kafka,PR-12743,5,3,66,15,81
kafka,PR-12749,1,2,26,9,35
kafka,PR-12750,1,1,6,4,10
kafka,PR-12751,1,1,4,4,8
kafka,PR-12752,1,3,28,1,29
kafka,PR-12637,28,19,2993,260,3253
kafka,PR-12744,10,4,303,4,307
kafka,PR-12744,14,4,303,4,307
kafka,PR-12753,1,3,6,2,8
kafka,PR-12744,16,4,303,4,307
kafka,PR-12744,17,4,281,4,285
kafka,PR-12754,1,6,476,5,481
kafka,PR-12753,2,3,6,2,8
kafka,PR-12756,1,18,834,350,1184
kafka,PR-12752,2,3,28,1,29
kafka,PR-12757,1,1,2,2,4
kafka,PR-12729,2,5,123,16,139
kafka,PR-12735,7,1,131,168,299
kafka,PR-12758,1,67,317,124,441
kafka,PR-12748,4,8,152,17,169
kafka,PR-12735,8,1,126,170,296
kafka,PR-12748,5,8,152,17,169
kafka,PR-12711,7,4,165,0,165
kafka,PR-12735,9,2,127,171,298
kafka,PR-12680,5,56,1573,3257,4830
kafka,PR-12743,6,2,42,1,43
kafka,PR-12752,3,3,23,3,26
kafka,PR-12760,1,4,71,16,87
kafka,PR-12761,1,8,216,32,248
kafka,PR-12760,2,4,71,16,87
kafka,PR-12762,2,2,45,2,47
kafka,PR-12749,2,2,41,10,51
kafka,PR-12752,4,3,38,2,40
kafka,PR-12763,1,1,1,0,1
kafka,PR-12749,3,2,41,10,51
kafka,PR-12764,1,1,2,3,5
kafka,PR-12672,40,10,710,16,726
kafka,PR-12765,1,2,30,9,39
kafka,PR-12758,2,68,318,127,445
kafka,PR-12762,3,2,43,2,45
kafka,PR-12753,3,3,6,2,8
kafka,PR-12766,1,1,2,2,4
kafka,PR-12767,1,2,1,1,2
kafka,PR-12761,6,15,460,112,572
kafka,PR-12613,2,1,2,2,4
kafka,PR-12758,3,68,318,127,445
kafka,PR-12748,8,7,129,12,141
kafka,PR-12760,3,4,71,16,87
kafka,PR-12768,1,2,7,3,10
kafka,PR-12769,1,2,17,3,20
kafka,PR-12770,1,19,207,199,406
kafka,PR-12761,7,14,452,112,564
kafka,PR-12672,41,10,787,25,812
kafka,PR-12748,11,10,203,47,250
kafka,PR-12771,1,6,43,2,45
kafka,PR-12772,1,4,61,27,88
kafka,PR-12590,13,7,366,161,527
kafka,PR-12773,1,2,13,0,13
kafka,PR-12774,2,2,47,2,49
kafka,PR-12758,4,64,251,123,374
kafka,PR-12684,4,4,30,5,35
kafka,PR-12775,1,3,135,28,163
kafka,PR-12777,2,1,52,54,106
kafka,PR-12739,6,1,58,62,120
kafka,PR-12647,3,3,86,0,86
kafka,PR-12752,5,3,37,2,39
kafka,PR-12752,6,3,38,2,40
kafka,PR-12753,5,4,167,2,169
kafka,PR-12753,6,4,173,2,175
kafka,PR-12752,7,3,35,2,37
kafka,PR-12778,1,4,65,2,67
kafka,PR-12752,8,3,35,2,37
kafka,PR-12779,1,1,1,1,2
kafka,PR-12781,1,3,76,85,161
kafka,PR-12728,4,2,235,342,577
kafka,PR-12728,6,2,235,346,581
kafka,PR-12637,29,20,3140,264,3404
kafka,PR-12725,9,2,313,493,806
kafka,PR-12779,2,1,1,1,2
kafka,PR-12782,1,1,7,4,11
kafka,PR-12781,2,3,77,92,169
kafka,PR-12783,4,7,158,9,167
kafka,PR-12775,6,4,528,37,565
kafka,PR-12783,5,8,161,11,172
kafka,PR-12675,8,6,10,7,17
kafka,PR-12784,1,1,11,8,19
kafka,PR-12777,3,1,48,54,102
kafka,PR-12785,1,6,11,8,19
kafka,PR-12786,1,1,1,1,2
kafka,PR-12771,2,7,50,5,55
kafka,PR-12760,6,4,70,16,86
kafka,PR-12779,3,1,1,1,2
kafka,PR-12671,2,2,17,6,23
kafka,PR-12728,10,2,233,351,584
kafka,PR-12775,7,4,528,37,565
kafka,PR-12787,1,1,2,2,4
kafka,PR-12789,1,3,49,8,57
kafka,PR-12788,3,4,528,37,565
kafka,PR-12790,2,2,27,2,29
kafka,PR-12781,5,3,71,94,165
kafka,PR-12728,12,3,235,375,610
kafka,PR-12784,2,2,11,9,20
kafka,PR-12791,1,2,35,25,60
kafka,PR-12728,14,3,280,371,651
kafka,PR-12792,1,3,135,28,163
kafka,PR-12784,3,2,16,12,28
kafka,PR-12784,5,2,9,8,17
kafka,PR-12728,15,3,281,371,652
kafka,PR-12781,7,3,88,119,207
kafka,PR-12725,10,2,315,494,809
kafka,PR-12792,3,4,192,28,220
kafka,PR-12769,2,2,17,3,20
kafka,PR-12792,4,4,527,37,564
kafka,PR-12577,10,14,1159,29,1188
kafka,PR-12753,7,4,84,2,86
kafka,PR-12783,7,9,233,15,248
kafka,PR-12794,1,2,0,68,68
kafka,PR-12793,3,1,6,1,7
kafka,PR-12753,8,4,84,2,86
kafka,PR-12728,17,3,296,379,675
kafka,PR-12769,3,2,17,3,20
kafka,PR-12772,2,2,42,4,46
kafka,PR-12773,2,2,23,0,23
kafka,PR-12577,13,14,1162,33,1195
kafka,PR-12795,1,4,47,43,90
kafka,PR-12789,3,6,111,34,145
kafka,PR-12796,2,2,35,0,35
kafka,PR-12791,2,2,32,25,57
kafka,PR-12797,2,2,8,11,19
kafka,PR-12792,6,4,527,37,564
kafka,PR-12796,3,2,35,0,35
kafka,PR-12797,3,4,19,26,45
kafka,PR-12792,9,4,525,37,562
kafka,PR-12797,4,5,22,30,52
kafka,PR-12798,1,1,5,5,10
kafka,PR-12799,1,1,1,1,2
kafka,PR-12798,2,1,5,5,10
kafka,PR-12775,9,4,519,37,556
kafka,PR-12800,1,2,60,5,65
kafka,PR-12753,9,4,89,3,92
kafka,PR-12801,1,4,128,50,178
kafka,PR-12802,1,2,36,1,37
kafka,PR-12771,3,7,50,5,55
kafka,PR-12804,1,4,39,16,55
kafka,PR-12789,5,7,187,48,235
kafka,PR-12725,11,2,306,502,808
kafka,PR-12806,5,3,119,13,132
kafka,PR-12807,1,10,1659,43,1702
kafka,PR-12728,18,3,307,386,693
kafka,PR-12781,8,3,88,119,207
kafka,PR-12753,10,4,89,3,92
kafka,PR-12808,1,4,45,4,49
kafka,PR-12809,1,2,1,34,35
kafka,PR-12810,1,1,0,1,1
kafka,PR-12783,8,13,235,28,263
kafka,PR-12666,8,5,441,10,451
kafka,PR-12806,6,3,127,13,140
kafka,PR-12810,3,1,2,3,5
kafka,PR-12809,2,2,1,34,35
kafka,PR-12811,1,20,1,0,1
kafka,PR-12781,9,3,90,123,213
kafka,PR-12812,1,1,10,5,15
kafka,PR-12807,3,17,2140,100,2240
kafka,PR-12813,1,8,72,17,89
kafka,PR-12804,2,4,44,28,72
kafka,PR-12807,4,17,2140,100,2240
kafka,PR-12577,14,14,1166,35,1201
kafka,PR-12816,1,26,523,87,610
kafka,PR-12783,9,12,232,20,252
kafka,PR-12817,1,13,244,325,569
kafka,PR-12818,1,6,369,473,842
kafka,PR-12666,10,5,441,10,451
kafka,PR-12756,2,20,799,355,1154
kafka,PR-12776,10,80,3919,3024,6943
kafka,PR-12819,1,1,2,2,4
kafka,PR-12684,5,4,37,5,42
kafka,PR-12817,2,12,271,432,703
kafka,PR-12753,11,4,89,3,92
kafka,PR-12783,10,12,257,38,295
kafka,PR-12794,2,2,0,68,68
kafka,PR-12821,1,2,116,260,376
kafka,PR-12822,1,2,15,7,22
kafka,PR-12823,1,1,33,78,111
kafka,PR-12817,3,12,281,432,713
kafka,PR-12806,7,3,127,13,140
kafka,PR-12824,1,1,1,1,2
kafka,PR-12825,1,8,120,14,134
kafka,PR-12806,10,4,152,16,168
kafka,PR-12783,11,13,275,37,312
kafka,PR-12822,2,2,15,8,23
kafka,PR-12685,7,15,325,70,395
kafka,PR-12826,2,3,110,56,166
kafka,PR-12804,3,4,55,39,94
kafka,PR-12773,3,2,23,0,23
kafka,PR-12823,3,1,62,82,144
kafka,PR-12772,3,2,42,4,46
kafka,PR-12809,3,2,12,13,25
kafka,PR-12825,2,8,120,14,134
kafka,PR-12827,2,5,83,0,83
kafka,PR-12808,3,5,53,4,57
kafka,PR-12577,16,16,960,48,1008
kafka,PR-12783,12,13,278,39,317
kafka,PR-12814,2,10,4317,1897,6214
kafka,PR-12776,11,83,3948,3037,6985
kafka,PR-12783,13,13,277,39,316
kafka,PR-12830,1,1,3,3,6
kafka,PR-12783,14,13,278,39,317
kafka,PR-12829,2,5,16,27,43
kafka,PR-12783,15,13,278,39,317
kafka,PR-12808,4,5,53,4,57
kafka,PR-12577,17,16,967,48,1015
kafka,PR-12748,12,10,249,81,330
kafka,PR-12795,4,6,84,95,179
kafka,PR-12827,4,5,82,0,82
kafka,PR-12577,18,16,1019,50,1069
kafka,PR-12831,6,7,2037,1808,3845
kafka,PR-12832,2,6,25,25,50
kafka,PR-12828,2,11,138,153,291
kafka,PR-12805,3,12,440,63,503
kafka,PR-12776,12,83,3948,3036,6984
kafka,PR-12833,1,3,8,3,11
kafka,PR-12577,19,16,1029,50,1079
kafka,PR-12834,1,8,2055,1812,3867
kafka,PR-12577,20,16,1034,50,1084
kafka,PR-12835,1,4,104,35,139
kafka,PR-12783,16,13,284,39,323
kafka,PR-12836,1,1,17,25,42
kafka,PR-12748,14,10,272,88,360
kafka,PR-12795,5,6,108,124,232
kafka,PR-12577,24,16,1085,50,1135
kafka,PR-12735,10,2,118,189,307
kafka,PR-12777,4,1,46,56,102
kafka,PR-12828,3,11,139,156,295
kafka,PR-12830,2,1,3,3,6
kafka,PR-12833,2,6,29,19,48
kafka,PR-12838,1,6,268,149,417
kafka,PR-12839,1,5,166,175,341
kafka,PR-12840,1,2,14,14,28
kafka,PR-12835,2,5,129,58,187
kafka,PR-12840,2,2,14,14,28
kafka,PR-12841,1,1,21,6,27
kafka,PR-12748,18,10,292,132,424
kafka,PR-12795,7,6,99,141,240
kafka,PR-12577,27,16,1081,50,1131
kafka,PR-12809,6,2,57,13,70
kafka,PR-12795,8,6,99,141,240
kafka,PR-12577,28,16,1081,50,1131
kafka,PR-12838,2,7,302,150,452
kafka,PR-12842,2,2,1,23,24
kafka,PR-12783,17,13,289,39,328
kafka,PR-12837,4,8,500,309,809
kafka,PR-12753,12,4,89,3,92
kafka,PR-12835,3,5,129,58,187
kafka,PR-12835,4,5,129,58,187
kafka,PR-12783,18,13,289,39,328
kafka,PR-12836,3,2,49,57,106
kafka,PR-12753,13,4,91,3,94
kafka,PR-12840,3,2,14,14,28
kafka,PR-12809,7,2,57,13,70
kafka,PR-12782,2,1,7,4,11
kafka,PR-12753,14,4,91,3,94
kafka,PR-12843,1,9,158,113,271
kafka,PR-12844,1,17,389,105,494
kafka,PR-12783,19,13,289,39,328
kafka,PR-12844,2,18,403,108,511
kafka,PR-12845,2,17,523,238,761
kafka,PR-12846,1,5,113,35,148
kafka,PR-12847,1,5,258,115,373
kafka,PR-12845,3,17,523,238,761
kafka,PR-12848,1,5,181,29,210
kafka,PR-12845,4,17,523,238,761
kafka,PR-12783,20,13,289,39,328
kafka,PR-12850,1,7,343,72,415
kafka,PR-12577,30,16,1081,50,1131
kafka,PR-12577,31,16,1081,50,1131
kafka,PR-12837,5,8,501,311,812
kafka,PR-12851,2,1,1,1,2
kafka,PR-12852,1,27,52,52,104
kafka,PR-12853,1,5,290,59,349
kafka,PR-12854,1,2,4,2,6
kafka,PR-12840,4,2,14,14,28
kafka,PR-12855,1,5,224,80,304
kafka,PR-12853,3,5,293,59,352
kafka,PR-12729,3,5,139,16,155
kafka,PR-12843,3,10,157,113,270
kafka,PR-12856,3,2,3,3,6
kafka,PR-12858,1,5,278,22,300
kafka,PR-12861,1,2,118,6,124
kafka,PR-12859,2,2,5,5,10
kafka,PR-12857,3,1,3,3,6
kafka,PR-12856,5,5,47,19,66
kafka,PR-12828,5,14,374,167,541
kafka,PR-12783,21,13,289,39,328
kafka,PR-12863,3,2,20,0,20
kafka,PR-12864,1,10,76,23,99
kafka,PR-12845,5,17,530,237,767
kafka,PR-12865,1,1,94,116,210
kafka,PR-12859,3,2,5,5,10
kafka,PR-12856,6,2,17,10,27
kafka,PR-12864,3,9,75,22,97
kafka,PR-12843,5,10,154,116,270
kafka,PR-12839,2,5,171,173,344
kafka,PR-12861,4,2,139,6,145
kafka,PR-12867,2,2,24,2,26
kafka,PR-12828,7,14,409,144,553
kafka,PR-12843,6,10,151,119,270
kafka,PR-12868,1,1,1,1,2
kafka,PR-12753,15,4,91,3,94
kafka,PR-12869,3,2,19,2,21
kafka,PR-12748,21,10,349,132,481
kafka,PR-12845,6,10,504,222,726
kafka,PR-12843,7,10,151,119,270
kafka,PR-12869,4,4,113,32,145
kafka,PR-12870,1,6,448,108,556
kafka,PR-12845,7,10,561,227,788
kafka,PR-12778,2,3,54,0,54
kafka,PR-12828,8,14,409,144,553
kafka,PR-12870,2,6,454,108,562
kafka,PR-12847,2,5,258,115,373
kafka,PR-12855,2,5,224,80,304
kafka,PR-12866,2,8,173,91,264
kafka,PR-12862,2,12,633,134,767
kafka,PR-12872,1,3,35,2,37
kafka,PR-12872,2,3,35,2,37
kafka,PR-12862,3,13,723,138,861
kafka,PR-12845,8,10,558,227,785
kafka,PR-12801,2,1,59,35,94
kafka,PR-12859,4,3,11,6,17
kafka,PR-12875,1,4,161,49,210
kafka,PR-12862,4,13,764,149,913
kafka,PR-12761,9,14,451,112,563
kafka,PR-12876,1,2,177,148,325
kafka,PR-12842,3,2,1,23,24
kafka,PR-12869,6,4,98,32,130
kafka,PR-12877,1,4,139,10,149
kafka,PR-12761,10,14,453,112,565
kafka,PR-12753,16,4,91,3,94
kafka,PR-12878,1,2,7,2,9
kafka,PR-12859,5,1,4,4,8
kafka,PR-12879,1,5,19,32,51
kafka,PR-12880,1,1,2,2,4
kafka,PR-12778,4,3,54,0,54
kafka,PR-12882,4,2,14,4,18
kafka,PR-12845,9,10,560,228,788
kafka,PR-12870,5,6,463,108,571
kafka,PR-12761,11,14,454,113,567
kafka,PR-12884,1,1,2,1,3
kafka,PR-12862,7,13,829,169,998
kafka,PR-12885,1,7,38,19,57
kafka,PR-12761,13,14,460,113,573
kafka,PR-12882,5,2,14,4,18
kafka,PR-12837,6,9,520,312,832
kafka,PR-12887,1,1,1,5,6
kafka,PR-12805,4,12,569,107,676
kafka,PR-12882,6,2,14,4,18
kafka,PR-12862,8,13,873,212,1085
kafka,PR-12888,1,1,121,0,121
kafka,PR-12753,17,4,69,3,72
kafka,PR-12886,3,11,802,330,1132
kafka,PR-12753,20,4,70,3,73
kafka,PR-12889,1,1,5,2,7
kafka,PR-12845,10,10,573,229,802
kafka,PR-12862,9,13,872,212,1084
kafka,PR-12886,4,11,835,330,1165
kafka,PR-12891,1,6,27,8,35
kafka,PR-12890,2,3,23,5,28
kafka,PR-12805,6,20,604,116,720
kafka,PR-12856,8,3,5,5,10
kafka,PR-12892,1,7,104,28,132
kafka,PR-12884,2,1,2,1,3
kafka,PR-12862,10,13,902,224,1126
kafka,PR-12893,1,1,1,1,2
kafka,PR-12884,4,1,2,1,3
kafka,PR-12894,1,1,5,2,7
kafka,PR-12877,3,4,146,10,156
kafka,PR-12813,2,6,60,7,67
kafka,PR-12895,1,40,800,0,800
kafka,PR-12837,7,11,536,312,848
kafka,PR-12896,1,7,193,59,252
kafka,PR-12897,1,3,124,13,137
kafka,PR-12886,6,11,827,330,1157
kafka,PR-12753,22,4,70,3,73
kafka,PR-12845,12,9,468,231,699
kafka,PR-12898,1,1,1,1,2
kafka,PR-12886,8,11,1153,330,1483
kafka,PR-12899,1,23,1133,825,1958
kafka,PR-12886,10,11,1153,330,1483
kafka,PR-12900,1,26,40,40,80
kafka,PR-12901,1,10,1076,341,1417
kafka,PR-12876,2,2,166,146,312
kafka,PR-12813,3,6,60,7,67
kafka,PR-12902,1,9,673,316,989
kafka,PR-12903,1,1,41,16,57
kafka,PR-12846,2,5,114,35,149
kafka,PR-12904,1,7,174,113,287
kafka,PR-12902,3,9,931,316,1247
kafka,PR-12607,2,1,635,955,1590
kafka,PR-12905,1,1,1,1,2
kafka,PR-12890,3,3,23,5,28
kafka,PR-12902,4,9,929,317,1246
kafka,PR-12902,5,9,929,317,1246
kafka,PR-12903,2,1,40,19,59
kafka,PR-12875,3,8,204,113,317
kafka,PR-12753,23,4,70,3,73
kafka,PR-12904,2,7,174,113,287
kafka,PR-12906,1,1,1,1,2
kafka,PR-12748,24,10,388,132,520
kafka,PR-12906,2,2,3,3,6
kafka,PR-12890,4,5,111,16,127
kafka,PR-12876,3,2,166,147,313
kafka,PR-12895,3,40,815,0,815
kafka,PR-12753,26,4,70,3,73
kafka,PR-12906,3,4,6,3,9
kafka,PR-12892,2,7,104,28,132
kafka,PR-12906,5,5,7,3,10
kafka,PR-12909,1,2,3,5,8
kafka,PR-12910,1,2,68,5,73
kafka,PR-12899,2,23,1187,825,2012
kafka,PR-12908,2,1,15,12,27
kafka,PR-12892,3,7,104,28,132
kafka,PR-12875,4,3,30,0,30
kafka,PR-12911,1,6,76,37,113
kafka,PR-12912,1,3,10,10,20
kafka,PR-12908,3,1,16,12,28
kafka,PR-12897,2,3,90,13,103
kafka,PR-12910,2,2,68,5,73
kafka,PR-12876,5,2,148,104,252
kafka,PR-12885,3,8,53,24,77
kafka,PR-12914,1,20,1647,602,2249
kafka,PR-12892,4,7,104,28,132
kafka,PR-12897,3,3,90,13,103
kafka,PR-12915,1,4,32,4,36
kafka,PR-12916,1,4,8,9,17
kafka,PR-12748,25,12,386,131,517
kafka,PR-12912,2,3,10,10,20
kafka,PR-12914,2,20,1647,602,2249
kafka,PR-12917,1,6,27,14,41
kafka,PR-12918,2,3,4,4,8
kafka,PR-12885,4,9,55,25,80
kafka,PR-12919,1,1,4,4,8
kafka,PR-12847,3,5,248,114,362
kafka,PR-12920,4,2,40,15,55
kafka,PR-12915,2,4,56,8,64
kafka,PR-12922,1,2,162,4,166
kafka,PR-12918,9,4,7,9,16
kafka,PR-12923,1,1,0,1,1
kafka,PR-12897,5,4,94,14,108
kafka,PR-12885,5,9,75,27,102
kafka,PR-12921,4,2,6,6,12
kafka,PR-12837,8,17,583,334,917
kafka,PR-12862,11,13,924,224,1148
kafka,PR-12918,11,3,4,4,8
kafka,PR-12924,1,1,8,7,15
kafka,PR-12862,12,13,927,224,1151
kafka,PR-12897,6,5,97,16,113
kafka,PR-12918,12,4,7,8,15
kafka,PR-12748,26,12,370,131,501
kafka,PR-12847,4,6,266,120,386
kafka,PR-12848,4,5,169,28,197
kafka,PR-12906,6,6,9,5,14
kafka,PR-12850,3,7,324,73,397
kafka,PR-12925,1,2,13,57,70
kafka,PR-12853,5,5,274,58,332
kafka,PR-12855,4,5,226,76,302
kafka,PR-12925,2,2,13,57,70
kafka,PR-12858,3,5,267,21,288
kafka,PR-12847,5,6,266,120,386
kafka,PR-12848,5,5,169,28,197
kafka,PR-12748,27,12,370,131,501
kafka,PR-12897,7,5,97,16,113
kafka,PR-12899,3,25,1245,826,2071
kafka,PR-12847,6,6,266,120,386
kafka,PR-12858,4,5,267,21,288
kafka,PR-12898,2,1,1,1,2
kafka,PR-12862,14,14,956,224,1180
kafka,PR-12885,8,9,75,27,102
kafka,PR-12926,1,1,36,0,36
kafka,PR-12837,9,17,583,334,917
kafka,PR-12847,7,6,266,120,386
kafka,PR-12915,3,2,38,5,43
kafka,PR-12897,8,6,117,16,133
kafka,PR-12885,9,9,75,27,102
kafka,PR-12895,4,62,1256,0,1256
kafka,PR-12837,10,18,601,334,935
kafka,PR-12929,2,1,6,7,13
kafka,PR-12930,2,4,75,3,78
kafka,PR-12915,4,3,39,6,45
kafka,PR-12802,2,2,37,2,39
kafka,PR-12931,1,1,2,2,4
kafka,PR-12925,3,2,13,57,70
kafka,PR-12914,3,21,1672,632,2304
kafka,PR-12932,1,6,254,11,265
kafka,PR-12898,3,1,4,0,4
kafka,PR-12848,6,5,167,28,195
kafka,PR-12821,3,2,132,258,390
kafka,PR-12892,6,9,277,51,328
kafka,PR-12893,2,2,16,2,18
kafka,PR-12933,1,1,6,6,12
kafka,PR-12607,3,1,655,977,1632
kafka,PR-12935,2,5,17,73,90
kafka,PR-12938,1,1,1,1,2
kafka,PR-12941,1,3,216,4,220
kafka,PR-12942,3,1,1,0,1
kafka,PR-12885,11,9,75,27,102
kafka,PR-12898,4,1,4,0,4
kafka,PR-12934,3,1,50,0,50
kafka,PR-12892,11,9,284,52,336
kafka,PR-12896,3,9,195,88,283
kafka,PR-12837,13,19,632,334,966
kafka,PR-12915,5,3,64,6,70
kafka,PR-12862,16,15,1135,231,1366
kafka,PR-12928,4,14,301,13,314
kafka,PR-12942,4,1,1,0,1
kafka,PR-12847,10,6,266,131,397
kafka,PR-12932,6,6,240,11,251
kafka,PR-12935,3,3,17,39,56
kafka,PR-12940,3,1,12,13,25
kafka,PR-12912,3,3,10,10,20
kafka,PR-12933,2,1,6,6,12
kafka,PR-12847,11,6,266,131,397
kafka,PR-12932,7,6,240,11,251
kafka,PR-12928,5,19,327,32,359
kafka,PR-12932,8,6,240,11,251
kafka,PR-12850,6,7,315,74,389
kafka,PR-12939,6,1,3,3,6
kafka,PR-12862,18,15,1123,231,1354
kafka,PR-12915,7,3,63,6,69
kafka,PR-12928,7,20,328,33,361
kafka,PR-12893,3,2,21,2,23
kafka,PR-12945,1,7,926,812,1738
kafka,PR-12753,27,4,70,3,73
kafka,PR-12933,3,1,6,6,12
kafka,PR-12940,4,1,12,13,25
kafka,PR-12908,4,1,16,12,28
kafka,PR-12800,2,2,69,6,75
kafka,PR-12947,1,3,189,142,331
kafka,PR-12948,1,1,19,0,19
kafka,PR-12949,1,2,0,149,149
kafka,PR-12950,1,5,15,104,119
kafka,PR-12675,9,6,10,7,17
kafka,PR-12950,2,5,15,104,119
kafka,PR-12729,4,5,137,16,153
kafka,PR-12950,3,5,15,104,119
kafka,PR-12675,10,6,10,7,17
kafka,PR-12951,2,15,552,404,956
kafka,PR-12952,1,7,18,25,43
kafka,PR-12675,11,7,13,10,23
kafka,PR-12862,19,17,1334,233,1567
kafka,PR-12951,3,15,552,404,956
kafka,PR-12950,4,5,15,104,119
kafka,PR-12862,20,17,1332,232,1564
kafka,PR-12675,12,7,13,10,23
kafka,PR-12948,2,1,19,0,19
kafka,PR-12953,3,3,2,6,8
kafka,PR-12951,4,15,552,404,956
kafka,PR-12939,7,1,42,42,84
kafka,PR-12853,6,5,264,60,324
kafka,PR-12803,5,16,837,38,875
kafka,PR-12846,3,5,110,35,145
kafka,PR-12855,5,7,349,78,427
kafka,PR-12853,7,5,264,60,324
kafka,PR-12939,9,1,3,3,6
kafka,PR-12932,11,6,260,13,273
kafka,PR-12948,3,1,19,0,19
kafka,PR-12951,5,15,552,404,956
kafka,PR-12954,1,13,78,32,110
kafka,PR-12932,12,6,260,13,273
kafka,PR-12800,3,2,47,10,57
kafka,PR-12892,12,9,286,52,338
kafka,PR-12893,4,2,23,2,25
kafka,PR-12955,2,4,30,14,44
kafka,PR-12944,2,4,59,5,64
kafka,PR-12915,8,3,63,6,69
kafka,PR-12956,1,6,120,17,137
kafka,PR-12957,1,1,1,1,2
kafka,PR-12958,1,7,148,113,261
kafka,PR-12944,3,4,70,6,76
kafka,PR-12954,2,13,136,32,168
kafka,PR-12935,4,4,71,37,108
kafka,PR-12932,13,6,260,13,273
kafka,PR-12903,3,1,43,20,63
kafka,PR-12959,1,4,43,26,69
kafka,PR-12955,3,16,220,137,357
kafka,PR-12937,3,14,281,0,281
kafka,PR-12946,7,10,1261,67,1328
kafka,PR-12958,2,7,150,113,263
kafka,PR-12946,8,11,1364,67,1431
kafka,PR-12961,1,29,291,75,366
kafka,PR-12960,3,5,11,7,18
kafka,PR-12961,2,29,296,75,371
kafka,PR-12962,1,11,154,88,242
kafka,PR-12935,6,4,76,38,114
kafka,PR-12955,4,4,30,14,44
kafka,PR-12947,2,3,186,142,328
kafka,PR-12944,4,4,69,5,74
kafka,PR-12961,3,29,316,76,392
kafka,PR-12855,6,7,347,77,424
kafka,PR-12932,14,7,307,13,320
kafka,PR-12962,2,11,154,88,242
kafka,PR-12862,28,17,1336,274,1610
kafka,PR-12932,15,7,307,13,320
kafka,PR-12956,2,6,120,17,137
kafka,PR-12753,28,4,70,3,73
kafka,PR-12946,12,12,1423,68,1491
kafka,PR-12729,6,5,137,16,153
kafka,PR-12967,1,11,22,44,66
kafka,PR-12963,3,23,251,195,446
kafka,PR-12965,5,10,366,32,398
kafka,PR-12968,1,2,18,4,22
kafka,PR-12969,1,6,51,21,72
kafka,PR-12970,1,3,22,24,46
kafka,PR-12964,4,19,558,146,704
kafka,PR-12862,32,19,1362,274,1636
kafka,PR-12961,4,29,331,111,442
kafka,PR-12951,6,16,553,405,958
kafka,PR-12971,4,1,20,16,36
kafka,PR-12962,3,11,154,88,242
kafka,PR-12729,7,5,137,16,153
kafka,PR-12855,7,5,262,77,339
kafka,PR-12855,8,5,269,76,345
kafka,PR-12962,6,11,198,84,282
kafka,PR-12972,1,21,561,23,584
kafka,PR-12941,7,2,215,3,218
kafka,PR-12944,7,4,69,5,74
kafka,PR-12856,9,3,4,4,8
kafka,PR-12802,3,1,2,1,3
kafka,PR-12965,6,20,573,45,618
kafka,PR-12973,1,2,39,26,65
kafka,PR-12956,3,6,189,40,229
kafka,PR-12965,7,20,600,45,645
kafka,PR-12974,1,2,21,3,24
kafka,PR-12975,1,2,75,22,97
kafka,PR-12961,6,29,331,121,452
kafka,PR-12973,2,2,39,26,65
kafka,PR-12976,1,7,31,62,93
kafka,PR-12956,4,7,218,44,262
kafka,PR-12956,5,7,218,44,262
kafka,PR-12977,1,4,66,115,181
kafka,PR-12802,4,1,2,1,3
kafka,PR-12753,29,4,70,3,73
kafka,PR-12862,33,19,1381,280,1661
kafka,PR-12964,5,19,558,146,704
kafka,PR-12855,10,5,269,75,344
kafka,PR-12858,7,5,252,20,272
kafka,PR-12947,3,3,232,157,389
kafka,PR-12978,1,1,4,11,15
kafka,PR-12979,1,3,14,5,19
kafka,PR-12972,4,23,601,29,630
kafka,PR-12855,11,5,269,75,344
kafka,PR-12973,4,5,164,51,215
kafka,PR-12937,5,14,284,0,284
kafka,PR-12965,8,21,608,47,655
kafka,PR-12980,1,15,195,128,323
kafka,PR-12975,2,2,75,22,97
kafka,PR-12944,8,4,69,5,74
kafka,PR-12972,6,24,602,29,631
kafka,PR-12973,5,5,164,51,215
kafka,PR-12862,34,19,1381,280,1661
kafka,PR-12961,7,32,332,123,455
kafka,PR-12982,1,1,12,1,13
kafka,PR-12981,2,10,90,66,156
kafka,PR-12944,9,4,69,5,74
kafka,PR-12984,2,7,187,41,228
kafka,PR-12972,7,24,602,29,631
kafka,PR-12858,8,5,252,20,272
kafka,PR-12985,1,1,0,1,1
kafka,PR-12985,2,1,2,2,4
kafka,PR-12973,7,5,161,51,212
kafka,PR-12944,10,4,69,5,74
kafka,PR-12973,8,5,161,51,212
kafka,PR-12983,3,38,1868,1113,2981
kafka,PR-12965,9,21,608,47,655
kafka,PR-12945,3,7,926,807,1733
kafka,PR-12983,4,38,1868,1116,2984
kafka,PR-12973,9,5,166,57,223
kafka,PR-12987,1,1,1,0,1
kafka,PR-12753,30,4,71,3,74
kafka,PR-12906,11,7,11,5,16
kafka,PR-12968,2,2,14,4,18
kafka,PR-12862,41,19,1364,289,1653
kafka,PR-12983,7,40,1869,1360,3229
kafka,PR-12947,6,3,234,152,386
kafka,PR-12988,2,2,10,5,15
kafka,PR-12753,32,4,71,3,74
kafka,PR-12906,12,8,13,5,18
kafka,PR-12972,8,24,602,29,631
kafka,PR-12858,9,5,252,20,272
kafka,PR-12982,2,1,12,1,13
kafka,PR-12989,1,1,3,3,6
kafka,PR-12979,2,3,14,5,19
kafka,PR-12990,1,7,778,152,930
kafka,PR-12991,1,1,4,2,6
kafka,PR-12895,10,40,816,0,816
kafka,PR-12862,45,19,1400,289,1689
kafka,PR-12941,8,2,217,3,220
kafka,PR-12979,3,3,14,5,19
kafka,PR-12961,10,38,383,143,526
kafka,PR-12992,1,2,168,0,168
kafka,PR-12993,1,15,223,105,328
kafka,PR-12994,1,15,394,320,714
kafka,PR-12995,1,2,106,23,129
kafka,PR-12997,2,1,14,9,23
kafka,PR-12998,2,6,538,3,541
kafka,PR-12947,7,3,234,152,386
kafka,PR-12753,33,4,71,3,74
kafka,PR-12906,13,10,20,9,29
kafka,PR-12821,4,2,132,278,410
kafka,PR-12995,2,4,157,27,184
kafka,PR-12865,2,1,99,153,252
kafka,PR-12999,1,16,45,848,893
kafka,PR-12862,46,19,1398,289,1687
kafka,PR-12968,4,2,14,4,18
kafka,PR-12995,3,5,198,51,249
kafka,PR-12983,9,42,2486,1361,3847
kafka,PR-12977,2,4,66,115,181
kafka,PR-13000,1,2,14,4,18
kafka,PR-13002,2,2,66,2,68
kafka,PR-13001,2,4,68,49,117
kafka,PR-12994,3,16,668,321,989
kafka,PR-13002,8,2,66,2,68
kafka,PR-13002,6,2,66,2,68
kafka,PR-12821,5,2,142,273,415
kafka,PR-13004,1,10,9901,5,9906
kafka,PR-13005,1,2,79,0,79
kafka,PR-12802,5,2,88,17,105
kafka,PR-13002,10,2,66,2,68
kafka,PR-12993,2,15,223,105,328
kafka,PR-12870,6,6,444,109,553
kafka,PR-12984,4,12,255,61,316
kafka,PR-12997,3,1,14,9,23
kafka,PR-12865,3,1,99,153,252
kafka,PR-12994,4,16,681,321,1002
kafka,PR-12982,3,1,12,1,13
kafka,PR-13002,11,2,66,2,68
kafka,PR-12996,4,29,763,438,1201
kafka,PR-13006,1,2,2,2,4
kafka,PR-12996,5,29,775,448,1223
kafka,PR-12996,6,29,775,448,1223
kafka,PR-13007,3,34,1392,920,2312
kafka,PR-13008,3,2,4,2,6
kafka,PR-13011,2,23,266,317,583
kafka,PR-12996,8,19,558,346,904
kafka,PR-13007,5,27,1190,831,2021
kafka,PR-13009,2,31,1441,1038,2479
kafka,PR-13010,2,33,1722,1258,2980
kafka,PR-13012,1,78,3490,2903,6393
kafka,PR-13002,12,2,66,2,68
kafka,PR-13011,3,23,265,317,582
kafka,PR-12996,9,19,556,344,900
kafka,PR-13013,2,7,145,93,238
kafka,PR-12979,4,3,14,5,19
kafka,PR-12996,10,19,556,344,900
kafka,PR-12997,4,1,14,9,23
kafka,PR-13004,2,10,9927,6,9933
kafka,PR-13013,3,7,143,104,247
kafka,PR-13013,4,7,145,104,249
kafka,PR-13015,1,2,7,3,10
kafka,PR-13016,1,1,13,13,26
kafka,PR-12735,15,2,125,190,315
kafka,PR-13004,3,10,9927,6,9933
kafka,PR-13017,1,2,22,3,25
kafka,PR-13014,2,1,37,28,65
kafka,PR-12996,11,19,556,344,900
kafka,PR-13007,7,27,1188,829,2017
kafka,PR-13009,4,31,1436,1036,2472
kafka,PR-13010,3,33,1717,1256,2973
kafka,PR-13018,1,2,7,13,20
kafka,PR-13021,4,4,412,2,414
kafka,PR-12801,3,1,59,37,96
kafka,PR-13019,2,2,34,2,36
kafka,PR-13022,1,1,3,1,4
kafka,PR-13009,5,17,884,696,1580
kafka,PR-12959,5,4,38,27,65
kafka,PR-13023,1,2,39,1,40
kafka,PR-13010,6,21,1418,1091,2509
kafka,PR-13012,4,71,3191,2741,5932
kafka,PR-12994,5,16,765,322,1087
kafka,PR-13007,9,8,631,485,1116
kafka,PR-13021,6,9,610,33,643
kafka,PR-13016,2,1,13,13,26
kafka,PR-13009,7,11,280,239,519
kafka,PR-13004,5,14,14536,9,14545
kafka,PR-13010,7,16,834,653,1487
kafka,PR-13022,2,1,3,1,4
kafka,PR-13021,11,9,639,33,672
kafka,PR-13004,7,14,14537,9,14546
kafka,PR-13005,2,2,88,0,88
kafka,PR-13023,2,2,39,1,40
kafka,PR-12979,5,3,14,5,19
kafka,PR-13010,8,16,834,653,1487
kafka,PR-13009,8,11,280,239,519
kafka,PR-13023,3,2,42,1,43
kafka,PR-13011,4,24,303,317,620
kafka,PR-13024,1,1,33,24,57
kafka,PR-13025,2,2,61,44,105
kafka,PR-13026,1,1,2,1,3
kafka,PR-13014,4,1,37,29,66
kafka,PR-12945,4,7,926,807,1733
kafka,PR-13021,12,9,645,39,684
kafka,PR-13010,9,11,562,422,984
kafka,PR-13023,4,2,42,1,43
kafka,PR-13012,6,47,2181,1851,4032
kafka,PR-13001,6,4,70,49,119
kafka,PR-13029,2,3,15,3,18
kafka,PR-13004,8,14,14537,9,14546
kafka,PR-13010,10,11,558,422,980
kafka,PR-13030,1,1,16,8,24
kafka,PR-13004,9,18,19925,2196,22121
kafka,PR-13024,2,1,33,24,57
kafka,PR-13031,1,1,1,1,2
kafka,PR-13012,8,38,1624,1431,3055
kafka,PR-13032,1,2,48,1,49
kafka,PR-13004,10,18,20035,2186,22221
kafka,PR-13014,5,1,37,29,66
kafka,PR-12959,6,4,38,27,65
kafka,PR-13017,2,2,43,24,67
kafka,PR-13004,11,18,20035,2186,22221
kafka,PR-13012,9,38,1624,1431,3055
kafka,PR-12870,7,9,805,124,929
kafka,PR-13034,1,1,0,1,1
kafka,PR-13032,3,2,67,1,68
kafka,PR-12979,6,3,14,5,19
kafka,PR-13029,4,2,8,1,9
kafka,PR-12886,12,10,628,133,761
kafka,PR-13035,1,2,39,3,42
kafka,PR-13012,10,39,1653,1448,3101
kafka,PR-13036,1,1,15,7,22
kafka,PR-13028,3,15,714,117,831
kafka,PR-13027,1,8,58,45,103
kafka,PR-13004,12,18,20035,2186,22221
kafka,PR-12979,7,3,14,5,19
kafka,PR-13037,1,1,1,0,1
kafka,PR-13035,2,2,39,3,42
kafka,PR-13038,2,26,237,198,435
kafka,PR-12979,8,3,27,13,40
kafka,PR-12802,8,2,46,19,65
kafka,PR-13036,2,1,16,10,26
kafka,PR-13041,1,47,143,108,251
kafka,PR-13042,2,10,303,227,530
kafka,PR-12906,14,10,20,9,29
kafka,PR-13039,2,26,227,193,420
kafka,PR-13036,3,1,16,10,26
kafka,PR-13042,4,10,304,227,531
kafka,PR-13039,3,31,349,243,592
kafka,PR-13038,3,26,237,198,435
kafka,PR-13037,2,1,24,8,32
kafka,PR-13044,1,1,1,1,2
kafka,PR-13041,2,47,140,108,248
kafka,PR-12979,9,3,27,13,40
kafka,PR-13045,1,1,1,0,1
kafka,PR-13042,5,10,304,227,531
kafka,PR-13046,2,28,883,762,1645
kafka,PR-12948,4,1,5,61,66
kafka,PR-13046,4,28,895,773,1668
kafka,PR-13046,5,28,895,775,1670
kafka,PR-12984,5,14,550,62,612
kafka,PR-13046,6,28,922,800,1722
kafka,PR-12886,13,10,627,133,760
kafka,PR-12886,14,10,627,133,760
kafka,PR-13037,3,1,18,8,26
kafka,PR-12948,5,2,8,61,69
kafka,PR-13038,4,26,217,195,412
kafka,PR-12590,17,8,482,221,703
kafka,PR-13027,2,9,81,49,130
kafka,PR-13048,1,2,46,45,91
kafka,PR-13047,3,2,2,12,14
kafka,PR-12813,4,6,83,18,101
kafka,PR-12936,3,8,163,0,163
kafka,PR-13038,5,26,217,195,412
kafka,PR-13037,4,1,14,8,22
kafka,PR-13048,2,2,46,45,91
kafka,PR-13050,1,1,4,4,8
kafka,PR-13049,7,102,1667,1592,3259
kafka,PR-13051,1,1,1,1,2
kafka,PR-13049,8,102,1671,1592,3263
kafka,PR-13049,9,102,1673,1592,3265
kafka,PR-13052,1,2,19,6,25
kafka,PR-13053,1,1,20,0,20
kafka,PR-13055,1,1,0,3,3
kafka,PR-13046,9,29,936,819,1755
kafka,PR-13046,10,28,936,816,1752
kafka,PR-13057,1,1,2,2,4
kafka,PR-13046,11,28,963,826,1789
kafka,PR-13039,4,8,123,53,176
kafka,PR-13058,1,4,182,46,228
kafka,PR-13059,1,3,12,2,14
kafka,PR-13039,6,6,122,51,173
kafka,PR-13060,2,1,11,13,24
kafka,PR-13053,2,1,20,0,20
kafka,PR-13061,1,2,44,1,45
kafka,PR-13062,1,1,3,2,5
kafka,PR-13063,1,1,20,1,21
kafka,PR-13064,1,3,5,2,7
kafka,PR-13063,2,1,21,2,23
kafka,PR-13043,6,16,776,410,1186
kafka,PR-13043,7,16,791,423,1214
kafka,PR-13039,8,16,186,95,281
kafka,PR-13049,10,102,1673,1592,3265
kafka,PR-13065,2,2,64,6,70
kafka,PR-13067,2,6,285,35,320
kafka,PR-13052,2,2,19,6,25
kafka,PR-13068,1,1,4,1,5
kafka,PR-13069,1,1,6,1,7
kafka,PR-13049,11,102,1673,1596,3269
kafka,PR-13052,3,2,18,6,24
kafka,PR-12998,15,50,1886,244,2130
kafka,PR-13070,1,1,1,1,2
kafka,PR-13071,1,1,5,1,6
kafka,PR-12802,10,2,46,19,65
kafka,PR-13072,1,1,3,3,6
kafka,PR-13073,1,2,3,3,6
kafka,PR-13065,4,2,67,6,73
kafka,PR-13025,4,10,122,59,181
kafka,PR-13071,2,1,7,1,8
kafka,PR-13074,1,1,0,2,2
kafka,PR-13075,1,1,3,3,6
kafka,PR-13076,1,5,15,6,21
kafka,PR-13077,1,11,1346,5,1351
kafka,PR-12782,3,1,7,4,11
kafka,PR-13058,3,4,189,53,242
kafka,PR-13065,5,2,67,6,73
kafka,PR-13078,1,6,115,0,115
kafka,PR-13043,9,13,682,373,1055
kafka,PR-13079,2,1,1,1,2
kafka,PR-13079,3,1,1,1,2
kafka,PR-13043,10,13,682,373,1055
kafka,PR-13043,11,12,683,371,1054
kafka,PR-12742,8,10,201,34,235
kafka,PR-13080,1,5,206,200,406
kafka,PR-13043,13,12,662,380,1042
kafka,PR-13081,1,1,3,1,4
kafka,PR-13077,3,11,1346,5,1351
kafka,PR-12998,19,48,1340,167,1507
kafka,PR-13082,1,2,21,5,26
kafka,PR-13075,2,2,59,4,63
kafka,PR-13063,3,1,21,2,23
kafka,PR-13083,1,1,1,1,2
kafka,PR-13064,2,4,6,3,9
kafka,PR-13084,1,1,2,1,3
kafka,PR-13043,14,12,670,381,1051
kafka,PR-12797,5,5,18,26,44
kafka,PR-13085,2,42,632,392,1024
kafka,PR-13075,5,2,59,4,63
kafka,PR-13086,1,1,1,0,1
kafka,PR-13087,1,1,2,2,4
kafka,PR-12995,4,5,198,51,249
kafka,PR-12998,21,50,1351,174,1525
kafka,PR-13032,4,2,68,1,69
kafka,PR-13075,7,2,61,4,65
kafka,PR-13078,3,7,131,8,139
kafka,PR-13046,14,29,974,829,1803
kafka,PR-13046,15,29,982,830,1812
kafka,PR-13043,15,12,663,380,1043
kafka,PR-13046,16,29,982,830,1812
kafka,PR-13085,3,42,632,386,1018
kafka,PR-13043,16,12,666,380,1046
kafka,PR-13090,1,1,2,2,4
kafka,PR-13043,17,12,665,377,1042
kafka,PR-13091,2,2,57,32,89
kafka,PR-13085,4,42,632,386,1018
kafka,PR-13090,2,1,2,2,4
kafka,PR-13085,6,42,595,447,1042
kafka,PR-13056,4,4,72,51,123
kafka,PR-13092,1,51,604,453,1057
kafka,PR-12998,24,55,1384,180,1564
kafka,PR-13046,17,29,975,824,1799
kafka,PR-13032,8,2,68,1,69
kafka,PR-13094,1,61,276,334,610
kafka,PR-13080,2,5,206,200,406
kafka,PR-12998,25,55,1384,180,1564
kafka,PR-12870,8,9,799,124,923
kafka,PR-12886,15,10,627,133,760
kafka,PR-12901,2,10,635,126,761
kafka,PR-12802,11,2,46,19,65
kafka,PR-13096,2,19,28,50,78
kafka,PR-13094,2,62,284,339,623
kafka,PR-13097,1,4,21,24,45
kafka,PR-12886,16,10,627,133,760
kafka,PR-13092,2,52,605,453,1058
kafka,PR-12870,9,9,799,124,923
kafka,PR-13092,3,52,613,460,1073
kafka,PR-13077,4,14,1358,7,1365
kafka,PR-13058,5,4,189,53,242
kafka,PR-12797,6,5,18,26,44
kafka,PR-13099,1,6,178,26,204
kafka,PR-13100,2,2,29,0,29
kafka,PR-12886,17,10,628,133,761
kafka,PR-13084,2,2,3,2,5
kafka,PR-12902,7,6,490,94,584
kafka,PR-12886,18,10,628,133,761
kafka,PR-13101,1,4,35,4,39
kafka,PR-13102,1,1,0,1,1
kafka,PR-13092,4,52,613,460,1073
kafka,PR-13103,1,14,121,61,182
kafka,PR-13104,1,2,26,2,28
kafka,PR-13096,3,19,28,50,78
kafka,PR-13089,5,10,266,126,392
kafka,PR-13092,6,52,613,460,1073
kafka,PR-13094,3,60,274,327,601
kafka,PR-12886,19,10,625,134,759
kafka,PR-12901,3,10,632,127,759
kafka,PR-13102,3,2,47,2,49
kafka,PR-13103,2,14,121,61,182
kafka,PR-13096,8,21,31,40,71
kafka,PR-13104,4,4,117,22,139
kafka,PR-13089,6,10,340,129,469
kafka,PR-13081,4,6,210,2,212
kafka,PR-13104,5,4,126,26,152
kafka,PR-13059,2,3,12,2,14
kafka,PR-13105,1,2,2,2,4
kafka,PR-12992,2,2,168,0,168
kafka,PR-13102,4,2,47,2,49
kafka,PR-12886,20,10,627,134,761
kafka,PR-12901,5,7,643,128,771
kafka,PR-13104,6,4,130,26,156
kafka,PR-13106,1,11,29,28,57
kafka,PR-13107,1,4,111,37,148
kafka,PR-13085,9,42,583,457,1040
kafka,PR-13108,1,10,52,53,105
kafka,PR-13109,1,1,1,1,2
kafka,PR-12902,8,6,488,94,582
kafka,PR-13110,2,3,43,3,46
kafka,PR-12990,2,7,779,153,932
kafka,PR-13111,2,3,80,19,99
kafka,PR-13110,4,4,45,5,50
kafka,PR-12902,9,6,488,94,582
kafka,PR-13112,1,11,207,51,258
kafka,PR-13046,19,29,947,799,1746
kafka,PR-13113,1,2,20,1,21
kafka,PR-13111,3,3,80,19,99
kafka,PR-12587,3,2,45,43,88
kafka,PR-13059,3,3,12,2,14
kafka,PR-13060,3,1,11,13,24
kafka,PR-13067,5,43,568,444,1012
kafka,PR-13115,1,1,1,1,2
kafka,PR-13114,3,24,998,25,1023
kafka,PR-13117,1,2,13,0,13
kafka,PR-13118,1,3,7,7,14
kafka,PR-13119,1,1,6,4,10
kafka,PR-12902,10,6,488,94,582
kafka,PR-13116,3,2,69,11,80
kafka,PR-13095,5,4,402,180,582
kafka,PR-13040,6,31,908,801,1709
kafka,PR-13120,2,100,449,291,740
kafka,PR-13121,1,1,3,6,9
kafka,PR-13095,6,3,325,179,504
kafka,PR-13046,20,29,951,803,1754
kafka,PR-13040,7,31,927,819,1746
kafka,PR-13116,4,2,116,14,130
kafka,PR-13095,7,4,312,179,491
kafka,PR-13040,8,31,928,820,1748
kafka,PR-12902,12,6,498,94,592
kafka,PR-13046,21,27,952,801,1753
kafka,PR-13112,9,18,790,201,991
kafka,PR-13112,10,18,790,201,991
kafka,PR-13046,22,27,952,801,1753
kafka,PR-12972,10,28,688,36,724
kafka,PR-13124,1,2,3,2,5
kafka,PR-13040,9,31,929,820,1749
kafka,PR-13125,1,2,22,0,22
kafka,PR-13067,6,43,565,441,1006
kafka,PR-13117,2,2,13,0,13
kafka,PR-13095,8,4,313,179,492
kafka,PR-13095,9,4,312,179,491
kafka,PR-13107,2,4,93,28,121
kafka,PR-13112,11,16,297,112,409
kafka,PR-13125,2,2,22,0,22
kafka,PR-12992,3,2,168,0,168
kafka,PR-13112,12,20,317,132,449
kafka,PR-13112,14,19,316,131,447
kafka,PR-13126,2,2,833,0,833
kafka,PR-13021,13,11,694,40,734
kafka,PR-13128,1,1,2,0,2
kafka,PR-13129,1,1,1,0,1
kafka,PR-13130,3,4,99,15,114
kafka,PR-12821,6,2,142,273,415
kafka,PR-12818,2,6,369,473,842
kafka,PR-12984,6,7,202,27,229
kafka,PR-13131,1,37,612,503,1115
kafka,PR-12821,7,2,146,273,419
kafka,PR-13112,15,22,328,143,471
kafka,PR-13119,2,1,12,5,17
kafka,PR-13112,16,22,328,143,471
kafka,PR-13114,4,24,988,25,1013
kafka,PR-13129,3,1,3,2,5
kafka,PR-13132,1,8,20,16,36
kafka,PR-13133,1,4,8,8,16
kafka,PR-13134,1,1,1,1,2
kafka,PR-13135,1,4,74,24,98
kafka,PR-13125,3,4,52,0,52
kafka,PR-13137,1,34,1955,852,2807
kafka,PR-13138,1,11,365,376,741
kafka,PR-12813,8,6,118,15,133
kafka,PR-13138,2,11,365,376,741
kafka,PR-13139,1,1,8,9,17
kafka,PR-13126,3,2,850,0,850
kafka,PR-13140,2,5,37,11,48
kafka,PR-13142,1,7,197,50,247
kafka,PR-13143,1,11,1001,50,1051
kafka,PR-13141,2,21,226,239,465
kafka,PR-13144,1,6,45,10,55
kafka,PR-13136,4,43,1147,805,1952
kafka,PR-13131,2,37,617,499,1116
kafka,PR-13136,7,39,1059,773,1832
kafka,PR-13141,6,21,244,261,505
kafka,PR-13141,8,21,271,276,547
kafka,PR-13145,1,1,0,3,3
kafka,PR-13094,4,60,274,327,601
kafka,PR-13146,1,15,164,52,216
kafka,PR-13141,9,21,271,276,547
kafka,PR-13136,8,39,1043,773,1816
kafka,PR-13131,4,37,599,497,1096
kafka,PR-13094,5,60,274,327,601
kafka,PR-13131,5,37,597,498,1095
kafka,PR-13136,9,39,1041,774,1815
kafka,PR-13135,3,4,147,36,183
kafka,PR-13148,1,3,60,44,104
kafka,PR-13128,2,1,2,0,2
kafka,PR-13149,1,1,1,1,2
kafka,PR-13137,2,34,1954,852,2806
kafka,PR-13126,4,2,863,0,863
kafka,PR-13144,3,7,60,16,76
kafka,PR-13140,3,5,38,11,49
kafka,PR-13147,2,1,4,3,7
kafka,PR-13151,1,4,70,12,82
kafka,PR-13154,2,1,3,2,5
kafka,PR-13152,2,26,2960,2151,5111
kafka,PR-13155,2,1,1,2,3
kafka,PR-13156,1,1,2,2,4
kafka,PR-12984,7,7,260,40,300
kafka,PR-13155,3,1,2,3,5
kafka,PR-13157,1,1,2,1,3
kafka,PR-13157,2,3,0,0,0
kafka,PR-13151,2,4,70,12,82
kafka,PR-13136,10,40,1106,843,1949
kafka,PR-13131,7,38,664,569,1233
kafka,PR-13153,2,8,279,27,306
kafka,PR-13160,1,1,2,1,3
kafka,PR-13162,1,1,4,5,9
kafka,PR-13142,2,7,241,50,291
kafka,PR-13143,2,11,987,50,1037
kafka,PR-13140,4,5,39,11,50
kafka,PR-13153,3,8,280,27,307
kafka,PR-13021,15,12,672,62,734
kafka,PR-12654,3,4,89,7,96
kafka,PR-12992,6,2,188,0,188
kafka,PR-13163,2,3,48,10,58
kafka,PR-13136,11,40,1106,843,1949
kafka,PR-13131,8,38,664,568,1232
kafka,PR-13164,2,12,66,54,120
kafka,PR-13165,2,15,152,37,189
kafka,PR-13153,4,8,286,40,326
kafka,PR-13166,1,1,12,5,17
kafka,PR-13167,1,9,49,40,89
kafka,PR-13158,3,10,151,111,262
kafka,PR-12637,31,20,3332,264,3596
kafka,PR-13159,3,11,247,34,281
kafka,PR-13131,9,38,664,567,1231
kafka,PR-12654,4,4,89,7,96
kafka,PR-13095,11,4,310,179,489
kafka,PR-13168,1,3,99,33,132
kafka,PR-13126,5,2,869,0,869
kafka,PR-13169,1,10,479,89,568
kafka,PR-13136,12,10,757,299,1056
kafka,PR-12637,32,20,3332,264,3596
kafka,PR-13162,2,1,4,5,9
kafka,PR-13136,13,10,757,299,1056
kafka,PR-13170,1,2,5,63,68
kafka,PR-12654,5,4,89,7,96
kafka,PR-13169,2,12,518,95,613
kafka,PR-13142,4,7,242,50,292
kafka,PR-13143,4,11,989,50,1039
kafka,PR-13021,16,12,676,68,744
kafka,PR-13159,4,13,269,43,312
kafka,PR-13153,9,12,386,43,429
kafka,PR-13126,6,2,834,0,834
kafka,PR-13116,9,6,549,64,613
kafka,PR-12984,8,7,260,40,300
kafka,PR-13171,2,8,554,222,776
kafka,PR-13174,1,8,15,63,78
kafka,PR-13162,4,4,14,20,34
kafka,PR-13148,2,3,61,44,105
kafka,PR-13171,5,8,560,222,782
kafka,PR-13173,3,3,67,3,70
kafka,PR-13136,14,10,751,299,1050
kafka,PR-13175,1,1,4,0,4
kafka,PR-12879,3,5,19,31,50
kafka,PR-13159,8,14,287,51,338
kafka,PR-13116,10,6,549,64,613
kafka,PR-13169,4,7,211,54,265
kafka,PR-12879,4,5,19,31,50
kafka,PR-13159,10,14,334,56,390
kafka,PR-13078,5,7,131,8,139
kafka,PR-13168,2,6,181,34,215
kafka,PR-13176,2,7,80,87,167
kafka,PR-13095,12,5,311,180,491
kafka,PR-13168,3,6,185,34,219
kafka,PR-13067,7,43,565,440,1005
kafka,PR-13143,5,4,796,0,796
kafka,PR-13120,3,100,460,291,751
kafka,PR-13025,5,10,122,59,181
kafka,PR-13169,5,7,211,54,265
kafka,PR-13178,1,7,200,85,285
kafka,PR-13167,3,9,59,48,107
kafka,PR-13179,1,4,172,7,179
kafka,PR-13114,5,25,1048,51,1099
kafka,PR-13168,4,6,173,36,209
kafka,PR-13180,1,4,130,14,144
kafka,PR-13143,6,4,796,0,796
kafka,PR-13025,6,10,122,59,181
kafka,PR-13169,6,7,226,55,281
kafka,PR-13181,1,2,71,22,93
kafka,PR-13168,7,6,175,49,224
kafka,PR-12972,19,33,722,71,793
kafka,PR-13136,15,8,742,295,1037
kafka,PR-13171,6,8,558,222,780
kafka,PR-12992,7,2,188,0,188
kafka,PR-12972,20,35,746,73,819
kafka,PR-13158,6,12,288,181,469
kafka,PR-12984,9,8,353,57,410
kafka,PR-13181,2,2,71,22,93
kafka,PR-13136,16,8,742,295,1037
kafka,PR-13171,7,8,558,222,780
kafka,PR-13180,2,6,158,43,201
kafka,PR-12984,10,8,353,57,410
kafka,PR-13182,1,14,770,17,787
kafka,PR-13183,1,6,361,41,402
kafka,PR-13185,2,17,600,269,869
kafka,PR-13184,2,9,93,70,163
kafka,PR-13186,1,2,87,58,145
kafka,PR-13143,7,4,876,0,876
kafka,PR-13187,1,1,7,3,10
kafka,PR-13136,17,8,741,295,1036
kafka,PR-12607,4,1,655,977,1632
kafka,PR-13168,8,6,202,49,251
kafka,PR-13183,2,5,385,44,429
kafka,PR-13171,8,6,530,203,733
kafka,PR-13185,3,17,595,268,863
kafka,PR-13180,3,7,204,42,246
kafka,PR-13120,4,100,454,306,760
kafka,PR-13184,3,9,109,86,195
kafka,PR-13183,3,6,390,46,436
kafka,PR-13188,2,8,2282,0,2282
kafka,PR-13190,1,2,8,3,11
kafka,PR-13189,4,9,2786,0,2786
kafka,PR-13190,2,2,8,3,11
kafka,PR-13192,1,7,2878,2571,5449
kafka,PR-12997,5,1,14,9,23
kafka,PR-13191,5,2,394,332,726
kafka,PR-13193,1,4,408,342,750
kafka,PR-13194,1,1,1,1,2
kafka,PR-13158,7,12,287,181,468
kafka,PR-13195,1,1,10,0,10
kafka,PR-13046,26,27,971,807,1778
kafka,PR-13183,4,6,390,46,436
kafka,PR-13196,1,7,509,11,520
kafka,PR-13113,2,2,20,1,21
kafka,PR-13171,9,6,521,203,724
kafka,PR-13183,5,6,390,46,436
kafka,PR-13192,2,7,2878,2571,5449
kafka,PR-13143,9,4,889,0,889
kafka,PR-13184,4,9,114,91,205
kafka,PR-13182,2,14,770,17,787
kafka,PR-13197,1,2,12,2,14
kafka,PR-13198,1,7,16,15,31
kafka,PR-13195,2,3,31,3,34
kafka,PR-13188,3,6,1414,8,1422
kafka,PR-13189,5,7,1918,8,1926
kafka,PR-13046,28,27,990,803,1793
kafka,PR-13199,2,2,12,12,24
kafka,PR-13199,3,2,12,12,24
kafka,PR-13067,8,43,565,439,1004
kafka,PR-12972,21,35,746,73,819
kafka,PR-13200,2,8,28,1,29
kafka,PR-13046,29,27,990,803,1793
kafka,PR-13025,7,11,153,62,215
kafka,PR-13199,5,2,11,11,22
kafka,PR-12992,8,2,188,0,188
kafka,PR-13203,1,20,366,1,367
kafka,PR-13202,2,8,430,0,430
kafka,PR-13161,6,2,27,4,31
kafka,PR-13200,3,8,28,1,29
kafka,PR-13198,2,7,18,17,35
kafka,PR-13200,4,8,28,1,29
kafka,PR-13178,2,6,167,69,236
kafka,PR-13200,5,8,28,1,29
kafka,PR-13021,18,12,721,68,789
kafka,PR-13204,2,10,775,659,1434
kafka,PR-13206,1,9,540,314,854
kafka,PR-13207,1,5,179,31,210
kafka,PR-13192,3,7,2878,2571,5449
kafka,PR-13204,4,10,773,659,1432
kafka,PR-13021,19,12,721,68,789
kafka,PR-13208,1,5,83,4,87
kafka,PR-13188,4,6,1414,8,1422
kafka,PR-13046,30,27,990,803,1793
kafka,PR-13209,1,4,3,11,14
kafka,PR-13200,6,8,28,1,29
kafka,PR-13046,31,27,990,803,1793
kafka,PR-13191,6,2,263,292,555
kafka,PR-13046,32,27,990,803,1793
kafka,PR-13203,2,12,338,0,338
kafka,PR-13210,1,42,83,86,169
kafka,PR-13211,1,2,55,5,60
kafka,PR-13201,5,11,2532,1779,4311
kafka,PR-13099,2,6,157,25,182
kafka,PR-13163,3,2,36,9,45
kafka,PR-12972,22,34,773,76,849
kafka,PR-13213,3,159,184,182,366
kafka,PR-13122,4,7,336,211,547
kafka,PR-13196,2,7,623,21,644
kafka,PR-12813,10,6,118,15,133
kafka,PR-13214,1,12,1292,1017,2309
kafka,PR-13213,4,159,184,182,366
kafka,PR-12972,23,35,778,79,857
kafka,PR-12813,11,6,118,15,133
kafka,PR-13216,1,1,0,1,1
kafka,PR-13218,1,5,30,42,72
kafka,PR-13206,2,9,558,313,871
kafka,PR-13188,6,6,1431,8,1439
kafka,PR-13189,6,7,1918,8,1926
kafka,PR-12972,24,35,778,79,857
kafka,PR-13215,2,7,570,475,1045
kafka,PR-13203,3,12,372,0,372
kafka,PR-13211,4,2,55,5,60
kafka,PR-13158,8,12,287,181,468
kafka,PR-13195,4,2,40,0,40
kafka,PR-13135,4,13,998,171,1169
kafka,PR-12992,9,2,188,0,188
kafka,PR-13212,2,26,30,26,56
kafka,PR-13218,2,5,30,42,72
kafka,PR-13203,4,12,372,0,372
kafka,PR-13214,2,13,1289,1018,2307
kafka,PR-12590,18,9,416,232,648
kafka,PR-12972,25,35,778,79,857
kafka,PR-13221,1,1,3,3,6
kafka,PR-12590,21,9,439,232,671
kafka,PR-13137,4,34,2014,852,2866
kafka,PR-13178,6,6,235,85,320
kafka,PR-13114,6,25,1046,51,1097
kafka,PR-13206,3,9,559,313,872
kafka,PR-13168,9,6,202,49,251
kafka,PR-13040,10,33,949,821,1770
kafka,PR-13212,3,26,30,26,56
kafka,PR-13222,1,1,2,2,4
kafka,PR-13040,12,34,984,821,1805
kafka,PR-13223,1,2,7,7,14
kafka,PR-13219,3,55,155,319,474
kafka,PR-13215,3,7,568,475,1043
kafka,PR-13040,13,34,984,821,1805
kafka,PR-13225,1,1,3,3,6
kafka,PR-13188,7,6,1410,8,1418
kafka,PR-13202,3,8,429,0,429
kafka,PR-13189,7,7,1910,8,1918
kafka,PR-13214,3,14,1309,1018,2327
kafka,PR-13226,1,2,22,24,46
kafka,PR-13224,7,23,1054,212,1266
kafka,PR-13040,15,34,982,822,1804
kafka,PR-13178,7,10,416,111,527
kafka,PR-13227,1,7,184,63,247
kafka,PR-13228,1,8,372,74,446
kafka,PR-13224,9,23,1057,212,1269
kafka,PR-13127,5,10,15,9,24
kafka,PR-13230,3,2,86,43,129
kafka,PR-13040,16,34,979,822,1801
kafka,PR-13215,4,8,576,514,1090
kafka,PR-13230,4,2,114,34,148
kafka,PR-13224,10,23,1057,212,1269
kafka,PR-13114,7,25,1043,51,1094
kafka,PR-13196,3,7,623,21,644
kafka,PR-13040,17,38,1043,888,1931
kafka,PR-13178,8,10,430,115,545
kafka,PR-13227,2,7,192,63,255
kafka,PR-13188,8,6,1441,8,1449
kafka,PR-13231,1,12,653,154,807
kafka,PR-13189,8,7,1909,8,1917
kafka,PR-13225,2,1,3,3,6
kafka,PR-13208,2,7,81,44,125
kafka,PR-13215,5,8,574,514,1088
kafka,PR-13040,18,38,1042,888,1930
kafka,PR-13233,1,1,18,11,29
kafka,PR-13189,9,3,502,7,509
kafka,PR-13040,19,38,1042,888,1930
kafka,PR-13234,1,27,223,173,396
kafka,PR-13125,4,4,53,0,53
kafka,PR-13211,5,2,55,5,60
kafka,PR-13211,7,2,55,5,60
kafka,PR-13234,2,27,224,173,397
kafka,PR-13235,1,2,18,7,25
kafka,PR-13236,1,3,72,1,73
kafka,PR-13190,3,3,53,4,57
kafka,PR-13218,3,5,30,42,72
kafka,PR-13237,2,3,59,4,63
kafka,PR-13238,1,1,18,15,33
kafka,PR-13235,2,2,18,7,25
kafka,PR-13234,4,27,223,174,397
kafka,PR-13127,6,10,13,9,22
kafka,PR-13095,13,5,317,183,500
kafka,PR-13230,6,3,187,34,221
kafka,PR-13239,1,8,53,54,107
kafka,PR-13196,5,8,647,25,672
kafka,PR-13135,5,20,1096,209,1305
kafka,PR-13240,2,9,184,27,211
kafka,PR-13241,1,3,28,8,36
kafka,PR-13082,2,2,19,5,24
kafka,PR-13242,1,1,15,5,20
kafka,PR-13184,7,10,128,116,244
kafka,PR-13178,10,11,457,142,599
kafka,PR-13227,5,7,192,63,255
kafka,PR-13207,3,5,231,31,262
kafka,PR-13243,2,3,119,22,141
kafka,PR-13243,3,3,120,22,142
kafka,PR-13100,3,3,28,0,28
kafka,PR-13244,1,1,7,0,7
kafka,PR-13245,1,3,176,34,210
kafka,PR-13246,1,2,0,4,4
kafka,PR-13247,3,12,636,179,815
kafka,PR-13240,6,9,288,43,331
kafka,PR-13246,3,3,54,24,78
kafka,PR-13163,4,2,37,10,47
kafka,PR-13207,4,5,231,31,262
kafka,PR-13245,3,3,176,34,210
kafka,PR-13178,11,11,468,136,604
kafka,PR-13114,9,27,1143,69,1212
kafka,PR-13248,1,2,20,0,20
kafka,PR-13208,4,10,140,37,177
kafka,PR-12957,2,1,1,1,2
kafka,PR-13228,2,8,400,74,474
kafka,PR-13207,5,5,231,31,262
kafka,PR-13078,7,7,137,8,145
kafka,PR-13249,1,5,354,1,355
kafka,PR-13250,1,10,767,1,768
kafka,PR-13251,1,12,1069,1,1070
kafka,PR-13252,1,13,1274,3,1277
kafka,PR-13253,1,1,13,8,21
kafka,PR-13254,1,2,11,1,12
kafka,PR-13255,1,25,548,239,787
kafka,PR-13234,5,27,223,174,397
kafka,PR-13248,2,4,49,1,50
kafka,PR-13247,11,14,931,281,1212
kafka,PR-13255,2,25,541,240,781
kafka,PR-13238,3,1,16,15,31
kafka,PR-13234,8,27,223,174,397
kafka,PR-13219,4,35,155,214,369
kafka,PR-13114,12,28,1175,85,1260
kafka,PR-13257,2,2,203,4,207
kafka,PR-13256,2,2,203,4,207
kafka,PR-13207,6,5,231,31,262
kafka,PR-13231,2,12,653,154,807
kafka,PR-13243,4,3,177,25,202
kafka,PR-13208,6,10,147,37,184
kafka,PR-13178,14,10,505,157,662
kafka,PR-12957,3,1,1,1,2
kafka,PR-13082,3,2,19,5,24
kafka,PR-13249,2,6,378,1,379
kafka,PR-13253,2,1,14,8,22
kafka,PR-13192,8,9,3363,2871,6234
kafka,PR-13168,11,6,166,40,206
kafka,PR-13234,12,26,222,164,386
kafka,PR-13095,14,5,317,181,498
kafka,PR-13254,2,2,11,1,12
kafka,PR-13258,1,1,0,2,2
kafka,PR-13114,13,28,1175,85,1260
kafka,PR-13259,1,19,0,94,94
kafka,PR-13172,3,3,501,8,509
kafka,PR-13025,8,12,182,65,247
kafka,PR-13234,13,26,222,164,386
kafka,PR-13250,2,5,413,0,413
kafka,PR-13251,2,7,715,0,715
kafka,PR-13252,2,8,921,2,923
kafka,PR-13261,1,2,29,4,33
kafka,PR-13262,2,3,21,3,24
kafka,PR-13178,17,10,505,157,662
kafka,PR-13263,1,1,1,1,2
kafka,PR-13114,14,28,1180,85,1265
kafka,PR-13262,4,4,39,43,82
kafka,PR-13196,8,8,647,25,672
kafka,PR-13266,1,1,8,6,14
kafka,PR-13178,18,10,505,157,662
kafka,PR-13267,2,10,328,135,463
kafka,PR-13254,3,2,11,1,12
kafka,PR-13250,3,5,413,0,413
kafka,PR-13269,1,1,2,1,3
kafka,PR-13248,3,4,49,1,50
kafka,PR-13251,3,7,715,0,715
kafka,PR-13270,2,1,4,1,5
kafka,PR-13255,5,25,528,240,768
kafka,PR-12997,6,1,14,9,23
kafka,PR-13270,3,2,8,1,9
kafka,PR-13271,1,14,29,15,44
kafka,PR-13196,9,8,647,25,672
kafka,PR-13135,6,20,1101,209,1310
kafka,PR-13272,1,2,61,0,61
kafka,PR-13178,19,11,507,159,666
kafka,PR-13273,1,1,1,1,2
kafka,PR-13251,4,2,302,0,302
kafka,PR-13252,3,3,508,2,510
kafka,PR-13264,3,21,649,93,742
kafka,PR-12992,10,2,188,0,188
kafka,PR-13192,9,9,3363,2871,6234
kafka,PR-13267,4,10,361,137,498
kafka,PR-13272,2,2,76,0,76
kafka,PR-13255,6,25,528,240,768
kafka,PR-13275,1,9,453,298,751
kafka,PR-13276,1,3,80,10,90
kafka,PR-13255,7,25,529,240,769
kafka,PR-13275,4,8,460,296,756
kafka,PR-13278,1,23,365,169,534
kafka,PR-13190,4,3,53,4,57
kafka,PR-13172,4,5,501,378,879
kafka,PR-13025,9,12,189,66,255
kafka,PR-13279,1,4,16,1,17
kafka,PR-12990,3,7,783,160,943
kafka,PR-13240,16,13,705,116,821
kafka,PR-13095,15,6,319,182,501
kafka,PR-13214,4,14,1309,1018,2327
kafka,PR-13273,2,2,3,3,6
kafka,PR-13281,1,1,3,2,5
kafka,PR-13190,5,3,53,4,57
kafka,PR-13268,6,17,147,86,233
kafka,PR-13100,4,3,28,0,28
kafka,PR-13280,2,14,668,40,708
kafka,PR-13273,3,2,3,3,6
kafka,PR-13191,10,2,251,304,555
kafka,PR-13114,15,28,1180,85,1265
kafka,PR-13255,8,25,529,240,769
kafka,PR-13282,2,6,459,247,706
kafka,PR-13240,17,13,705,116,821
kafka,PR-13214,5,14,1309,1018,2327
kafka,PR-13281,2,1,3,2,5
kafka,PR-13283,1,19,735,52,787
kafka,PR-13276,2,3,87,7,94
kafka,PR-13279,2,4,16,1,17
kafka,PR-12957,4,1,1,1,2
kafka,PR-13190,7,3,55,5,60
kafka,PR-13284,1,2,19,21,40
kafka,PR-13285,1,1,6,6,12
kafka,PR-13272,3,2,91,0,91
kafka,PR-13268,7,17,154,89,243
kafka,PR-13216,2,2,0,2,2
kafka,PR-13228,3,9,426,80,506
kafka,PR-13206,6,9,561,312,873
kafka,PR-13286,2,2,146,39,185
kafka,PR-13191,11,2,252,304,556
kafka,PR-13190,8,3,55,5,60
kafka,PR-13261,2,2,37,8,45
kafka,PR-13240,19,16,960,194,1154
kafka,PR-12990,4,7,790,160,950
kafka,PR-13212,4,25,29,25,54
kafka,PR-13240,20,16,926,207,1133
kafka,PR-13280,3,14,668,40,708
kafka,PR-13228,4,9,427,82,509
kafka,PR-13289,1,2,6,0,6
kafka,PR-13190,9,3,52,4,56
kafka,PR-13252,4,3,511,2,513
kafka,PR-13286,3,2,146,39,185
kafka,PR-13240,21,16,875,164,1039
kafka,PR-13287,2,5,24,45,69
kafka,PR-13291,1,2,10,1,11
kafka,PR-13161,12,2,71,15,86
kafka,PR-13274,2,34,1744,240,1984
kafka,PR-13268,8,17,154,89,243
kafka,PR-13206,8,9,561,312,873
kafka,PR-13292,1,38,1914,243,2157
kafka,PR-13231,5,19,789,240,1029
kafka,PR-13294,1,6,126,49,175
kafka,PR-13095,16,6,333,182,515
kafka,PR-13290,1,2,5,2,7
kafka,PR-13279,3,4,17,1,18
kafka,PR-13215,8,8,572,514,1086
kafka,PR-13295,2,3,138,9,147
kafka,PR-13205,15,4,35,26,61
kafka,PR-12990,5,7,836,160,996
kafka,PR-13205,17,4,30,21,51
kafka,PR-13269,3,1,4,1,5
kafka,PR-13240,30,16,1180,266,1446
kafka,PR-13067,10,43,561,430,991
kafka,PR-13296,1,1,0,1,1
kafka,PR-13252,5,3,551,8,559
kafka,PR-13205,18,4,30,21,51
kafka,PR-13231,6,20,834,250,1084
kafka,PR-13206,12,9,558,313,871
kafka,PR-13297,3,3,19,6,25
kafka,PR-13270,4,2,20,2,22
kafka,PR-13252,6,3,596,8,604
kafka,PR-13240,33,17,1284,276,1560
kafka,PR-13174,3,8,15,63,78
kafka,PR-13174,6,8,15,63,78
kafka,PR-13299,1,1,4,0,4
kafka,PR-13240,34,17,1285,276,1561
kafka,PR-13190,11,3,55,5,60
kafka,PR-13300,2,14,207,83,290
kafka,PR-13206,14,9,558,316,874
kafka,PR-13231,7,20,835,252,1087
kafka,PR-13301,3,4,675,508,1183
kafka,PR-13302,1,16,64,49,113
kafka,PR-13300,4,17,297,156,453
kafka,PR-13303,1,3,126,5,131
kafka,PR-12813,12,6,118,15,133
kafka,PR-13264,4,19,577,80,657
kafka,PR-13304,1,21,250,136,386
kafka,PR-13190,12,3,55,5,60
kafka,PR-13297,4,3,33,9,42
kafka,PR-13305,1,1,2,2,4
kafka,PR-13304,2,21,252,138,390
kafka,PR-13195,5,2,39,0,39
kafka,PR-13306,1,1,8,0,8
kafka,PR-13275,5,8,460,296,756
kafka,PR-13308,1,1,1,1,2
kafka,PR-13297,5,3,33,9,42
kafka,PR-13309,1,4,118,53,171
kafka,PR-13306,2,1,7,0,7
kafka,PR-13311,1,2,16,12,28
kafka,PR-13280,4,17,1133,49,1182
kafka,PR-13280,5,17,1137,49,1186
kafka,PR-13311,2,2,16,12,28
kafka,PR-13191,12,2,275,301,576
kafka,PR-13309,6,4,133,53,186
kafka,PR-13309,7,4,133,53,186
kafka,PR-13304,3,21,252,138,390
kafka,PR-13102,6,2,48,2,50
kafka,PR-13172,5,5,501,378,879
kafka,PR-13240,35,17,1285,276,1561
kafka,PR-13304,4,21,252,138,390
kafka,PR-13280,7,19,1259,276,1535
kafka,PR-13193,3,4,15,11,26
kafka,PR-13312,2,3,539,88,627
kafka,PR-13190,13,3,55,5,60
kafka,PR-13313,1,9,17,11,28
kafka,PR-13193,4,4,19,17,36
kafka,PR-13291,2,2,56,53,109
kafka,PR-13184,9,10,113,118,231
kafka,PR-13116,12,8,461,87,548
kafka,PR-13315,1,1,3,10,13
kafka,PR-13190,16,3,56,6,62
kafka,PR-13176,3,8,83,90,173
kafka,PR-13097,4,1,15,2,17
kafka,PR-13316,1,1,7,0,7
kafka,PR-13270,5,2,18,2,20
kafka,PR-13317,1,1,7,4,11
kafka,PR-13276,4,2,191,13,204
kafka,PR-13067,12,43,562,430,992
kafka,PR-13247,12,11,824,0,824
kafka,PR-13285,2,1,9,9,18
kafka,PR-13312,3,3,539,88,627
kafka,PR-13309,9,4,147,105,252
kafka,PR-13313,2,10,17,13,30
kafka,PR-13304,5,21,279,138,417
kafka,PR-13302,2,16,64,53,117
kafka,PR-13067,14,43,562,430,992
kafka,PR-13240,36,17,1156,328,1484
kafka,PR-13287,3,5,27,45,72
kafka,PR-13190,18,3,50,4,54
kafka,PR-13315,3,1,5,12,17
kafka,PR-13309,10,4,147,105,252
kafka,PR-13078,8,7,137,8,145
kafka,PR-13318,2,3,41,8,49
kafka,PR-13319,1,3,15,14,29
kafka,PR-13320,7,3,25,1,26
kafka,PR-13275,7,8,436,293,729
kafka,PR-13067,16,43,562,430,992
kafka,PR-13321,1,1,2,2,4
kafka,PR-13304,8,22,326,138,464
kafka,PR-13275,8,8,436,293,729
kafka,PR-13240,42,19,1127,367,1494
kafka,PR-13285,3,2,41,40,81
kafka,PR-12990,6,8,852,165,1017
kafka,PR-13322,1,2,93,0,93
kafka,PR-13284,2,2,47,18,65
kafka,PR-13304,9,22,326,138,464
kafka,PR-13319,2,3,17,16,33
kafka,PR-13182,3,14,770,17,787
kafka,PR-13078,9,7,137,8,145
kafka,PR-13318,4,3,41,8,49
kafka,PR-13318,6,3,41,8,49
kafka,PR-13318,9,3,41,8,49
kafka,PR-13240,48,20,1190,372,1562
kafka,PR-13319,3,3,17,16,33
kafka,PR-13116,13,15,697,194,891
kafka,PR-13231,8,20,933,267,1200
kafka,PR-13185,5,16,555,266,821
kafka,PR-13301,4,4,683,510,1193
kafka,PR-13323,1,46,337,139,476
kafka,PR-13172,6,5,501,378,879
kafka,PR-13284,3,2,47,18,65
kafka,PR-13284,4,2,47,18,65
kafka,PR-13324,1,1,1,1,2
kafka,PR-13322,2,2,152,0,152
kafka,PR-13323,2,46,337,139,476
kafka,PR-13240,52,21,1184,346,1530
kafka,PR-13067,17,43,564,432,996
kafka,PR-13284,5,2,47,18,65
kafka,PR-13275,9,8,434,293,727
kafka,PR-13325,1,1,3,2,5
kafka,PR-13285,4,2,46,55,101
kafka,PR-13326,1,3,34,3,37
kafka,PR-13327,1,1,1,1,2
kafka,PR-13182,4,14,770,17,787
kafka,PR-13264,6,19,573,80,653
kafka,PR-13215,9,8,582,514,1096
kafka,PR-13328,1,3,11,5,16
kafka,PR-13116,14,8,461,87,548
kafka,PR-13318,11,6,81,32,113
kafka,PR-13329,1,6,145,12,157
kafka,PR-13240,55,21,1323,346,1669
kafka,PR-13331,1,3,14,3,17
kafka,PR-13303,3,3,126,5,131
kafka,PR-13274,3,15,604,158,762
kafka,PR-13231,9,20,957,272,1229
kafka,PR-13292,3,23,796,186,982
kafka,PR-13116,16,10,525,89,614
kafka,PR-13332,1,17,346,90,436
kafka,PR-12813,18,4,126,35,161
kafka,PR-13333,1,1,100,65,165
kafka,PR-13318,15,6,81,32,113
kafka,PR-13318,18,6,81,32,113
kafka,PR-13318,13,6,81,32,113
kafka,PR-13334,1,8,84,77,161
kafka,PR-13304,10,21,276,138,414
kafka,PR-13269,5,2,31,9,40
kafka,PR-13274,4,15,611,158,769
kafka,PR-13335,1,2,29,3,32
kafka,PR-13327,2,1,1,1,2
kafka,PR-13336,1,1,12,8,20
kafka,PR-13215,10,8,582,514,1096
kafka,PR-13240,60,22,1419,351,1770
kafka,PR-13114,17,29,1274,86,1360
kafka,PR-13280,8,19,1259,276,1535
kafka,PR-13269,6,2,31,9,40
kafka,PR-13329,3,7,159,12,171
kafka,PR-13231,11,20,957,272,1229
kafka,PR-13165,3,15,158,43,201
kafka,PR-13067,18,43,564,432,996
kafka,PR-13332,2,17,348,91,439
kafka,PR-13303,4,6,143,22,165
kafka,PR-13318,20,7,88,44,132
kafka,PR-13337,1,13,163,57,220
kafka,PR-13331,2,3,14,3,17
kafka,PR-13240,62,22,1432,352,1784
kafka,PR-13338,1,6,244,15,259
kafka,PR-13231,12,20,955,272,1227
kafka,PR-13116,17,12,613,125,738
kafka,PR-13303,5,6,103,80,183
kafka,PR-13339,1,4,10,10,20
kafka,PR-13340,3,24,1388,186,1574
kafka,PR-13240,64,23,1443,354,1797
kafka,PR-13303,6,6,105,77,182
kafka,PR-13339,3,4,12,15,27
kafka,PR-13339,4,4,12,15,27
kafka,PR-13275,10,8,434,293,727
kafka,PR-13303,8,11,185,89,274
kafka,PR-13067,19,43,564,432,996
kafka,PR-13341,1,1,2,1,3
kafka,PR-13240,69,23,1479,353,1832
kafka,PR-13342,1,1,1,1,2
kafka,PR-13116,20,15,1013,142,1155
kafka,PR-13343,1,2,4,19,23
kafka,PR-13337,2,13,163,57,220
kafka,PR-13116,21,16,1091,144,1235
kafka,PR-13280,9,19,1259,276,1535
kafka,PR-13067,20,44,568,436,1004
kafka,PR-13335,2,2,29,3,32
kafka,PR-13240,70,23,1479,353,1832
kafka,PR-13320,8,3,25,1,26
kafka,PR-13346,1,3,62,3,65
kafka,PR-13347,1,2,7,0,7
kafka,PR-13348,1,1,4,2,6
kafka,PR-13067,21,44,560,436,996
kafka,PR-13345,3,15,518,100,618
kafka,PR-13349,1,1,913,892,1805
kafka,PR-13350,1,7,1865,1313,3178
kafka,PR-13351,1,3,94,5,99
kafka,PR-13352,1,20,879,382,1261
kafka,PR-13331,4,4,15,3,18
kafka,PR-13303,9,11,186,89,275
kafka,PR-13353,2,2,26,5,31
kafka,PR-13116,22,16,1093,146,1239
kafka,PR-13354,1,1,45,22,67
kafka,PR-13355,1,2,2,48,50
kafka,PR-13318,21,9,109,84,193
kafka,PR-13097,5,1,15,2,17
kafka,PR-12813,19,4,126,35,161
kafka,PR-13292,4,9,192,28,220
kafka,PR-13340,4,10,779,28,807
kafka,PR-13303,13,11,234,85,319
kafka,PR-13348,2,1,4,2,6
kafka,PR-13067,22,44,555,436,991
kafka,PR-13116,23,15,1006,151,1157
kafka,PR-13357,2,6,95,21,116
kafka,PR-13358,1,1,1,1,2
kafka,PR-13352,2,21,971,434,1405
kafka,PR-13116,25,15,1040,155,1195
kafka,PR-13357,3,6,95,21,116
kafka,PR-13326,2,3,34,3,37
kafka,PR-13359,1,1,14,9,23
kafka,PR-13337,3,14,170,131,301
kafka,PR-13344,2,10,81,1218,1299
kafka,PR-13360,1,2,115,6,121
kafka,PR-13318,22,10,115,117,232
kafka,PR-13067,23,44,555,436,991
kafka,PR-12813,21,4,164,33,197
kafka,PR-13361,1,2,108,0,108
kafka,PR-13157,3,1,2,1,3
kafka,PR-13240,79,26,1573,453,2026
kafka,PR-13351,2,3,94,5,99
kafka,PR-13240,80,26,1620,453,2073
kafka,PR-13364,1,2,263,150,413
kafka,PR-13363,2,2,45,9,54
kafka,PR-13365,1,6,32,9,41
kafka,PR-13366,1,3,7,3,10
kafka,PR-13367,1,2,8,6,14
kafka,PR-13368,1,4,114,62,176
kafka,PR-13370,1,1,5,3,8
kafka,PR-13368,2,4,114,62,176
kafka,PR-12992,15,3,219,0,219
kafka,PR-13371,1,1,4,4,8
kafka,PR-13366,2,3,7,3,10
kafka,PR-13323,8,43,341,91,432
kafka,PR-13301,7,12,1300,532,1832
kafka,PR-13372,2,6,262,106,368
kafka,PR-13367,2,3,27,18,45
kafka,PR-12992,16,3,219,0,219
kafka,PR-13326,3,3,34,3,37
kafka,PR-13337,8,20,329,196,525
kafka,PR-13348,3,1,4,2,6
kafka,PR-13374,1,16,355,67,422
kafka,PR-13375,1,22,219,252,471
kafka,PR-13348,5,2,65,4,69
kafka,PR-13377,1,1,1,1,2
kafka,PR-13348,6,2,67,6,73
kafka,PR-13378,2,9,267,125,392
kafka,PR-13323,9,43,341,91,432
kafka,PR-13374,2,16,354,66,420
kafka,PR-13378,4,7,230,166,396
kafka,PR-13379,1,2,60,6,66
kafka,PR-13323,11,43,300,77,377
kafka,PR-13377,2,1,1,1,2
kafka,PR-13326,4,3,34,3,37
kafka,PR-13344,3,11,97,1234,1331
kafka,PR-13380,3,8,428,34,462
kafka,PR-13283,2,19,736,52,788
kafka,PR-13381,1,1,0,0,0
kafka,PR-13380,7,9,564,40,604
kafka,PR-13380,8,9,564,40,604
kafka,PR-13383,2,3,317,443,760
kafka,PR-13124,2,2,3,2,5
kafka,PR-13384,1,4,28,10,38
kafka,PR-13350,2,7,1009,478,1487
kafka,PR-13385,1,1,1,1,2
kafka,PR-13386,1,1,1,1,2
kafka,PR-13378,14,9,492,392,884
kafka,PR-13387,1,1,1,1,2
kafka,PR-13372,5,7,263,107,370
kafka,PR-13389,1,1,2,0,2
kafka,PR-13388,2,2,3,3,6
kafka,PR-13378,18,9,654,480,1134
kafka,PR-13384,2,4,28,10,38
kafka,PR-13344,5,11,105,1234,1339
kafka,PR-13367,3,3,25,24,49
kafka,PR-13390,2,20,169,164,333
kafka,PR-13384,3,4,78,12,90
kafka,PR-13372,6,7,284,115,399
kafka,PR-13378,20,9,654,480,1134
kafka,PR-13379,3,4,160,9,169
kafka,PR-13384,4,4,78,12,90
kafka,PR-13386,2,1,7,7,14
kafka,PR-13367,5,4,33,23,56
kafka,PR-13393,1,5,188,20,208
kafka,PR-13384,5,4,88,14,102
kafka,PR-13368,3,4,114,62,176
kafka,PR-13323,12,43,311,82,393
kafka,PR-13394,1,1,0,37,37
kafka,PR-13395,1,2,82,5,87
kafka,PR-13386,3,1,7,7,14
kafka,PR-13292,6,10,360,65,425
kafka,PR-13396,3,7,60,28,88
kafka,PR-13374,3,16,364,128,492
kafka,PR-13397,1,1,11,7,18
kafka,PR-13378,21,9,654,480,1134
kafka,PR-13393,2,4,184,20,204
kafka,PR-13384,6,4,88,14,102
kafka,PR-13372,8,7,287,115,402
kafka,PR-13374,4,16,364,128,492
kafka,PR-13323,13,43,294,82,376
kafka,PR-13323,15,43,294,82,376
kafka,PR-13390,4,28,222,203,425
kafka,PR-13398,1,1,2,2,4
kafka,PR-13395,2,2,82,5,87
kafka,PR-13399,1,2,4,4,8
kafka,PR-13400,1,2,6,67,73
kafka,PR-13323,16,43,294,82,376
kafka,PR-13401,1,2,6,67,73
kafka,PR-13402,1,5,60,46,106
kafka,PR-13395,3,2,82,5,87
kafka,PR-13403,1,1,5,3,8
kafka,PR-13372,9,7,288,115,403
kafka,PR-13404,1,2,70,11,81
kafka,PR-13405,1,3,126,0,126
kafka,PR-13402,2,5,60,46,106
kafka,PR-13362,1,2,79,0,79
kafka,PR-13407,1,18,506,96,602
kafka,PR-13367,7,4,52,41,93
kafka,PR-13408,1,15,368,72,440
kafka,PR-13390,6,29,224,205,429
kafka,PR-13380,9,9,611,57,668
kafka,PR-13369,2,14,413,6,419
kafka,PR-13409,1,3,72,8,80
kafka,PR-13404,2,2,107,13,120
kafka,PR-13380,10,9,588,74,662
kafka,PR-13410,1,2,57,34,91
kafka,PR-13405,2,3,126,0,126
kafka,PR-13395,5,2,71,5,76
kafka,PR-13411,1,2,2,2,4
kafka,PR-13403,2,1,5,17,22
kafka,PR-13399,2,2,4,4,8
kafka,PR-13412,1,2,4,4,8
kafka,PR-13398,4,2,12,2,14
kafka,PR-13413,1,1,1,0,1
kafka,PR-13414,1,1,3,0,3
kafka,PR-13407,4,18,508,96,604
kafka,PR-13398,5,2,12,2,14
kafka,PR-13369,3,14,413,6,419
kafka,PR-13415,1,2,39,13,52
kafka,PR-13407,5,24,675,146,821
kafka,PR-13409,2,3,86,8,94
kafka,PR-13380,11,9,634,80,714
kafka,PR-13391,3,20,1059,70,1129
kafka,PR-13362,2,2,82,0,82
kafka,PR-13361,2,2,108,0,108
kafka,PR-13283,3,19,740,52,792
kafka,PR-13417,2,9,580,503,1083
kafka,PR-13418,3,2,100,0,100
kafka,PR-13398,6,2,12,2,14
kafka,PR-13403,3,1,5,17,22
kafka,PR-13419,1,3,77,24,101
kafka,PR-13420,1,3,193,50,243
kafka,PR-13421,2,3,18,4,22
kafka,PR-13422,1,5,17,24,41
kafka,PR-13407,6,25,686,147,833
kafka,PR-13417,3,9,574,503,1077
kafka,PR-13391,4,23,1097,70,1167
kafka,PR-13373,9,9,486,50,536
kafka,PR-13423,2,1,58,12,70
kafka,PR-13407,7,25,686,147,833
kafka,PR-13424,1,25,1039,116,1155
kafka,PR-13391,5,23,1097,70,1167
kafka,PR-13292,7,10,360,65,425
kafka,PR-13409,3,3,86,8,94
kafka,PR-13383,3,3,318,446,764
kafka,PR-13361,6,2,133,8,141
kafka,PR-13417,4,9,574,503,1077
kafka,PR-12992,18,3,219,0,219
kafka,PR-13426,1,2,50,2,52
kafka,PR-13427,1,3,4,4,8
kafka,PR-13417,5,9,574,503,1077
kafka,PR-13326,6,3,34,3,37
kafka,PR-13373,10,9,482,48,530
kafka,PR-13426,2,3,52,3,55
kafka,PR-13428,2,3,96,285,381
kafka,PR-13340,6,12,878,29,907
kafka,PR-13430,2,2,5,4,9
kafka,PR-13431,1,8,442,104,546
kafka,PR-13294,5,6,136,56,192
kafka,PR-13380,12,9,645,93,738
kafka,PR-13432,1,11,694,482,1176
kafka,PR-13429,2,5,356,48,404
kafka,PR-13433,1,4,325,16,341
kafka,PR-13430,3,3,7,4,11
kafka,PR-13407,8,33,1014,171,1185
kafka,PR-13340,7,3,686,1,687
kafka,PR-13429,3,5,379,48,427
kafka,PR-13421,3,3,18,4,22
kafka,PR-13380,14,9,707,96,803
kafka,PR-13421,4,4,19,6,25
kafka,PR-13435,1,1,49,35,84
kafka,PR-13434,3,29,1216,88,1304
kafka,PR-13421,5,7,143,11,154
kafka,PR-13436,1,1,1,0,1
kafka,PR-13407,11,34,1255,173,1428
kafka,PR-13426,3,3,55,3,58
kafka,PR-13380,16,9,701,96,797
kafka,PR-13382,3,9,129,45,174
kafka,PR-13382,4,9,129,45,174
kafka,PR-13438,3,20,1487,1475,2962
kafka,PR-13424,2,25,1039,117,1156
kafka,PR-13427,2,2,3,3,6
kafka,PR-13374,5,15,397,130,527
kafka,PR-13439,1,14,27,27,54
kafka,PR-13432,2,11,694,482,1176
kafka,PR-13441,1,1,4,6,10
kafka,PR-13434,4,29,1212,88,1300
kafka,PR-13424,7,25,1040,118,1158
kafka,PR-13440,3,7,239,66,305
kafka,PR-13269,7,2,31,9,40
kafka,PR-13393,4,5,258,78,336
kafka,PR-13405,3,3,126,0,126
kafka,PR-13440,4,7,243,66,309
kafka,PR-13368,4,8,266,64,330
kafka,PR-13443,1,6,741,29,770
kafka,PR-13374,6,15,396,133,529
kafka,PR-13438,5,20,1496,1474,2970
kafka,PR-13368,5,8,276,64,340
kafka,PR-13380,17,9,702,96,798
kafka,PR-13391,6,23,1109,73,1182
kafka,PR-13283,4,19,740,52,792
kafka,PR-13423,3,1,58,12,70
kafka,PR-13445,2,2,20,10,30
kafka,PR-13446,1,3,53,5,58
kafka,PR-13434,5,29,1213,89,1302
kafka,PR-13432,3,11,694,482,1176
kafka,PR-13441,2,1,4,6,10
kafka,PR-13447,1,1,7,2,9
kafka,PR-13438,6,20,1492,1474,2966
kafka,PR-13452,1,3,102,5,107
kafka,PR-13452,2,3,102,5,107
kafka,PR-13408,6,14,353,85,438
kafka,PR-13460,1,3,49,6,55
kafka,PR-13269,11,2,56,33,89
kafka,PR-13440,5,7,243,66,309
kafka,PR-13391,7,23,1114,73,1187
kafka,PR-13424,8,25,1040,118,1158
kafka,PR-13442,2,8,284,42,326
kafka,PR-13444,3,12,381,51,432
kafka,PR-13449,2,8,434,42,476
kafka,PR-13445,4,4,41,10,51
kafka,PR-13429,5,5,421,48,469
kafka,PR-13463,1,11,261,157,418
kafka,PR-12637,33,20,3332,264,3596
kafka,PR-13456,3,5,187,2,189
kafka,PR-13457,2,9,33,20,53
kafka,PR-13443,2,6,695,29,724
kafka,PR-13446,2,3,90,6,96
kafka,PR-13374,7,15,403,129,532
kafka,PR-13380,19,9,781,124,905
kafka,PR-13445,6,4,99,16,115
kafka,PR-13457,3,9,33,20,53
kafka,PR-13456,4,5,187,2,189
kafka,PR-13269,12,2,85,33,118
kafka,PR-13446,4,3,91,6,97
kafka,PR-13434,7,31,1404,127,1531
kafka,PR-13127,8,10,13,9,22
kafka,PR-13455,2,2,75,2,77
kafka,PR-13341,2,1,2,1,3
kafka,PR-13240,83,28,1615,449,2064
kafka,PR-13464,1,1,20,16,36
kafka,PR-13456,5,5,187,2,189
kafka,PR-13457,4,10,41,29,70
kafka,PR-13373,12,10,529,33,562
kafka,PR-13373,13,8,512,26,538
kafka,PR-13269,13,2,85,33,118
kafka,PR-13325,2,1,6,2,8
kafka,PR-13463,2,11,261,157,418
kafka,PR-13466,1,1,1,1,2
kafka,PR-13433,2,4,325,16,341
kafka,PR-13443,3,6,695,29,724
kafka,PR-13467,1,15,162,45,207
kafka,PR-13468,1,1,11,16,27
kafka,PR-13431,2,8,440,104,544
kafka,PR-13464,2,1,20,16,36
kafka,PR-13442,3,8,284,42,326
kafka,PR-13408,8,14,353,85,438
kafka,PR-13462,3,7,157,83,240
kafka,PR-13318,23,10,116,117,233
kafka,PR-13469,1,1,1,1,2
kafka,PR-13470,1,2,22,18,40
kafka,PR-13457,5,11,51,38,89
kafka,PR-13380,20,9,781,124,905
kafka,PR-13434,8,31,1426,153,1579
kafka,PR-13471,1,1,3,0,3
kafka,PR-13269,14,2,85,33,118
kafka,PR-13361,9,1,41,43,84
kafka,PR-13472,1,3,34,3,37
kafka,PR-13473,1,1,16,0,16
kafka,PR-13464,3,1,20,16,36
kafka,PR-13474,1,3,222,31,253
kafka,PR-13458,2,20,167,65,232
kafka,PR-13459,3,7,642,650,1292
kafka,PR-13471,2,3,40,0,40
kafka,PR-13475,1,15,187,74,261
kafka,PR-13469,2,1,1,1,2
kafka,PR-13463,4,11,211,134,345
kafka,PR-13447,3,1,7,2,9
kafka,PR-13468,3,1,11,16,27
kafka,PR-13477,1,4,99,16,115
kafka,PR-13478,1,1,1,1,2
kafka,PR-13471,3,2,56,2,58
kafka,PR-13476,1,31,8119,35,8154
kafka,PR-13471,4,3,58,2,60
kafka,PR-13479,1,1,2,2,4
kafka,PR-13480,1,1,3,3,6
kafka,PR-13481,1,1,1,0,1
kafka,PR-13477,2,4,98,16,114
kafka,PR-13482,1,2,8,7,15
kafka,PR-13483,1,1,2,3,5
kafka,PR-13484,1,2,28,10,38
kafka,PR-13471,5,3,58,2,60
kafka,PR-13474,2,3,224,31,255
kafka,PR-13486,1,2,2,2,4
kafka,PR-13487,1,8,507,81,588
kafka,PR-13488,1,3,10,3,13
kafka,PR-13490,1,5,103,37,140
kafka,PR-13471,7,3,44,2,46
kafka,PR-13471,8,3,44,2,46
kafka,PR-13473,4,3,101,2,103
kafka,PR-13487,2,8,483,77,560
kafka,PR-13491,1,1,69,0,69
kafka,PR-13492,1,19,764,751,1515
kafka,PR-13473,5,3,96,2,98
kafka,PR-13471,9,3,44,2,46
kafka,PR-13493,1,9,317,320,637
kafka,PR-13494,1,1,2,2,4
kafka,PR-13491,2,1,8,0,8
kafka,PR-13492,2,13,484,467,951
kafka,PR-13489,3,19,399,75,474
kafka,PR-13477,3,4,98,16,114
kafka,PR-13496,2,21,277,44,321
kafka,PR-13497,2,5,455,59,514
kafka,PR-13498,1,1,1,1,2
kafka,PR-13487,3,8,483,77,560
kafka,PR-13487,5,8,434,53,487
kafka,PR-13490,3,5,101,37,138
kafka,PR-13490,4,5,134,62,196
kafka,PR-13499,1,2,53,1,54
kafka,PR-13487,6,8,437,53,490
kafka,PR-13500,1,1,1,1,2
kafka,PR-13501,1,1,10,9,19
kafka,PR-13502,1,1,109,0,109
kafka,PR-13503,1,5,671,536,1207
kafka,PR-13504,1,2,61,2,63
kafka,PR-13505,1,2,491,0,491
kafka,PR-13506,1,2,4,4,8
kafka,PR-13507,1,9,105,57,162
kafka,PR-13495,4,28,1388,1004,2392
kafka,PR-13490,5,6,222,65,287
kafka,PR-13508,1,1,4,2,6
kafka,PR-13509,1,29,944,147,1091
kafka,PR-13511,1,7,237,112,349
kafka,PR-13487,8,8,415,61,476
kafka,PR-13508,2,1,4,2,6
kafka,PR-13489,5,19,396,75,471
kafka,PR-13512,1,1,1,1,2
kafka,PR-13505,3,2,491,0,491
kafka,PR-13492,3,13,484,467,951
kafka,PR-13512,2,2,6,11,17
kafka,PR-13476,2,31,8204,35,8239
kafka,PR-13475,2,17,202,74,276
kafka,PR-13513,1,13,114,66,180
kafka,PR-13505,4,2,491,0,491
kafka,PR-13514,2,5,186,62,248
kafka,PR-13515,1,5,198,95,293
kafka,PR-13516,1,3,198,105,303
kafka,PR-13517,1,3,213,169,382
kafka,PR-13492,4,13,484,467,951
kafka,PR-13520,1,6,356,0,356
kafka,PR-13484,2,2,28,10,38
kafka,PR-13510,2,28,1216,139,1355
kafka,PR-13522,1,27,809,189,998
kafka,PR-13487,10,11,828,341,1169
kafka,PR-13523,1,10,52,28,80
kafka,PR-13509,2,29,944,147,1091
kafka,PR-13503,2,5,671,536,1207
kafka,PR-13489,6,19,400,75,475
kafka,PR-13510,3,29,1218,141,1359
kafka,PR-13524,1,3,80,24,104
kafka,PR-13523,2,10,85,38,123
kafka,PR-13525,3,3,9,6,15
kafka,PR-13521,2,2,209,0,209
kafka,PR-13524,2,3,106,24,130
kafka,PR-13527,1,11,84,198,282
kafka,PR-13513,2,14,222,76,298
kafka,PR-13502,2,1,109,0,109
kafka,PR-13528,1,4,22,19,41
kafka,PR-13523,5,14,102,58,160
kafka,PR-13502,3,1,109,0,109
kafka,PR-13529,1,5,49,73,122
kafka,PR-13525,4,3,9,4,13
kafka,PR-13487,12,12,1203,605,1808
kafka,PR-13530,1,2,92,3,95
kafka,PR-13487,14,12,1374,605,1979
kafka,PR-13531,1,1,23,0,23
kafka,PR-13487,15,14,1365,611,1976
kafka,PR-13513,3,16,225,77,302
kafka,PR-13491,3,1,6,0,6
kafka,PR-13532,1,1,6,4,10
kafka,PR-13534,1,1,2,7,9
kafka,PR-13520,2,6,343,0,343
kafka,PR-13505,5,2,489,0,489
kafka,PR-13536,1,3,24,7,31
kafka,PR-13537,1,13,923,7,930
kafka,PR-13538,1,16,1851,7,1858
kafka,PR-13513,4,15,223,76,299
kafka,PR-13539,1,2,29,3,32
kafka,PR-13540,1,8,215,181,396
kafka,PR-13520,4,6,343,0,343
kafka,PR-13505,6,2,489,0,489
kafka,PR-13539,2,2,29,3,32
kafka,PR-13541,1,2,45,0,45
kafka,PR-13523,6,14,103,57,160
kafka,PR-13543,1,1,17,16,33
kafka,PR-13524,3,3,106,24,130
kafka,PR-13542,3,2,62,1,63
kafka,PR-13541,2,4,84,1,85
kafka,PR-13524,4,6,148,31,179
kafka,PR-13497,3,5,454,58,512
kafka,PR-13496,3,21,198,13,211
kafka,PR-13477,4,4,98,16,114
kafka,PR-13490,6,6,223,65,288
kafka,PR-13509,3,4,212,44,256
kafka,PR-13510,4,9,487,39,526
kafka,PR-13522,2,6,532,145,677
kafka,PR-13505,7,2,489,0,489
kafka,PR-13520,5,6,343,0,343
kafka,PR-13510,5,9,487,39,526
kafka,PR-13522,3,7,534,147,681
kafka,PR-13535,4,15,762,59,821
kafka,PR-13536,2,3,24,7,31
kafka,PR-13538,2,15,1850,7,1857
kafka,PR-13537,2,12,922,7,929
kafka,PR-13544,1,17,2519,7,2526
kafka,PR-13505,8,2,489,0,489
kafka,PR-13546,1,4,130,81,211
kafka,PR-13547,2,1,9,0,9
kafka,PR-13548,1,1,1,1,2
kafka,PR-13549,1,1,2,1,3
kafka,PR-13551,1,3,29,4,33
kafka,PR-13550,3,4,201,71,272
kafka,PR-13553,1,4,57,26,83
kafka,PR-13551,2,3,30,4,34
kafka,PR-13550,4,4,201,71,272
kafka,PR-13552,3,19,571,20,591
kafka,PR-13554,2,18,273,536,809
kafka,PR-13547,5,1,5,0,5
kafka,PR-13555,1,5,21,18,39
kafka,PR-13556,1,3,64,0,64
kafka,PR-13556,3,4,79,9,88
kafka,PR-13558,1,11,1219,1,1220
kafka,PR-13559,1,1,14,9,23
kafka,PR-13560,1,3,61,9,70
kafka,PR-13561,1,7,297,28,325
kafka,PR-13554,3,18,273,536,809
kafka,PR-13552,4,19,571,20,591
kafka,PR-13561,2,7,297,28,325
kafka,PR-13550,8,4,149,44,193
kafka,PR-13554,5,18,281,536,817
kafka,PR-13563,2,8,51,25,76
kafka,PR-13553,2,4,57,26,83
kafka,PR-13564,1,43,582,620,1202
kafka,PR-13565,2,8,126,2,128
kafka,PR-13566,1,47,712,634,1346
kafka,PR-13554,6,18,281,536,817
kafka,PR-13567,1,1,1,1,2
kafka,PR-13568,1,1,9,0,9
kafka,PR-13564,2,26,301,84,385
kafka,PR-13566,2,3,114,6,120
kafka,PR-13567,2,1,1,1,2
kafka,PR-13569,1,3,4,4,8
kafka,PR-13563,3,8,52,30,82
kafka,PR-13561,3,7,297,28,325
kafka,PR-13565,5,11,134,104,238
kafka,PR-13570,1,8,14,10,24
kafka,PR-13571,1,4,117,3,120
kafka,PR-13572,1,1,1,0,1
kafka,PR-13569,2,3,4,4,8
kafka,PR-13567,3,1,1,1,2
kafka,PR-13573,1,1,2,1,3
kafka,PR-13557,3,2,34,2,36
kafka,PR-13574,1,2,4,2,6
kafka,PR-13545,1,1,1,5,6
kafka,PR-13575,1,2,67,0,67
kafka,PR-13574,2,4,23,20,43
kafka,PR-13576,1,1,1,0,1
kafka,PR-13574,3,4,23,20,43
kafka,PR-13577,1,2,51,15,66
kafka,PR-13578,1,1,4,2,6
kafka,PR-13579,1,2,30,5,35
kafka,PR-13575,2,5,72,4,76
kafka,PR-13580,1,16,38,34,72
kafka,PR-13569,3,3,4,4,8
kafka,PR-13581,1,21,142,235,377
kafka,PR-13569,4,3,4,4,8
kafka,PR-13567,4,1,1,1,2
kafka,PR-13581,2,25,169,257,426
kafka,PR-13583,1,1,1,1,2
kafka,PR-13584,1,1,16,0,16
kafka,PR-13585,3,8,773,1,774
kafka,PR-13547,6,1,5,0,5
kafka,PR-13557,4,2,34,2,36
kafka,PR-13585,4,8,772,1,773
kafka,PR-13581,3,34,362,266,628
kafka,PR-13585,5,8,770,1,771
kafka,PR-13587,1,1,1,0,1
kafka,PR-13579,2,2,30,5,35
kafka,PR-13588,1,2,2,2,4
kafka,PR-13589,1,10,80,81,161
kafka,PR-13550,9,4,149,44,193
kafka,PR-13575,3,5,137,14,151
kafka,PR-13590,1,15,223,76,299
kafka,PR-13591,1,2,74,8,82
kafka,PR-13592,1,5,217,15,232
kafka,PR-13577,2,2,51,15,66
kafka,PR-13579,3,2,30,5,35
kafka,PR-13594,1,2,5,24,29
kafka,PR-13584,3,1,25,0,25
kafka,PR-13595,3,9,218,16,234
kafka,PR-13581,4,43,914,332,1246
kafka,PR-13600,1,7,368,19,387
kafka,PR-13601,1,7,369,20,389
kafka,PR-13602,1,7,368,19,387
kafka,PR-13603,1,7,369,20,389
kafka,PR-13572,3,2,41,1,42
kafka,PR-13575,4,5,141,14,155
kafka,PR-13581,7,75,1285,495,1780
kafka,PR-13607,2,6,138,10,148
kafka,PR-13606,3,2,118,9,127
kafka,PR-13608,1,7,88,22,110
kafka,PR-13575,5,1,12,15,27
kafka,PR-13609,3,25,716,720,1436
kafka,PR-13584,4,1,26,0,26
kafka,PR-13550,13,5,200,52,252
kafka,PR-13579,8,2,112,48,160
kafka,PR-13609,4,25,730,743,1473
kafka,PR-13610,1,3,3,3,6
kafka,PR-13594,3,3,7,26,33
kafka,PR-13611,1,1,0,1,1
kafka,PR-13568,2,1,9,0,9
kafka,PR-13612,1,10,13,13,26
kafka,PR-13587,3,1,1,0,1
kafka,PR-13606,4,2,118,9,127
kafka,PR-13613,4,2,46,0,46
kafka,PR-13614,1,1,32,0,32
kafka,PR-13604,2,7,369,21,390
kafka,PR-13599,3,6,186,48,234
kafka,PR-13598,2,6,186,48,234
kafka,PR-13597,2,6,186,48,234
kafka,PR-13596,3,6,186,48,234
kafka,PR-13603,2,7,369,20,389
kafka,PR-13601,2,7,369,20,389
kafka,PR-13579,10,2,112,48,160
kafka,PR-13550,15,6,254,46,300
kafka,PR-13615,3,9,280,255,535
kafka,PR-13616,2,10,1608,0,1608
kafka,PR-13592,2,5,217,15,232
kafka,PR-13617,1,1,3,1,4
kafka,PR-13579,11,2,112,48,160
kafka,PR-13618,3,1,6,6,12
kafka,PR-13598,3,6,186,48,234
kafka,PR-13599,4,6,186,48,234
kafka,PR-13620,1,1,3,3,6
kafka,PR-13596,4,6,187,48,235
kafka,PR-13597,3,6,187,48,235
kafka,PR-13604,3,7,369,21,390
kafka,PR-13621,1,2,122,135,257
kafka,PR-13555,5,5,48,45,93
kafka,PR-13616,3,10,1608,0,1608
kafka,PR-13555,6,5,48,45,93
kafka,PR-13622,1,5,82,8,90
kafka,PR-13591,2,3,79,9,88
kafka,PR-13584,5,1,26,0,26
kafka,PR-13599,5,6,186,48,234
kafka,PR-13623,1,2,44,2,46
kafka,PR-13624,2,1,0,5,5
kafka,PR-13598,6,6,186,48,234
kafka,PR-13575,6,1,24,38,62
kafka,PR-13625,1,3,8,7,15
kafka,PR-13625,3,4,10,9,19
kafka,PR-13626,1,1,0,1,1
kafka,PR-13571,2,3,102,3,105
kafka,PR-13627,7,6,8,13,21
kafka,PR-13625,4,4,10,9,19
kafka,PR-13627,8,6,8,13,21
kafka,PR-13630,1,1,3,3,6
kafka,PR-13603,3,7,367,21,388
kafka,PR-13601,3,7,367,21,388
kafka,PR-13602,2,7,366,20,386
kafka,PR-13600,2,7,366,20,386
kafka,PR-13632,1,24,76,1275,1351
kafka,PR-13600,3,7,366,20,386
kafka,PR-13633,1,1,2,1,3
kafka,PR-13600,4,7,366,20,386
kafka,PR-13601,4,7,367,21,388
kafka,PR-13634,1,1,2,2,4
kafka,PR-13631,6,20,289,102,391
kafka,PR-13635,1,1,1,1,2
kafka,PR-13603,4,7,367,21,388
kafka,PR-13636,1,2,20,2,22
kafka,PR-13626,2,1,0,1,1
kafka,PR-13637,1,7,2687,0,2687
kafka,PR-13638,1,7,2644,0,2644
kafka,PR-13627,12,6,9,17,26
kafka,PR-13639,1,14,7462,0,7462
kafka,PR-13625,6,4,10,9,19
kafka,PR-13550,26,2,138,45,183
kafka,PR-13627,13,6,9,17,26
kafka,PR-13622,2,5,81,8,89
kafka,PR-13642,1,1,1,1,2
kafka,PR-13631,7,20,294,102,396
kafka,PR-13628,3,7,130,9,139
kafka,PR-13550,27,2,138,45,183
kafka,PR-13550,28,2,134,32,166
kafka,PR-13628,6,7,128,8,136
kafka,PR-13645,1,4,234,29,263
kafka,PR-13591,4,3,148,24,172
kafka,PR-13628,7,7,124,8,132
kafka,PR-13631,8,20,307,106,413
kafka,PR-13631,9,20,310,106,416
kafka,PR-13646,1,1,2,2,4
kafka,PR-13648,1,1,2,2,4
kafka,PR-13647,4,1,0,4,4
kafka,PR-13637,3,3,1018,3,1021
kafka,PR-13638,3,2,963,0,963
kafka,PR-13649,1,1,1,1,2
kafka,PR-13550,29,2,130,32,162
kafka,PR-13650,1,2,40,298,338
kafka,PR-13651,1,1,12,7,19
kafka,PR-13605,3,8,195,14,209
kafka,PR-13651,2,2,13,8,21
kafka,PR-13608,2,28,188,60,248
kafka,PR-13640,11,27,674,547,1221
kafka,PR-13628,9,6,124,8,132
kafka,PR-13631,10,20,310,106,416
kafka,PR-13648,2,1,5,5,10
kafka,PR-13584,6,1,26,0,26
kafka,PR-13649,2,1,1,1,2
kafka,PR-13637,5,3,1028,3,1031
kafka,PR-13652,2,2,122,32,154
kafka,PR-13628,10,6,124,8,132
kafka,PR-13591,5,3,148,24,172
kafka,PR-13594,5,6,27,61,88
kafka,PR-13653,1,2,18,1,19
kafka,PR-13561,4,7,297,28,325
kafka,PR-13648,3,1,5,5,10
kafka,PR-13607,3,6,139,10,149
kafka,PR-13607,4,6,139,10,149
kafka,PR-13654,1,9,9,18,27
kafka,PR-13655,3,5,10,13,23
kafka,PR-13657,2,1,2,1,3
kafka,PR-13650,2,2,40,298,338
kafka,PR-13652,3,2,122,32,154
kafka,PR-13621,2,2,126,137,263
kafka,PR-13658,1,8,47,27,74
kafka,PR-13637,7,3,1027,3,1030
kafka,PR-13623,3,2,65,12,77
kafka,PR-13605,4,8,198,14,212
kafka,PR-13638,4,2,963,0,963
kafka,PR-13659,1,1,3,1,4
kafka,PR-13660,1,1,138,0,138
kafka,PR-13655,4,5,10,13,23
kafka,PR-13607,5,3,42,9,51
kafka,PR-13661,2,3,61,63,124
kafka,PR-13591,7,6,205,68,273
kafka,PR-13662,1,6,21,21,42
kafka,PR-13607,6,4,45,11,56
kafka,PR-13654,2,10,10,23,33
kafka,PR-13655,5,5,8,13,21
kafka,PR-13653,5,2,29,0,29
kafka,PR-13639,2,8,4776,1,4777
kafka,PR-13638,5,2,984,0,984
kafka,PR-13664,1,1,7,3,10
kafka,PR-13665,1,5,131,14,145
kafka,PR-13623,4,2,65,12,77
kafka,PR-13666,1,6,463,2,465
kafka,PR-13660,2,1,126,0,126
kafka,PR-13621,3,1,116,134,250
kafka,PR-13659,3,2,27,2,29
kafka,PR-13669,1,1,1,1,2
kafka,PR-13666,3,6,468,2,470
kafka,PR-13607,8,4,106,16,122
kafka,PR-13655,6,5,8,13,21
kafka,PR-13670,3,5,33,12,45
kafka,PR-13607,9,4,105,15,120
kafka,PR-13591,12,6,248,91,339
kafka,PR-13607,10,4,105,15,120
kafka,PR-13638,6,3,1002,0,1002
kafka,PR-13666,5,6,468,2,470
kafka,PR-13675,1,7,624,20,644
kafka,PR-13638,7,3,1007,0,1007
kafka,PR-13676,1,2,32,2,34
kafka,PR-13591,15,6,250,92,342
kafka,PR-13654,3,11,19,27,46
kafka,PR-13617,2,1,1,0,1
kafka,PR-13638,8,3,1007,0,1007
kafka,PR-13623,6,2,61,12,73
kafka,PR-13594,6,7,29,62,91
kafka,PR-13659,4,2,27,2,29
kafka,PR-13677,1,2,76,11,87
kafka,PR-13660,3,1,126,0,126
kafka,PR-13673,6,1,16,16,32
kafka,PR-13676,2,2,34,2,36
kafka,PR-13664,2,1,7,3,10
kafka,PR-13678,2,2,55,3,58
kafka,PR-13680,1,1,1,1,2
kafka,PR-13681,1,1,301,336,637
kafka,PR-13669,3,1,14,14,28
kafka,PR-13672,2,1,18,7,25
kafka,PR-13660,4,1,126,0,126
kafka,PR-13682,1,1,14,6,20
kafka,PR-13684,1,3,4,5,9
kafka,PR-13685,1,1,1,0,1
kafka,PR-13687,1,1,3,3,6
kafka,PR-13621,4,1,116,134,250
kafka,PR-13688,1,3,40,11,51
kafka,PR-13638,10,3,1007,0,1007
kafka,PR-13644,12,3,751,0,751
kafka,PR-13639,3,6,3810,1,3811
kafka,PR-13681,2,1,282,336,618
kafka,PR-13686,6,73,2469,1504,3973
kafka,PR-13584,8,1,26,0,26
kafka,PR-13690,3,1,1,0,1
kafka,PR-13691,3,5,5,5,10
kafka,PR-13584,9,1,29,0,29
kafka,PR-13690,4,1,1,0,1
kafka,PR-13692,1,1,10,2,12
kafka,PR-13693,1,1,6,6,12
kafka,PR-13694,1,1,1,0,1
kafka,PR-13690,5,2,21,0,21
kafka,PR-13663,8,4,1967,0,1967
kafka,PR-13686,7,73,2469,1504,3973
kafka,PR-13695,1,1,1,1,2
kafka,PR-13608,6,31,605,182,787
kafka,PR-13692,2,1,10,2,12
kafka,PR-13696,1,1,10,2,12
kafka,PR-13679,3,20,174,92,266
kafka,PR-13697,1,2,2,15,17
kafka,PR-13695,2,1,1,1,2
kafka,PR-13679,5,21,179,92,271
kafka,PR-13694,2,1,1,0,1
kafka,PR-13690,6,2,21,0,21
kafka,PR-13694,3,1,1,0,1
kafka,PR-13673,8,1,16,16,32
kafka,PR-13698,1,2,21,0,21
kafka,PR-13699,1,2,21,0,21
kafka,PR-13700,1,4,34,2,36
kafka,PR-13694,4,1,1,0,1
kafka,PR-13665,2,5,131,14,145
kafka,PR-13702,1,1,1,1,2
kafka,PR-13663,9,4,2021,0,2021
kafka,PR-13703,2,14,224,57,281
kafka,PR-13694,5,1,1,0,1
kafka,PR-13608,8,31,698,183,881
kafka,PR-13663,12,4,2070,0,2070
kafka,PR-13679,6,21,179,92,271
kafka,PR-13697,2,2,2,15,17
kafka,PR-13705,1,2,50,27,77
kafka,PR-13694,6,1,1,0,1
kafka,PR-13678,3,2,81,6,87
kafka,PR-13706,1,2,3,17,20
kafka,PR-13701,2,2,20,0,20
kafka,PR-13706,2,4,7,21,28
kafka,PR-13679,7,21,179,92,271
kafka,PR-13584,10,1,28,0,28
kafka,PR-13686,9,80,2944,1507,4451
kafka,PR-13703,3,14,230,57,287
kafka,PR-13663,14,4,2114,0,2114
kafka,PR-13707,2,3,12,4,16
kafka,PR-13708,1,2,89,0,89
kafka,PR-13710,1,1,5,5,10
kafka,PR-13663,15,4,2114,0,2114
kafka,PR-13633,2,1,2,1,3
kafka,PR-13584,11,1,28,0,28
kafka,PR-13711,2,1,258,222,480
kafka,PR-13704,7,5,339,1,340
kafka,PR-13712,1,1,11,20,31
kafka,PR-13713,1,1,43,3,46
kafka,PR-13715,1,33,1172,734,1906
kafka,PR-13716,1,33,1172,734,1906
kafka,PR-13681,3,1,282,336,618
kafka,PR-13584,12,1,28,0,28
kafka,PR-13717,1,2,3,3,6
kafka,PR-13718,1,1,0,0,0
kafka,PR-13662,3,5,18,18,36
kafka,PR-13719,1,1,6,3,9
kafka,PR-13720,1,1,9,3,12
kafka,PR-13584,13,1,28,0,28
kafka,PR-13720,2,1,16,17,33
kafka,PR-13721,1,2,23,6,29
kafka,PR-13722,2,1,4,20,24
kafka,PR-13708,3,1,43,0,43
kafka,PR-13704,9,5,329,1,330
kafka,PR-13681,4,1,283,337,620
kafka,PR-13723,1,2,6,3,9
kafka,PR-13705,2,2,53,27,80
kafka,PR-13646,2,1,2,2,4
kafka,PR-13724,1,1,85,8,93
kafka,PR-13703,4,14,230,57,287
kafka,PR-13725,1,10,402,1,403
kafka,PR-13719,2,1,6,3,9
kafka,PR-13726,1,6,74,10,84
kafka,PR-13728,1,1,9,0,9
kafka,PR-13591,16,6,250,92,342
kafka,PR-13678,13,2,77,3,80
kafka,PR-13701,3,2,20,0,20
kafka,PR-13558,3,12,1224,3,1227
kafka,PR-13732,1,1,6,3,9
kafka,PR-13710,2,1,9,6,15
kafka,PR-13678,14,2,76,3,79
kafka,PR-13719,3,1,6,3,9
kafka,PR-13705,3,2,53,27,80
kafka,PR-13665,4,5,132,14,146
kafka,PR-13733,3,2,24,2,26
kafka,PR-13558,4,11,933,3,936
kafka,PR-13686,10,80,2944,1507,4451
kafka,PR-13735,2,8,352,28,380
kafka,PR-13734,2,1,2,2,4
kafka,PR-13736,2,7,192,17,209
kafka,PR-13732,3,4,1,19,20
kafka,PR-13719,4,1,6,3,9
kafka,PR-13561,5,7,295,29,324
kafka,PR-13737,1,2,19,0,19
kafka,PR-13736,3,7,192,17,209
kafka,PR-13738,1,2,53,15,68
kafka,PR-13738,3,2,75,15,90
kafka,PR-13733,4,3,71,65,136
kafka,PR-13558,6,10,730,3,733
kafka,PR-13639,7,7,4020,3,4023
kafka,PR-13738,4,2,83,20,103
kafka,PR-13704,10,5,329,1,330
kafka,PR-13739,1,3,3,3,6
kafka,PR-13708,6,1,43,0,43
kafka,PR-13741,1,2,90,5,95
kafka,PR-13678,15,2,76,3,79
kafka,PR-13716,2,33,1203,752,1955
kafka,PR-13724,2,10,469,101,570
kafka,PR-13743,1,1,1,1,2
kafka,PR-13716,3,41,1351,811,2162
kafka,PR-13744,1,1,45,43,88
kafka,PR-13745,1,1,3,1,4
kafka,PR-13746,1,1,0,1,1
kafka,PR-13724,3,10,469,101,570
kafka,PR-13747,1,1,3,3,6
kafka,PR-13748,1,1,1,1,2
kafka,PR-13749,1,1,52,55,107
kafka,PR-13750,1,1,3,1,4
kafka,PR-13742,2,12,505,16,521
kafka,PR-13747,3,1,3,3,6
kafka,PR-13716,4,51,1611,913,2524
kafka,PR-13676,3,2,34,2,36
kafka,PR-13751,1,4,41,38,79
kafka,PR-13744,2,1,45,44,89
kafka,PR-13733,6,3,78,71,149
kafka,PR-13639,8,7,4035,3,4038
kafka,PR-13752,1,1,1,1,2
kafka,PR-13753,1,1,2,2,4
kafka,PR-13729,2,2,157,3,160
kafka,PR-13754,1,1,10,3,13
kafka,PR-13753,2,1,2,2,4
kafka,PR-13755,1,1,9,9,18
kafka,PR-13724,4,10,469,101,570
kafka,PR-13729,3,2,156,2,158
kafka,PR-13591,17,6,242,85,327
kafka,PR-13757,1,1,22,0,22
kafka,PR-13759,1,11,477,45,522
kafka,PR-13761,3,4,29,2,31
kafka,PR-13762,2,2,13,2,15
kafka,PR-13760,2,4,371,192,563
kafka,PR-13763,1,1,5,3,8
kafka,PR-13639,9,7,4043,3,4046
kafka,PR-13738,6,3,102,20,122
kafka,PR-13639,10,7,4124,3,4127
kafka,PR-13751,2,4,41,38,79
kafka,PR-13758,2,8,380,83,463
kafka,PR-13765,1,6,190,68,258
kafka,PR-13561,6,7,294,29,323
kafka,PR-13611,2,1,0,1,1
kafka,PR-13608,10,32,778,196,974
kafka,PR-13758,3,9,416,90,506
kafka,PR-13661,3,3,61,63,124
kafka,PR-13758,4,9,422,92,514
kafka,PR-13639,11,12,4175,54,4229
kafka,PR-13760,3,4,403,163,566
kafka,PR-13742,3,12,505,16,521
kafka,PR-13661,4,3,61,63,124
kafka,PR-13766,1,3,43,2,45
kafka,PR-13767,2,11,248,67,315
kafka,PR-13768,1,1,14,3,17
kafka,PR-13767,3,11,251,66,317
kafka,PR-13742,4,12,511,16,527
kafka,PR-13769,1,2,53,42,95
kafka,PR-13770,1,23,44,32,76
kafka,PR-13767,4,11,251,66,317
kafka,PR-13771,1,6,192,204,396
kafka,PR-13772,1,4,69,19,88
kafka,PR-13773,1,1,12,1,13
kafka,PR-13738,7,3,103,20,123
kafka,PR-13767,6,11,257,72,329
kafka,PR-13758,5,10,439,96,535
kafka,PR-13774,2,9,86,47,133
kafka,PR-13738,8,3,103,20,123
kafka,PR-13775,1,1,4,2,6
kafka,PR-13721,2,2,23,6,29
kafka,PR-13773,2,1,17,3,20
kafka,PR-13776,2,4,84,4,88
kafka,PR-13777,2,3,34,3,37
kafka,PR-13776,3,4,87,4,91
kafka,PR-13665,5,5,158,16,174
kafka,PR-13779,1,9,29,17,46
kafka,PR-13780,1,1,12,8,20
kafka,PR-13764,2,9,178,169,347
kafka,PR-13781,1,2,40,1,41
kafka,PR-13758,6,21,655,112,767
kafka,PR-13751,3,4,40,38,78
kafka,PR-13772,2,7,71,26,97
kafka,PR-13770,3,27,44,37,81
kafka,PR-13776,4,4,88,4,92
kafka,PR-13759,5,9,297,56,353
kafka,PR-13782,1,2,26,5,31
kafka,PR-13758,7,21,647,113,760
kafka,PR-13783,1,1,1,1,2
kafka,PR-13780,2,1,21,8,29
kafka,PR-13759,6,9,272,56,328
kafka,PR-13757,3,2,96,8,104
kafka,PR-13561,7,7,296,29,325
kafka,PR-13784,3,2,6,4,10
kafka,PR-13777,3,3,34,3,37
kafka,PR-13666,6,7,599,4,603
kafka,PR-13658,2,8,62,41,103
kafka,PR-13785,1,1,7,8,15
kafka,PR-13775,2,1,3,1,4
kafka,PR-13779,2,9,29,17,46
kafka,PR-13784,4,2,5,3,8
kafka,PR-13666,7,7,599,4,603
kafka,PR-13779,3,10,35,24,59
kafka,PR-13561,8,7,296,29,325
kafka,PR-13758,8,22,655,118,773
kafka,PR-13757,6,2,96,8,104
kafka,PR-13759,8,9,280,56,336
kafka,PR-13780,4,1,11,8,19
kafka,PR-13786,3,1,1,1,2
kafka,PR-13787,1,10,476,118,594
kafka,PR-13735,4,9,349,30,379
kafka,PR-13681,7,1,276,337,613
kafka,PR-13735,5,11,509,35,544
kafka,PR-13788,7,12,527,259,786
kafka,PR-13758,9,23,649,119,768
kafka,PR-13772,3,7,71,26,97
kafka,PR-13771,5,6,174,216,390
kafka,PR-13779,5,10,35,24,59
kafka,PR-13790,1,1,7,6,13
kafka,PR-13584,14,1,28,0,28
kafka,PR-13776,5,4,90,4,94
kafka,PR-13790,4,1,2,2,4
kafka,PR-13791,1,2,3,1,4
kafka,PR-13779,6,10,35,24,59
kafka,PR-13561,9,7,305,30,335
kafka,PR-13792,1,1,61,2,63
kafka,PR-13788,9,12,451,242,693
kafka,PR-13779,7,10,35,24,59
kafka,PR-13561,10,7,304,30,334
kafka,PR-13793,1,4,34,30,64
kafka,PR-13794,1,2,69,0,69
kafka,PR-13795,1,24,3151,52,3203
kafka,PR-13782,2,2,26,5,31
kafka,PR-13666,9,7,583,4,587
kafka,PR-13758,10,23,649,119,768
kafka,PR-13796,2,3,218,8,226
kafka,PR-13675,2,7,639,20,659
kafka,PR-13792,2,1,61,2,63
kafka,PR-13769,2,2,78,66,144
kafka,PR-13793,2,4,34,30,64
kafka,PR-13765,2,7,289,68,357
kafka,PR-13735,7,9,476,32,508
kafka,PR-13798,1,1,13,2,15
kafka,PR-13793,3,4,34,30,64
kafka,PR-13799,1,8,312,76,388
kafka,PR-13793,4,4,34,30,64
kafka,PR-13772,6,7,71,26,97
kafka,PR-13800,1,2,13,2,15
kafka,PR-13675,4,8,646,24,670
kafka,PR-13794,2,2,78,0,78
kafka,PR-13680,2,1,1,1,2
kafka,PR-13678,16,2,78,3,81
kafka,PR-13675,5,8,646,24,670
kafka,PR-13788,10,12,451,242,693
kafka,PR-13772,7,7,71,26,97
kafka,PR-13803,1,1,1,0,1
kafka,PR-13765,3,7,289,68,357
kafka,PR-13802,2,7,582,178,760
kafka,PR-13675,7,12,672,25,697
kafka,PR-13799,2,8,312,76,388
kafka,PR-13788,12,12,456,247,703
kafka,PR-13771,11,7,355,217,572
kafka,PR-13804,1,1,21,15,36
kafka,PR-13591,18,6,260,103,363
kafka,PR-13805,1,2,2,2,4
kafka,PR-13805,2,2,2,2,4
kafka,PR-13806,1,2,27,15,42
kafka,PR-13675,9,13,703,28,731
kafka,PR-13807,2,5,177,41,218
kafka,PR-13561,14,7,372,40,412
kafka,PR-13795,5,15,2662,47,2709
kafka,PR-13809,2,1,7,8,15
kafka,PR-13765,4,7,300,69,369
kafka,PR-13806,2,2,27,15,42
kafka,PR-13812,1,24,4211,48,4259
kafka,PR-13813,1,3,72,5,77
kafka,PR-13676,4,2,34,2,36
kafka,PR-13739,2,3,3,7,10
kafka,PR-13771,13,7,357,219,576
kafka,PR-13765,5,7,300,69,369
kafka,PR-13815,1,3,333,216,549
kafka,PR-13802,3,7,744,179,923
kafka,PR-13788,14,12,456,247,703
kafka,PR-13816,1,4,115,71,186
kafka,PR-13675,10,13,755,28,783
kafka,PR-13795,7,15,2755,47,2802
kafka,PR-13772,8,7,71,26,97
kafka,PR-13812,3,24,4401,48,4449
kafka,PR-13811,1,3,56,12,68
kafka,PR-13817,1,1,37,0,37
kafka,PR-13813,2,4,108,29,137
kafka,PR-13788,15,12,456,247,703
kafka,PR-13711,4,1,118,223,341
kafka,PR-13818,1,16,807,182,989
kafka,PR-13807,3,5,218,47,265
kafka,PR-13819,1,2,3,4,7
kafka,PR-13795,8,9,2131,28,2159
kafka,PR-13812,4,18,3777,29,3806
kafka,PR-13820,2,15,506,421,927
kafka,PR-13765,6,7,300,69,369
kafka,PR-13819,2,2,3,4,7
kafka,PR-13816,2,4,115,71,186
kafka,PR-13817,2,1,37,0,37
kafka,PR-13821,1,8,476,278,754
kafka,PR-13803,3,1,1,0,1
kafka,PR-13820,3,15,506,421,927
kafka,PR-13756,6,4,455,0,455
kafka,PR-13816,4,4,125,76,201
kafka,PR-13765,7,9,315,84,399
kafka,PR-13819,3,2,3,4,7
kafka,PR-13765,8,12,319,88,407
kafka,PR-13807,4,5,218,47,265
kafka,PR-13822,1,4,8,3,11
kafka,PR-13817,3,1,37,0,37
kafka,PR-13807,5,5,218,47,265
kafka,PR-13678,17,2,78,3,81
kafka,PR-13678,18,2,78,3,81
kafka,PR-13820,5,17,740,608,1348
kafka,PR-13823,5,69,109,87,196
kafka,PR-13824,1,1,6,6,12
kafka,PR-13815,2,3,350,233,583
kafka,PR-13561,15,7,372,40,412
kafka,PR-13823,6,69,109,87,196
kafka,PR-13764,3,5,129,52,181
kafka,PR-13821,2,8,476,278,754
kafka,PR-13814,1,4,49,23,72
kafka,PR-13818,2,16,820,182,1002
kafka,PR-13820,6,17,740,608,1348
kafka,PR-13591,19,6,262,101,363
kafka,PR-13826,1,15,226,48,274
kafka,PR-13591,24,4,151,8,159
kafka,PR-13827,3,1,47,0,47
kafka,PR-13807,6,5,218,47,265
kafka,PR-13756,7,4,455,0,455
kafka,PR-13807,7,5,218,47,265
kafka,PR-13828,1,4,68,6,74
kafka,PR-13760,5,5,404,179,583
kafka,PR-13829,2,4,46,2,48
kafka,PR-13712,3,1,15,19,34
kafka,PR-13818,3,17,1013,208,1221
kafka,PR-13827,4,1,48,0,48
kafka,PR-13787,6,10,527,115,642
kafka,PR-13830,1,6,52,52,104
kafka,PR-13815,3,3,349,233,582
kafka,PR-13782,6,3,46,4,50
kafka,PR-13797,6,7,152,11,163
kafka,PR-13798,2,1,39,15,54
kafka,PR-13831,1,2,12,1,13
kafka,PR-13820,7,17,740,608,1348
kafka,PR-13832,1,1,31,1,32
kafka,PR-13795,9,9,2182,28,2210
kafka,PR-13712,4,1,15,19,34
kafka,PR-13818,4,17,1017,209,1226
kafka,PR-13828,3,8,105,23,128
kafka,PR-13814,2,4,49,23,72
kafka,PR-13676,5,2,34,2,36
kafka,PR-13820,8,17,740,608,1348
kafka,PR-13834,2,2,41,19,60
kafka,PR-13835,1,2,31,0,31
kafka,PR-13830,2,9,80,74,154
kafka,PR-13836,1,28,172,157,329
kafka,PR-13798,3,2,50,18,68
kafka,PR-13837,1,11,2437,0,2437
kafka,PR-13834,3,2,41,19,60
kafka,PR-13798,4,3,55,23,78
kafka,PR-13724,9,10,428,110,538
kafka,PR-13838,1,1,24,8,32
kafka,PR-13826,2,19,278,117,395
kafka,PR-13831,4,15,80,10,90
kafka,PR-13830,3,9,80,74,154
kafka,PR-13818,5,17,1023,215,1238
kafka,PR-13827,6,1,52,0,52
kafka,PR-13839,4,2,11,2,13
kafka,PR-13840,1,6,10,9,19
kafka,PR-13841,2,1,9,6,15
kafka,PR-13712,5,1,15,19,34
kafka,PR-13837,2,11,2437,0,2437
kafka,PR-13665,6,5,157,16,173
kafka,PR-13828,5,8,113,25,138
kafka,PR-13840,2,6,10,9,19
kafka,PR-13561,16,7,368,40,408
kafka,PR-13843,1,2,103,6,109
kafka,PR-13795,12,9,2183,28,2211
kafka,PR-13820,9,17,740,608,1348
kafka,PR-13843,2,2,104,7,111
kafka,PR-13795,13,9,2183,28,2211
kafka,PR-13844,1,1,2,1,3
kafka,PR-13831,5,15,80,10,90
kafka,PR-13845,1,2,57,2,59
kafka,PR-13838,2,2,38,20,58
kafka,PR-13756,13,6,445,5,450
kafka,PR-13816,5,4,128,76,204
kafka,PR-13846,1,2,30,0,30
kafka,PR-13798,5,6,182,70,252
kafka,PR-13847,1,2,6,2,8
kafka,PR-13843,3,2,102,7,109
kafka,PR-13826,3,19,279,118,397
kafka,PR-13711,5,1,119,224,343
kafka,PR-13828,6,8,113,25,138
kafka,PR-13843,4,2,102,7,109
kafka,PR-13849,1,4,15,3,18
kafka,PR-13848,2,6,40,47,87
kafka,PR-13802,6,7,786,189,975
kafka,PR-13820,10,17,740,608,1348
kafka,PR-13845,2,2,57,2,59
kafka,PR-13764,4,5,184,66,250
kafka,PR-13756,16,6,441,5,446
kafka,PR-13624,3,1,0,5,5
kafka,PR-13802,7,7,789,189,978
kafka,PR-13850,4,5,373,164,537
kafka,PR-13787,12,10,551,130,681
kafka,PR-13846,2,2,30,0,30
kafka,PR-13828,7,8,113,25,138
kafka,PR-13820,11,17,740,608,1348
kafka,PR-13848,3,1,27,5,32
kafka,PR-13624,4,1,0,5,5
kafka,PR-13801,5,3,316,7,323
kafka,PR-13852,1,4,34,0,34
kafka,PR-13820,13,17,760,608,1368
kafka,PR-13848,4,1,27,5,32
kafka,PR-13853,1,1,2,2,4
kafka,PR-13828,8,8,115,25,140
kafka,PR-13650,3,2,40,298,338
kafka,PR-13719,5,1,7,3,10
kafka,PR-13812,5,13,1590,5,1595
kafka,PR-13854,1,1,8,0,8
kafka,PR-13848,5,1,27,5,32
kafka,PR-13828,9,8,115,25,140
kafka,PR-13705,7,2,50,27,77
kafka,PR-13850,5,6,374,164,538
kafka,PR-13838,3,2,37,23,60
kafka,PR-13716,13,68,5081,1286,6367
kafka,PR-13756,19,6,466,5,471
kafka,PR-13782,8,3,46,4,50
kafka,PR-13854,2,1,8,0,8
kafka,PR-13848,6,1,27,5,32
kafka,PR-13855,2,9,627,37,664
kafka,PR-13787,13,14,566,146,712
kafka,PR-13798,8,6,183,73,256
kafka,PR-13856,1,14,682,523,1205
kafka,PR-13855,4,9,680,33,713
kafka,PR-13828,10,8,131,23,154
kafka,PR-13773,3,1,17,3,20
kafka,PR-13848,7,1,27,5,32
kafka,PR-13773,4,2,48,3,51
kafka,PR-13858,1,1,4,2,6
kafka,PR-13782,9,3,46,4,50
kafka,PR-13856,2,14,682,523,1205
kafka,PR-13850,6,6,374,164,538
kafka,PR-13859,1,5,23,5,28
kafka,PR-13705,8,2,50,27,77
kafka,PR-13828,11,8,131,23,154
kafka,PR-13857,3,2,9,8,17
kafka,PR-13857,4,2,10,9,19
kafka,PR-13812,6,13,1595,5,1600
kafka,PR-13719,6,1,8,3,11
kafka,PR-13857,5,2,10,9,19
kafka,PR-13665,11,5,164,18,182
kafka,PR-13857,6,2,10,9,19
kafka,PR-13860,1,16,2687,6,2693
kafka,PR-13861,1,1,0,0,0
kafka,PR-13848,8,1,31,8,39
kafka,PR-13857,7,2,10,9,19
kafka,PR-13857,8,2,10,9,19
kafka,PR-13858,2,1,4,2,6
kafka,PR-13816,7,4,128,76,204
kafka,PR-13857,9,2,10,9,19
kafka,PR-13857,10,2,10,9,19
kafka,PR-13773,5,3,45,4,49
kafka,PR-13848,9,1,31,8,39
kafka,PR-13862,1,3,44,53,97
kafka,PR-13857,11,2,10,9,19
kafka,PR-13826,6,25,857,151,1008
kafka,PR-13591,25,4,151,8,159
kafka,PR-13828,12,8,131,23,154
kafka,PR-13848,10,1,31,8,39
kafka,PR-13850,8,6,374,164,538
kafka,PR-13858,3,1,4,2,6
kafka,PR-13848,11,1,31,8,39
kafka,PR-13854,3,1,6,0,6
kafka,PR-13705,10,2,50,27,77
kafka,PR-13848,12,1,31,8,39
kafka,PR-13863,1,1,3,2,5
kafka,PR-13864,1,2,23,37,60
kafka,PR-13839,5,2,116,14,130
kafka,PR-13865,2,2,2,2,4
kafka,PR-13866,1,1,1,1,2
kafka,PR-13867,1,1,2,2,4
kafka,PR-13868,1,1,422,459,881
kafka,PR-13676,6,2,34,2,36
kafka,PR-13716,14,71,5513,1568,7081
kafka,PR-13870,3,23,5912,252,6164
kafka,PR-13855,7,12,674,39,713
kafka,PR-13871,1,1,1,1,2
kafka,PR-13705,11,2,50,27,77
kafka,PR-13839,6,2,116,14,130
kafka,PR-13862,2,3,45,54,99
kafka,PR-13872,1,6,7,11,18
kafka,PR-13665,12,5,164,18,182
kafka,PR-13812,7,13,1595,5,1600
kafka,PR-13817,4,1,37,0,37
kafka,PR-13696,2,1,17,3,20
kafka,PR-13813,3,4,104,29,133
kafka,PR-13868,4,1,519,458,977
kafka,PR-13872,2,6,8,11,19
kafka,PR-13850,9,6,374,165,539
kafka,PR-13561,17,8,367,36,403
kafka,PR-13874,1,1,38,55,93
kafka,PR-13875,1,1,1,1,2
kafka,PR-13868,5,1,519,458,977
kafka,PR-13850,10,6,374,165,539
kafka,PR-13856,4,14,695,523,1218
kafka,PR-13700,5,5,58,5,63
kafka,PR-13840,3,6,11,10,21
kafka,PR-13876,1,3,59,17,76
kafka,PR-13850,11,6,374,165,539
kafka,PR-13840,4,6,11,10,21
kafka,PR-13696,3,1,17,3,20
kafka,PR-13877,1,1,1,1,2
kafka,PR-13855,10,12,677,39,716
kafka,PR-13878,1,1,6,9,15
kafka,PR-13561,18,8,376,36,412
kafka,PR-13880,1,9,950,131,1081
kafka,PR-13881,1,2,5,5,10
kafka,PR-13856,5,14,695,523,1218
kafka,PR-13876,2,3,59,17,76
kafka,PR-13561,19,8,376,36,412
kafka,PR-13662,4,5,18,18,36
kafka,PR-13868,9,1,526,476,1002
kafka,PR-13883,1,35,76,77,153
kafka,PR-13665,13,4,133,12,145
kafka,PR-13876,3,3,81,39,120
kafka,PR-13884,1,39,55,55,110
kafka,PR-13886,1,5,10,10,20
kafka,PR-13887,1,3,10,10,20
kafka,PR-13888,1,26,42,42,84
kafka,PR-13889,1,3,9,9,18
kafka,PR-13885,3,11,26,26,52
kafka,PR-13882,5,29,55,55,110
kafka,PR-13883,2,35,74,74,148
kafka,PR-13888,2,26,42,42,84
kafka,PR-13816,8,4,128,76,204
kafka,PR-13890,2,3,58,10,68
kafka,PR-13850,14,6,481,160,641
kafka,PR-13868,10,1,526,476,1002
kafka,PR-13884,2,39,55,55,110
kafka,PR-13889,2,3,9,9,18
kafka,PR-13891,1,3,545,478,1023
kafka,PR-13798,9,6,231,72,303
kafka,PR-13787,14,14,566,146,712
kafka,PR-13582,6,19,45,44,89
kafka,PR-13852,2,4,34,0,34
kafka,PR-13883,3,6,19,19,38
kafka,PR-13889,3,3,9,9,18
kafka,PR-13850,15,6,481,160,641
kafka,PR-13665,14,2,20,4,24
kafka,PR-13884,3,39,55,55,110
kafka,PR-13839,8,2,116,14,130
kafka,PR-13893,1,1,3,1,4
kafka,PR-13850,16,6,486,160,646
kafka,PR-13773,6,3,45,4,49
kafka,PR-13582,7,19,45,44,89
kafka,PR-13894,1,1,1,1,2
kafka,PR-13895,1,3,46,7,53
kafka,PR-13896,1,2,4,1,5
kafka,PR-13812,8,14,1600,7,1607
kafka,PR-13897,1,1,19,41,60
kafka,PR-13898,1,3,90,69,159
kafka,PR-13899,1,10,1011,6,1017
kafka,PR-13582,8,19,47,46,93
kafka,PR-13895,2,5,59,10,69
kafka,PR-13760,6,5,444,179,623
kafka,PR-13798,10,6,231,72,303
kafka,PR-13787,15,14,556,140,696
kafka,PR-13582,9,19,47,46,93
kafka,PR-13831,6,16,84,10,94
kafka,PR-13895,3,5,59,10,69
kafka,PR-13716,15,74,9381,1596,10977
kafka,PR-13900,1,6,60,19,79
kafka,PR-13880,2,9,947,131,1078
kafka,PR-13901,1,10,953,80,1033
kafka,PR-13801,10,3,315,6,321
kafka,PR-13880,3,9,947,131,1078
kafka,PR-13902,1,1,1,2,3
kafka,PR-13903,1,1,1,1,2
kafka,PR-13818,6,17,1103,267,1370
kafka,PR-13904,1,1,2,2,4
kafka,PR-13905,1,3,108,4,112
kafka,PR-13855,12,12,416,41,457
kafka,PR-13907,1,66,1481,280,1761
kafka,PR-13817,5,1,37,0,37
kafka,PR-13862,3,3,59,68,127
kafka,PR-13818,7,17,1111,267,1378
kafka,PR-13837,3,11,2437,0,2437
kafka,PR-13908,1,1,1,1,2
kafka,PR-13818,9,17,1113,267,1380
kafka,PR-13910,1,3,62,15,77
kafka,PR-13911,2,2,37,24,61
kafka,PR-13787,16,14,556,140,696
kafka,PR-13910,2,3,62,15,77
kafka,PR-13912,2,1,4,2,6
kafka,PR-13716,16,76,9636,1662,11298
kafka,PR-13911,3,2,46,31,77
kafka,PR-13798,11,6,231,72,303
kafka,PR-13905,2,3,108,4,112
kafka,PR-13798,12,6,231,72,303
kafka,PR-13902,2,1,1,2,3
kafka,PR-13913,1,1,15,6,21
kafka,PR-13893,2,1,3,1,4
kafka,PR-13915,1,1,8,2,10
kafka,PR-13874,2,1,41,56,97
kafka,PR-13760,7,5,444,179,623
kafka,PR-13917,3,1,2,2,4
kafka,PR-13787,17,15,559,144,703
kafka,PR-13561,21,8,383,36,419
kafka,PR-13891,2,3,545,478,1023
kafka,PR-13910,3,4,60,20,80
kafka,PR-13798,13,5,240,77,317
kafka,PR-13918,2,17,569,153,722
kafka,PR-13821,3,15,637,364,1001
kafka,PR-13919,1,1,2,2,4
kafka,PR-13852,3,4,34,0,34
kafka,PR-13915,5,1,8,2,10
kafka,PR-13920,1,1,1,1,2
kafka,PR-13908,2,1,1,1,2
kafka,PR-13915,6,1,17,2,19
kafka,PR-13880,4,9,949,131,1080
kafka,PR-13921,1,1,3,0,3
kafka,PR-13591,27,4,150,7,157
kafka,PR-13847,2,3,16,7,23
kafka,PR-13908,3,1,1,1,2
kafka,PR-13743,2,1,1,1,2
kafka,PR-13884,4,38,54,54,108
kafka,PR-13676,7,2,34,2,36
kafka,PR-13798,14,5,240,77,317
kafka,PR-13787,18,15,559,144,703
kafka,PR-13918,4,17,569,153,722
kafka,PR-13901,2,10,953,80,1033
kafka,PR-13922,1,1,0,1,1
kafka,PR-13760,8,5,452,178,630
kafka,PR-13920,2,1,1,1,2
kafka,PR-13923,1,1,10,5,15
kafka,PR-13880,5,9,960,131,1091
kafka,PR-13924,2,3,34,5,39
kafka,PR-13923,2,1,14,5,19
kafka,PR-13862,4,3,59,68,127
kafka,PR-13847,3,4,22,7,29
kafka,PR-13925,2,2,80,17,97
kafka,PR-13926,1,2,63,23,86
kafka,PR-13927,1,16,326,154,480
kafka,PR-13901,7,10,943,78,1021
kafka,PR-13591,28,4,150,7,157
kafka,PR-13831,7,16,81,11,92
kafka,PR-13918,5,17,567,151,718
kafka,PR-13928,1,1,3,0,3
kafka,PR-13842,2,2,108,0,108
kafka,PR-13918,7,19,577,156,733
kafka,PR-13855,13,12,455,40,495
kafka,PR-13929,1,4,60,8,68
kafka,PR-13921,2,3,18,11,29
kafka,PR-13927,2,16,326,154,480
kafka,PR-13925,4,2,91,15,106
kafka,PR-13921,3,3,18,11,29
kafka,PR-13930,1,1,12,6,18
kafka,PR-13920,4,1,2,2,4
kafka,PR-13921,4,3,18,11,29
kafka,PR-13924,3,3,34,5,39
kafka,PR-13931,2,31,655,181,836
kafka,PR-13929,2,4,60,8,68
kafka,PR-13928,5,1,1,0,1
kafka,PR-13932,2,2,138,339,477
kafka,PR-13921,5,3,19,12,31
kafka,PR-13921,6,3,19,12,31
kafka,PR-13921,7,3,19,12,31
kafka,PR-13933,1,1,1,1,2
kafka,PR-13921,8,3,19,12,31
kafka,PR-13901,8,10,943,78,1021
kafka,PR-13927,8,16,323,154,477
kafka,PR-13915,7,1,47,2,49
kafka,PR-13934,1,1,2,6,8
kafka,PR-13935,1,2,9,2,11
kafka,PR-13924,4,3,39,5,44
kafka,PR-13929,3,4,78,21,99
kafka,PR-13936,1,6,216,67,283
kafka,PR-13937,1,1,53,0,53
kafka,PR-13787,19,16,573,153,726
kafka,PR-13929,4,4,78,21,99
kafka,PR-13760,9,5,452,178,630
kafka,PR-13935,2,2,9,2,11
kafka,PR-13929,5,4,80,21,101
kafka,PR-13923,4,1,11,5,16
kafka,PR-13939,1,1,3,3,6
kafka,PR-13938,2,3,11,5,16
kafka,PR-13926,2,2,63,23,86
kafka,PR-13901,9,10,958,78,1036
kafka,PR-13924,5,3,52,8,60
kafka,PR-13787,20,16,573,153,726
kafka,PR-13939,2,1,1,1,2
kafka,PR-13901,11,10,958,78,1036
kafka,PR-13940,2,5,104,1,105
kafka,PR-13787,21,16,570,150,720
kafka,PR-13941,1,1,48,5,53
kafka,PR-13945,1,3,115,4,119
kafka,PR-13913,2,2,57,7,64
kafka,PR-13946,1,2,26,26,52
kafka,PR-13948,1,1,5,3,8
kafka,PR-13561,22,8,383,36,419
kafka,PR-13949,1,2,21,2,23
kafka,PR-13950,1,1,80,135,215
kafka,PR-13901,12,10,965,78,1043
kafka,PR-13901,13,10,965,78,1043
kafka,PR-13944,3,13,206,20,226
kafka,PR-13951,4,2,348,352,700
kafka,PR-13914,5,2,104,17,121
kafka,PR-13952,1,3,30,22,52
kafka,PR-13925,5,2,91,15,106
kafka,PR-13944,4,13,206,20,226
kafka,PR-13876,4,3,62,17,79
kafka,PR-13950,2,1,59,97,156
kafka,PR-13837,4,11,2451,0,2451
kafka,PR-13914,6,2,105,17,122
kafka,PR-13953,1,1,0,1,1
kafka,PR-13950,4,1,65,104,169
kafka,PR-13953,2,1,0,1,1
kafka,PR-13954,1,6,95,77,172
kafka,PR-13955,1,2,42,6,48
kafka,PR-13950,5,1,65,104,169
kafka,PR-13954,4,6,94,77,171
kafka,PR-13949,2,2,28,2,30
kafka,PR-13898,2,3,98,75,173
kafka,PR-13953,3,1,0,1,1
kafka,PR-13956,1,2,61,46,107
kafka,PR-13954,5,6,95,77,172
kafka,PR-13957,1,5,125,1,126
kafka,PR-13958,1,2,9,9,18
kafka,PR-13929,9,4,144,34,178
kafka,PR-13927,9,16,300,138,438
kafka,PR-13959,1,8,149,16,165
kafka,PR-13960,1,2,31,1,32
kafka,PR-13962,1,2,46,6,52
kafka,PR-13961,1,16,794,110,904
kafka,PR-13787,22,16,570,150,720
kafka,PR-13821,4,16,751,416,1167
kafka,PR-13893,3,1,3,1,4
kafka,PR-13963,1,18,1683,128,1811
kafka,PR-13954,6,6,98,77,175
kafka,PR-13964,1,3,3,3,6
kafka,PR-13965,1,3,56,14,70
kafka,PR-13967,1,1,1,1,2
kafka,PR-13968,1,2,18,3,21
kafka,PR-13936,2,6,216,67,283
kafka,PR-13966,2,3,75,4,79
kafka,PR-13961,3,10,702,36,738
kafka,PR-13969,1,1,1,1,2
kafka,PR-13958,2,2,26,17,43
kafka,PR-13787,23,16,570,150,720
kafka,PR-13801,11,3,334,6,340
kafka,PR-13929,10,4,151,34,185
kafka,PR-13970,1,3,10,8,18
kafka,PR-13971,1,15,307,2,309
kafka,PR-13961,5,10,711,36,747
kafka,PR-13972,1,1,1,1,2
kafka,PR-13973,1,15,33,0,33
kafka,PR-13971,2,15,338,30,368
kafka,PR-13787,24,16,570,150,720
kafka,PR-13787,25,16,570,150,720
kafka,PR-13969,2,2,68,1,69
kafka,PR-13974,1,1,1,1,2
kafka,PR-13961,6,10,761,36,797
kafka,PR-13955,2,2,45,6,51
kafka,PR-13963,3,12,1682,51,1733
kafka,PR-13974,2,21,31,31,62
kafka,PR-13801,13,2,323,4,327
kafka,PR-13972,2,1,1,1,2
kafka,PR-13936,6,6,216,67,283
kafka,PR-13973,2,15,33,0,33
kafka,PR-13975,1,6,75,16,91
kafka,PR-13976,1,1,2,1,3
kafka,PR-13970,2,1,3,1,4
kafka,PR-13936,7,6,215,67,282
kafka,PR-13851,11,4,604,11,615
kafka,PR-13977,2,4,32,5,37
kafka,PR-13724,10,10,383,111,494
kafka,PR-13963,5,7,998,32,1030
kafka,PR-13978,1,1,164,171,335
kafka,PR-13974,3,21,33,33,66
kafka,PR-13963,6,7,998,32,1030
kafka,PR-13941,2,1,51,0,51
kafka,PR-13945,2,3,106,4,110
kafka,PR-13979,1,1,0,0,0
kafka,PR-13976,2,1,3,2,5
kafka,PR-13837,5,11,2459,0,2459
kafka,PR-13944,6,13,276,20,296
kafka,PR-13973,3,14,31,33,64
kafka,PR-13969,3,2,68,1,69
kafka,PR-13931,4,31,627,217,844
kafka,PR-13585,8,8,769,0,769
kafka,PR-13980,1,3,23,7,30
kafka,PR-13981,1,3,21,4,25
kafka,PR-13627,14,6,9,17,26
kafka,PR-13982,1,1,6,6,12
kafka,PR-13979,2,8,7,7,14
kafka,PR-13959,4,3,149,15,164
kafka,PR-13927,10,16,314,148,462
kafka,PR-13957,4,5,119,1,120
kafka,PR-13965,2,3,56,14,70
kafka,PR-13983,1,5,295,256,551
kafka,PR-13873,3,1,160,287,447
kafka,PR-13661,5,3,61,63,124
kafka,PR-13985,1,5,6,6,12
kafka,PR-13813,4,3,69,9,78
kafka,PR-13986,1,1,16,0,16
kafka,PR-13984,21,31,729,169,898
kafka,PR-13561,23,8,383,36,419
kafka,PR-13801,14,2,321,4,325
kafka,PR-13982,3,2,17,17,34
kafka,PR-13963,8,7,1019,32,1051
kafka,PR-13987,2,2,4,11,15
kafka,PR-13986,2,1,16,0,16
kafka,PR-13916,6,49,1890,334,2224
kafka,PR-13988,2,2,15,1,16
kafka,PR-13982,4,2,15,14,29
kafka,PR-13787,27,20,720,154,874
kafka,PR-13990,9,15,568,411,979
kafka,PR-13913,3,3,91,8,99
kafka,PR-13973,4,14,31,33,64
kafka,PR-13960,2,11,142,36,178
kafka,PR-13988,3,2,15,1,16
kafka,PR-13945,3,3,165,4,169
kafka,PR-13913,4,3,91,8,99
kafka,PR-13991,3,14,1339,66,1405
kafka,PR-13963,9,7,1060,48,1108
kafka,PR-13992,1,1,2,2,4
kafka,PR-13993,1,1,6,1,7
kafka,PR-13994,1,1,5,1,6
kafka,PR-13945,4,3,139,4,143
kafka,PR-13787,28,20,720,154,874
kafka,PR-13995,1,2,14,1,15
kafka,PR-13942,2,6,229,4,233
kafka,PR-13963,11,7,1058,48,1106
kafka,PR-13990,17,11,428,321,749
kafka,PR-13997,2,22,55,54,109
kafka,PR-13992,2,1,3,3,6
kafka,PR-13561,24,8,383,36,419
kafka,PR-13963,12,7,1058,48,1106
kafka,PR-13995,2,2,14,1,15
kafka,PR-13927,11,16,302,139,441
kafka,PR-13913,5,3,105,7,112
kafka,PR-13646,3,2,14,7,21
kafka,PR-13991,4,10,322,36,358
kafka,PR-14000,1,1,1,1,2
kafka,PR-13927,12,16,302,139,441
kafka,PR-13916,7,51,1937,334,2271
kafka,PR-13956,2,1,59,46,105
kafka,PR-14001,1,10,411,36,447
kafka,PR-13993,3,1,33,36,69
kafka,PR-14002,1,10,52,41,93
kafka,PR-13787,29,20,719,154,873
kafka,PR-14003,2,2,73,10,83
kafka,PR-13837,6,11,2459,0,2459
kafka,PR-14004,1,2,217,6,223
kafka,PR-14005,1,10,742,17,759
kafka,PR-13916,8,51,1978,370,2348
kafka,PR-13977,3,4,32,5,37
kafka,PR-13990,19,11,432,321,753
kafka,PR-14008,1,4,178,41,219
kafka,PR-14009,1,4,60,12,72
kafka,PR-13945,5,3,141,4,145
kafka,PR-13916,9,51,2051,372,2423
kafka,PR-14003,3,2,73,10,83
kafka,PR-13996,5,4,706,2,708
kafka,PR-13965,3,3,64,16,80
kafka,PR-13920,5,1,3,3,6
kafka,PR-14011,1,1,6,0,6
kafka,PR-14012,1,9,81,29,110
kafka,PR-13991,5,10,322,36,358
kafka,PR-13975,3,5,122,89,211
kafka,PR-13870,23,24,4829,625,5454
kafka,PR-14011,2,1,6,0,6
kafka,PR-13585,11,8,749,0,749
kafka,PR-13987,3,2,5,11,16
kafka,PR-14010,2,15,1042,227,1269
kafka,PR-13991,6,10,322,36,358
kafka,PR-14005,2,10,742,17,759
kafka,PR-14013,1,1,1,1,2
kafka,PR-14014,1,1,1,1,2
kafka,PR-14008,4,4,178,49,227
kafka,PR-14003,4,2,68,10,78
kafka,PR-14011,3,1,2,0,2
kafka,PR-13952,4,3,82,24,106
kafka,PR-14015,1,2,85,4,89
kafka,PR-14012,2,8,97,48,145
kafka,PR-13948,2,1,4,3,7
kafka,PR-14008,5,4,178,49,227
kafka,PR-14016,1,2,1,23,24
kafka,PR-13941,3,1,50,0,50
kafka,PR-13773,7,3,45,4,49
kafka,PR-14008,6,5,194,56,250
kafka,PR-13797,7,10,214,12,226
kafka,PR-13787,31,20,719,154,873
kafka,PR-14018,1,12,20,38,58
kafka,PR-14019,2,2,10,10,20
kafka,PR-13977,5,4,32,5,37
kafka,PR-13971,5,18,412,36,448
kafka,PR-14009,6,7,136,24,160
kafka,PR-13643,3,22,622,310,932
kafka,PR-14020,1,1,62,0,62
kafka,PR-14021,1,1,0,1,1
kafka,PR-13971,6,18,414,38,452
kafka,PR-14022,1,5,6,6,12
kafka,PR-14023,1,1,1,1,2
kafka,PR-14009,7,7,136,24,160
kafka,PR-14021,4,4,49,19,68
kafka,PR-13662,7,6,28,28,56
kafka,PR-13561,25,8,383,36,419
kafka,PR-13643,4,22,621,310,931
kafka,PR-14015,3,2,81,4,85
kafka,PR-13944,8,13,313,21,334
kafka,PR-13920,7,2,67,2,69
kafka,PR-13658,4,7,272,252,524
kafka,PR-14004,2,2,217,6,223
kafka,PR-14024,1,7,216,45,261
kafka,PR-14012,5,10,124,106,230
kafka,PR-13944,9,13,313,21,334
kafka,PR-13837,9,12,2503,0,2503
kafka,PR-13983,2,5,295,256,551
kafka,PR-14004,4,2,224,6,230
kafka,PR-13773,9,3,38,4,42
kafka,PR-14026,1,11,16,16,32
kafka,PR-13942,3,4,98,3,101
kafka,PR-13977,6,4,32,5,37
kafka,PR-13797,9,10,201,16,217
kafka,PR-14020,2,1,62,0,62
kafka,PR-13802,8,7,789,189,978
kafka,PR-14028,2,14,211,30,241
kafka,PR-13916,10,57,2311,379,2690
kafka,PR-13944,10,13,313,21,334
kafka,PR-13870,28,25,5009,616,5625
kafka,PR-14020,3,1,62,0,62
kafka,PR-13990,22,11,427,307,734
kafka,PR-13971,10,18,452,71,523
kafka,PR-14029,2,3,7,29,36
kafka,PR-14019,3,2,10,10,20
kafka,PR-13662,8,6,28,28,56
kafka,PR-13797,11,10,246,20,266
kafka,PR-13996,8,4,722,2,724
kafka,PR-14010,3,15,1062,264,1326
kafka,PR-14031,1,1,17,1,18
kafka,PR-14032,1,2,3,3,6
kafka,PR-13627,15,6,9,17,26
kafka,PR-14033,1,10,145,56,201
kafka,PR-13773,11,3,38,4,42
kafka,PR-13658,6,7,276,252,528
kafka,PR-13920,8,2,88,2,90
kafka,PR-13944,11,13,313,21,334
kafka,PR-14034,1,13,1398,1097,2495
kafka,PR-13983,3,5,293,254,547
kafka,PR-13860,2,16,2687,6,2693
kafka,PR-13944,12,13,313,21,334
kafka,PR-14004,5,2,224,6,230
kafka,PR-14037,1,1,50,17,67
kafka,PR-14038,1,1,17,0,17
kafka,PR-13627,16,6,9,17,26
kafka,PR-14002,3,10,52,41,93
kafka,PR-14028,3,14,215,30,245
kafka,PR-14005,3,10,821,17,838
kafka,PR-13662,9,6,28,28,56
kafka,PR-13870,35,25,5014,616,5630
kafka,PR-14036,2,2,2,2,4
kafka,PR-14035,3,1,16,8,24
kafka,PR-14039,1,1,9,2,11
kafka,PR-13643,6,22,636,306,942
kafka,PR-14040,1,1,0,21,21
kafka,PR-13842,3,2,124,0,124
kafka,PR-14032,7,3,4,4,8
kafka,PR-14041,1,1,2,1,3
kafka,PR-13870,36,25,4981,616,5597
kafka,PR-14033,2,10,227,63,290
kafka,PR-13971,12,20,454,72,526
kafka,PR-14031,2,1,17,1,18
kafka,PR-13662,10,6,28,28,56
kafka,PR-13996,9,4,722,2,724
kafka,PR-13949,5,2,28,2,30
kafka,PR-14026,3,11,16,16,32
kafka,PR-14030,6,8,1586,259,1845
kafka,PR-14042,1,1,11,2,13
kafka,PR-14043,1,5,256,18,274
kafka,PR-13999,4,5,361,15,376
kafka,PR-14040,2,1,0,21,21
kafka,PR-13966,4,2,2,4,6
kafka,PR-14044,1,5,58,15,73
kafka,PR-14012,6,10,124,106,230
kafka,PR-13975,5,5,135,100,235
kafka,PR-13662,11,6,28,28,56
kafka,PR-14047,1,7,401,0,401
kafka,PR-14046,3,17,101,63,164
kafka,PR-14048,2,7,127,1,128
kafka,PR-13977,7,4,32,5,37
kafka,PR-14047,2,7,401,0,401
kafka,PR-14029,3,3,7,29,36
kafka,PR-13971,13,20,454,72,526
kafka,PR-14050,1,2,39,3,42
kafka,PR-14024,5,8,286,30,316
kafka,PR-14051,1,1,7,1,8
kafka,PR-13916,11,59,2358,413,2771
kafka,PR-14044,2,3,46,3,49
kafka,PR-14046,5,17,102,63,165
kafka,PR-13971,14,20,454,72,526
kafka,PR-13996,10,4,793,2,795
kafka,PR-14010,4,15,1062,264,1326
kafka,PR-14053,5,2,89,9,98
kafka,PR-14055,3,25,555,5,560
kafka,PR-13999,5,5,360,15,375
kafka,PR-14056,1,7,4751,45,4796
kafka,PR-14053,6,5,151,34,185
kafka,PR-13817,6,1,37,0,37
kafka,PR-14045,4,8,75,50,125
kafka,PR-14046,7,20,130,75,205
kafka,PR-14057,1,3,76,69,145
kafka,PR-14058,1,4,94,24,118
kafka,PR-14051,2,1,8,1,9
kafka,PR-13966,5,2,2,4,6
kafka,PR-14045,5,8,73,50,123
kafka,PR-14061,1,1,1,1,2
kafka,PR-14060,3,1,1,1,2
kafka,PR-14059,2,9,843,601,1444
kafka,PR-13897,2,1,20,43,63
kafka,PR-14017,5,6,3313,42,3355
kafka,PR-14062,1,3,161,88,249
kafka,PR-14030,7,8,1737,259,1996
kafka,PR-14046,8,20,146,75,221
kafka,PR-14047,3,7,406,0,406
kafka,PR-13797,12,11,269,25,294
kafka,PR-14005,4,12,844,22,866
kafka,PR-14017,8,7,3421,44,3465
kafka,PR-14064,1,10,827,2,829
kafka,PR-14050,2,2,39,3,42
kafka,PR-13990,23,11,427,307,734
kafka,PR-14053,7,1,25,17,42
kafka,PR-14017,9,9,3479,66,3545
kafka,PR-14058,2,4,96,24,120
kafka,PR-14045,6,8,73,50,123
kafka,PR-14065,3,2,3,3,6
kafka,PR-14057,2,4,77,70,147
kafka,PR-14046,9,20,146,75,221
kafka,PR-14047,4,7,409,0,409
kafka,PR-13562,14,9,1072,827,1899
kafka,PR-14045,7,8,73,50,123
kafka,PR-14059,3,9,843,601,1444
kafka,PR-14057,4,4,77,70,147
kafka,PR-13920,9,2,88,2,90
kafka,PR-14046,10,20,146,75,221
kafka,PR-13773,12,3,38,4,42
kafka,PR-14047,5,7,409,0,409
kafka,PR-14058,3,4,99,24,123
kafka,PR-13562,15,10,1071,828,1899
kafka,PR-14024,7,8,263,31,294
kafka,PR-14059,6,8,823,600,1423
kafka,PR-14066,1,5,5,10,15
kafka,PR-13662,12,6,28,28,56
kafka,PR-14017,10,9,3464,74,3538
kafka,PR-14055,4,26,658,5,663
kafka,PR-14067,1,10,1830,38,1868
kafka,PR-13797,13,11,269,25,294
kafka,PR-14068,1,1,42,0,42
kafka,PR-13707,5,2,7,5,12
kafka,PR-14069,1,4,7,6,13
kafka,PR-14070,1,1,1,1,2
kafka,PR-14071,1,1,2,2,4
kafka,PR-14071,2,1,18,2,20
kafka,PR-14072,2,1,1,1,2
kafka,PR-14073,2,4,210,11,221
kafka,PR-14074,1,5,68,68,136
kafka,PR-14075,1,1,6,6,12
kafka,PR-14075,2,1,6,6,12
kafka,PR-14077,1,4,325,2,327
kafka,PR-14076,2,4,25,33,58
kafka,PR-14076,3,5,34,35,69
kafka,PR-14051,3,2,60,3,63
kafka,PR-14078,1,2,147,32,179
kafka,PR-13571,3,3,102,3,105
kafka,PR-14051,4,2,60,3,63
kafka,PR-14079,2,6,82,24,106
kafka,PR-14051,5,2,60,3,63
kafka,PR-14080,1,1,5,4,9
kafka,PR-14079,3,6,115,27,142
kafka,PR-14004,6,2,224,6,230
kafka,PR-14072,3,2,2,2,4
kafka,PR-14067,2,10,1822,38,1860
kafka,PR-13561,26,9,387,38,425
kafka,PR-14081,1,1,1,1,2
kafka,PR-13916,14,59,2351,420,2771
kafka,PR-14082,1,5,374,6,380
kafka,PR-14083,1,62,2361,427,2788
kafka,PR-14033,4,10,229,63,292
kafka,PR-13707,6,2,12,8,20
kafka,PR-14074,2,5,68,68,136
kafka,PR-14073,3,4,210,11,221
kafka,PR-14064,2,10,830,2,832
kafka,PR-14062,2,3,161,88,249
kafka,PR-14084,1,2,15,3,18
kafka,PR-14085,1,2,13,13,26
kafka,PR-14030,10,6,902,123,1025
kafka,PR-14086,2,1,8,0,8
kafka,PR-13643,7,16,644,294,938
kafka,PR-14083,2,62,2361,427,2788
kafka,PR-14010,8,28,1404,427,1831
kafka,PR-14087,1,28,1404,427,1831
kafka,PR-13990,26,12,437,313,750
kafka,PR-14088,1,6,13,17,30
kafka,PR-14053,9,5,157,42,199
kafka,PR-14084,2,2,15,3,18
kafka,PR-14089,1,11,187,144,331
kafka,PR-14064,3,10,870,9,879
kafka,PR-14051,6,2,60,3,63
kafka,PR-14083,3,62,2378,427,2805
kafka,PR-14051,7,2,60,3,63
kafka,PR-14090,1,2,212,166,378
kafka,PR-14079,4,11,150,56,206
kafka,PR-14091,1,1,1,1,2
kafka,PR-14051,8,2,60,3,63
kafka,PR-14092,1,2,20,13,33
kafka,PR-14059,7,8,823,600,1423
kafka,PR-14067,7,20,2181,176,2357
kafka,PR-14089,3,16,209,162,371
kafka,PR-14094,1,1,1,1,2
kafka,PR-14093,2,3,223,0,223
kafka,PR-14095,1,1,1,0,1
kafka,PR-14093,3,3,225,0,225
kafka,PR-14089,4,16,211,163,374
kafka,PR-14028,4,12,152,25,177
kafka,PR-14096,1,18,410,338,748
kafka,PR-14086,3,3,15,2,17
kafka,PR-13987,5,4,1736,12,1748
kafka,PR-13643,8,18,743,304,1047
kafka,PR-14095,2,0,0,0,0
kafka,PR-14056,2,7,4735,46,4781
kafka,PR-14097,1,14,1233,217,1450
kafka,PR-14098,1,1,1,1,2
kafka,PR-14053,12,5,146,30,176
kafka,PR-14064,4,10,967,9,976
kafka,PR-13920,10,2,88,2,90
kafka,PR-14094,3,2,32,20,52
kafka,PR-13920,11,2,89,2,91
kafka,PR-14096,2,18,410,338,748
kafka,PR-14094,4,2,32,20,52
kafka,PR-14100,1,1,1,1,2
kafka,PR-13801,15,3,444,5,449
kafka,PR-14101,1,1,1,0,1
kafka,PR-14067,8,20,2220,177,2397
kafka,PR-14090,2,1,208,163,371
kafka,PR-14102,1,2,1529,2443,3972
kafka,PR-14017,13,9,3339,165,3504
kafka,PR-14028,5,12,152,25,177
kafka,PR-14049,6,7,114,0,114
kafka,PR-14083,7,66,2398,435,2833
kafka,PR-14053,13,5,147,30,177
kafka,PR-14090,3,1,208,163,371
kafka,PR-14104,2,2,111,9,120
kafka,PR-14089,7,17,246,210,456
kafka,PR-14105,1,1,5,0,5
kafka,PR-14090,4,1,208,163,371
kafka,PR-14103,2,7,85,3,88
kafka,PR-14097,2,14,1244,228,1472
kafka,PR-14067,9,20,2230,177,2407
kafka,PR-14017,14,9,3339,165,3504
kafka,PR-14106,1,8,1018,1,1019
kafka,PR-13643,9,18,746,304,1050
kafka,PR-14090,5,1,208,163,371
kafka,PR-14107,2,6,208,101,309
kafka,PR-14068,4,2,66,0,66
kafka,PR-14097,3,14,1242,228,1470
kafka,PR-14055,6,26,677,5,682
kafka,PR-14088,3,7,54,18,72
kafka,PR-14097,4,11,405,162,567
kafka,PR-14108,2,11,486,177,663
kafka,PR-14097,5,11,459,199,658
kafka,PR-14090,6,1,208,163,371
kafka,PR-14067,10,20,2245,194,2439
kafka,PR-14107,3,6,208,100,308
kafka,PR-14110,2,1,49,0,49
kafka,PR-14111,1,52,409,149,558
kafka,PR-14049,7,7,136,0,136
kafka,PR-13801,17,3,336,5,341
kafka,PR-14069,2,4,7,6,13
kafka,PR-14090,7,1,208,163,371
kafka,PR-13947,9,3,121,25,146
kafka,PR-13966,6,2,2,4,6
kafka,PR-14090,8,1,208,163,371
kafka,PR-14110,3,1,49,0,49
kafka,PR-14112,1,5,34,0,34
kafka,PR-14113,1,4,28,2,30
kafka,PR-14049,8,7,136,0,136
kafka,PR-14086,4,3,14,2,16
kafka,PR-14084,3,2,15,3,18
kafka,PR-14114,2,7,152,53,205
kafka,PR-14099,9,19,865,283,1148
kafka,PR-14115,3,2,68,14,82
kafka,PR-13643,10,18,775,304,1079
kafka,PR-14114,3,9,280,53,333
kafka,PR-14117,1,12,178,226,404
kafka,PR-14099,10,19,866,281,1147
kafka,PR-14090,10,1,208,163,371
kafka,PR-14086,5,3,14,2,16
kafka,PR-14109,2,1,6,5,11
kafka,PR-14097,6,11,464,200,664
kafka,PR-14115,4,2,74,15,89
kafka,PR-14118,2,5,173,20,193
kafka,PR-14118,4,5,171,20,191
kafka,PR-13990,27,12,437,313,750
kafka,PR-14056,4,6,1316,261,1577
kafka,PR-13920,12,2,89,2,91
kafka,PR-14118,5,5,171,20,191
kafka,PR-14114,4,10,288,65,353
kafka,PR-14099,11,19,972,362,1334
kafka,PR-14118,6,6,262,20,282
kafka,PR-14097,7,11,472,192,664
kafka,PR-14099,12,19,959,361,1320
kafka,PR-14090,11,1,208,163,371
kafka,PR-14117,2,12,178,226,404
kafka,PR-14114,5,10,288,65,353
kafka,PR-14056,5,6,1316,261,1577
kafka,PR-14119,1,2,28,10,38
kafka,PR-14083,8,66,2411,435,2846
kafka,PR-14121,1,1,0,5,5
kafka,PR-14099,14,19,959,361,1320
kafka,PR-14117,4,12,221,269,490
kafka,PR-13860,3,15,2683,6,2689
kafka,PR-14115,5,3,99,20,119
kafka,PR-14120,2,9,819,33,852
kafka,PR-14117,5,12,228,276,504
kafka,PR-14122,1,1,1407,1610,3017
kafka,PR-14118,8,6,255,25,280
kafka,PR-14121,3,1,3,0,3
kafka,PR-14123,2,5,68,23,91
kafka,PR-14121,4,1,5,0,5
kafka,PR-14124,1,8,312,1,313
kafka,PR-14125,1,2,19,2,21
kafka,PR-14126,1,1,5,5,10
kafka,PR-14123,3,5,68,23,91
kafka,PR-14109,3,1,6,5,11
kafka,PR-14096,3,18,410,338,748
kafka,PR-14114,6,10,288,65,353
kafka,PR-13947,10,3,121,25,146
kafka,PR-14127,1,10,950,266,1216
kafka,PR-14108,5,12,1304,290,1594
kafka,PR-14127,2,10,950,266,1216
kafka,PR-14112,3,15,985,267,1252
kafka,PR-14114,7,10,292,67,359
kafka,PR-14112,4,17,1088,272,1360
karaf,PR-1213,3,3,3,2,5
karaf,PR-1077,2,12,243,2,245
karaf,PR-1213,4,3,3,2,5
karaf,PR-1077,3,12,243,2,245
karaf,PR-1287,1,7,30,7,37
karaf,PR-1287,2,7,30,7,37
karaf,PR-1288,1,1,9,3,12
karaf,PR-1289,1,1,1,1,2
karaf,PR-1290,1,1,1,1,2
karaf,PR-1291,1,5,10,16,26
karaf,PR-1292,1,1,13,1,14
karaf,PR-1293,1,4,331,6,337
karaf,PR-1294,1,4,331,6,337
karaf,PR-1295,1,1,1,1,2
karaf,PR-1294,2,4,331,6,337
karaf,PR-1296,1,1,2,2,4
karaf,PR-1290,2,1,1,1,2
karaf,PR-1297,1,1,1,1,2
karaf,PR-1298,1,1,1,1,2
karaf,PR-1299,1,1,1,1,2
karaf,PR-1300,1,1,2,2,4
karaf,PR-1300,2,1,2,2,4
karaf,PR-1290,4,1,1,1,2
karaf,PR-1301,1,1,1,1,2
karaf,PR-1302,1,1,1,1,2
karaf,PR-1301,2,1,1,1,2
karaf,PR-1302,2,1,1,1,2
karaf,PR-1303,1,2,2,2,4
karaf,PR-1303,2,2,2,2,4
karaf,PR-1300,3,1,2,2,4
karaf,PR-1304,1,1,1,1,2
karaf,PR-1305,1,1,1,1,2
karaf,PR-1306,1,1,1,1,2
karaf,PR-1307,1,1,1,1,2
karaf,PR-1308,1,1,1,1,2
karaf,PR-1309,1,1,1,1,2
karaf,PR-1310,1,1,1,1,2
karaf,PR-1311,1,1,1,1,2
karaf,PR-1312,1,1,1,1,2
karaf,PR-1307,2,1,1,1,2
karaf,PR-1306,2,1,1,1,2
karaf,PR-1300,4,1,2,2,4
karaf,PR-1306,3,1,1,1,2
karaf,PR-1306,4,1,1,1,2
karaf,PR-1310,2,1,1,1,2
karaf,PR-1308,2,1,1,1,2
karaf,PR-1310,3,1,1,1,2
karaf,PR-1313,1,2,2,2,4
karaf,PR-1314,1,1,1,1,2
karaf,PR-1316,1,1,0,314,314
karaf,PR-1317,1,1,1,1,2
karaf,PR-1315,2,2,3,3,6
karaf,PR-1294,3,4,331,6,337
karaf,PR-1317,2,2,2,2,4
karaf,PR-1289,2,1,1,1,2
karaf,PR-1291,2,5,10,16,26
karaf,PR-1289,3,1,1,1,2
karaf,PR-1291,3,5,10,16,26
karaf,PR-1287,3,7,30,7,37
karaf,PR-1287,4,8,47,7,54
karaf,PR-1318,1,1,1,1,2
karaf,PR-1321,1,1,1,1,2
karaf,PR-1323,1,1,1,1,2
karaf,PR-1322,2,1,1,1,2
karaf,PR-1319,3,1,1,1,2
karaf,PR-1320,3,1,1,1,2
karaf,PR-1324,1,1,9,1,10
karaf,PR-1321,2,1,1,1,2
karaf,PR-1323,2,1,1,1,2
karaf,PR-1320,4,1,1,1,2
karaf,PR-1325,1,4,29,9,38
karaf,PR-1326,1,1,71,5,76
karaf,PR-1327,1,1,4,0,4
karaf,PR-1328,2,1,1,1,2
karaf,PR-1329,1,1,2,1,3
karaf,PR-1330,1,1,1,1,2
karaf,PR-1213,5,3,3,2,5
karaf,PR-1077,4,12,243,2,245
karaf,PR-1331,1,1,1,1,2
karaf,PR-1332,1,1,1,1,2
karaf,PR-1333,1,1,1,1,2
karaf,PR-1334,1,1,1,1,2
karaf,PR-1335,1,1,1,1,2
karaf,PR-1336,1,1,2,1,3
karaf,PR-1337,1,3,4,21,25
karaf,PR-1338,1,1,2,4,6
karaf,PR-1340,1,1,1,1,2
karaf,PR-1341,1,1,1,1,2
karaf,PR-1339,1,1,68,1,69
karaf,PR-1342,1,4,24,0,24
karaf,PR-1343,1,1,18,0,18
karaf,PR-1343,2,1,18,0,18
karaf,PR-1344,1,1,22,0,22
karaf,PR-1345,1,1,1,1,2
karaf,PR-1345,2,1,1,1,2
karaf,PR-1346,1,3,232,0,232
karaf,PR-1346,2,3,232,0,232
karaf,PR-1348,1,1,1,1,2
karaf,PR-1349,1,1,1,1,2
karaf,PR-1350,2,2,2,2,4
karaf,PR-1351,2,1,1,1,2
karaf,PR-1352,1,4,44,0,44
karaf,PR-1353,1,2,2,2,4
karaf,PR-1354,1,1,1,1,2
karaf,PR-1355,2,1,1,1,2
karaf,PR-1356,1,1,1,1,2
karaf,PR-1357,1,1,1,1,2
karaf,PR-1357,2,1,1,1,2
karaf,PR-1358,1,5,54,4,58
karaf,PR-1359,1,1,1,1,2
karaf,PR-1360,1,1,2,1,3
karaf,PR-1361,1,1,1,1,2
karaf,PR-1362,1,1,28,5,33
karaf,PR-1363,1,1,13,0,13
karaf,PR-1364,1,1,1,1,2
karaf,PR-1363,2,1,13,0,13
karaf,PR-1365,1,1,9,7,16
karaf,PR-1366,1,1,1,1,2
karaf,PR-1367,1,1,1,1,2
karaf,PR-1368,1,2,204,0,204
karaf,PR-1369,1,2,29,32,61
karaf,PR-1370,1,1,1,1,2
karaf,PR-1371,1,1,1,1,2
karaf,PR-1372,1,1,1,1,2
karaf,PR-1373,1,1,1,1,2
karaf,PR-1374,1,2,55,8,63
karaf,PR-1375,1,1,16,2,18
karaf,PR-1375,2,1,16,2,18
karaf,PR-1376,1,3,130,0,130
karaf,PR-1377,1,3,14,0,14
karaf,PR-1377,2,3,18,0,18
karaf,PR-1377,3,3,11,0,11
karaf,PR-1377,4,3,11,0,11
karaf,PR-1378,1,7,120,5,125
karaf,PR-1379,1,2,89,16,105
karaf,PR-1380,1,1,16,1,17
karaf,PR-1381,1,1,1,1,2
karaf,PR-1382,1,1,1,1,2
karaf,PR-1383,1,1,1,1,2
karaf,PR-1384,1,4,44,20,64
karaf,PR-1386,1,1,1,1,2
karaf,PR-1387,2,2,2,2,4
karaf,PR-1390,2,2,18,2,20
karaf,PR-1390,3,1,1,1,2
karaf,PR-1391,1,1,7,2,9
karaf,PR-1385,4,2,2,1,3
karaf,PR-1390,5,1,1,1,2
karaf,PR-1391,2,1,7,2,9
karaf,PR-1392,1,2,2,2,4
karaf,PR-1394,1,2,21,4,25
karaf,PR-1395,1,1,1,1,2
karaf,PR-1393,6,2,4,4,8
karaf,PR-1396,1,1,1,1,2
karaf,PR-1397,1,3,3,213,216
karaf,PR-1397,2,3,4,213,217
karaf,PR-1398,1,1,1,1,2
karaf,PR-1399,1,1,1,1,2
karaf,PR-1400,1,1,1,1,2
karaf,PR-1401,1,1,1,0,1
karaf,PR-1399,2,1,1,1,2
karaf,PR-1401,2,1,1,0,1
karaf,PR-1402,1,1,1,1,2
karaf,PR-1402,2,1,1,1,2
karaf,PR-1402,3,1,1,1,2
karaf,PR-1403,1,1,1,1,2
karaf,PR-1404,1,1,1,1,2
karaf,PR-1405,1,1,1,1,2
karaf,PR-1406,1,1,1,1,2
karaf,PR-1404,2,1,1,1,2
karaf,PR-1407,1,3,25,23,48
karaf,PR-1408,1,1,8,0,8
karaf,PR-1409,1,1,1,1,2
karaf,PR-1410,1,1,1,1,2
karaf,PR-1410,2,1,1,1,2
karaf,PR-1411,1,1,5,0,5
karaf,PR-1412,1,1,1,1,2
karaf,PR-1413,2,1,3,1,4
karaf,PR-1414,2,1,1,1,2
karaf,PR-1415,2,2,2,2,4
karaf,PR-1416,1,1,1,1,2
karaf,PR-1417,1,1,6,1,7
karaf,PR-1418,1,1,1,1,2
karaf,PR-1419,1,1,1,1,2
karaf,PR-1420,1,1,1,1,2
karaf,PR-1421,2,1,1,1,2
karaf,PR-1422,1,1,1,1,2
karaf,PR-1424,1,3,8,1,9
karaf,PR-1423,2,1,2,2,4
karaf,PR-1423,3,1,2,2,4
karaf,PR-1425,1,1,1,1,2
karaf,PR-1426,2,1,1,1,2
karaf,PR-1426,3,1,1,1,2
karaf,PR-1427,1,2,2,0,2
karaf,PR-1427,2,2,4,0,4
karaf,PR-1427,3,2,4,0,4
karaf,PR-1429,1,2,4,1,5
karaf,PR-1430,3,1,1,1,2
karaf,PR-1431,1,1,1,1,2
karaf,PR-1432,1,1,1,1,2
karaf,PR-1433,1,1,1,1,2
karaf,PR-1434,1,1,1,1,2
karaf,PR-1435,1,1,2,2,4
karaf,PR-1436,1,1,2,2,4
karaf,PR-1437,1,1,1,1,2
karaf,PR-1438,1,1,1,1,2
karaf,PR-1439,1,1,1,1,2
karaf,PR-1436,2,1,2,2,4
karaf,PR-1440,1,1,1,1,2
karaf,PR-1441,1,1,4,0,4
karaf,PR-1440,2,1,1,1,2
karaf,PR-1442,1,1,4,7,11
karaf,PR-1443,1,2,4,4,8
karaf,PR-1444,1,4,25,6,31
karaf,PR-1445,1,1,1,1,2
karaf,PR-1447,1,1,1,1,2
karaf,PR-1448,1,2,2,2,4
karaf,PR-1447,2,1,1,1,2
karaf,PR-1449,1,1,5,3,8
karaf,PR-1450,3,1,1,1,2
karaf,PR-1446,5,3,3,2,5
karaf,PR-1451,1,1,1,1,2
karaf,PR-1446,6,3,3,2,5
karaf,PR-1446,7,3,3,2,5
karaf,PR-1446,9,1,1,1,2
karaf,PR-1452,1,1,1,1,2
karaf,PR-1453,1,2,2,5,7
karaf,PR-1454,1,3,5,5,10
karaf,PR-1457,2,2,6,6,12
karaf,PR-1458,2,1,1,1,2
karaf,PR-1459,1,1,1,1,2
karaf,PR-1460,1,1,1,1,2
karaf,PR-1461,1,1,1,1,2
karaf,PR-1461,2,1,1,1,2
karaf,PR-1462,1,7,30,22,52
karaf,PR-1462,2,8,32,25,57
karaf,PR-1463,1,3,139,61,200
karaf,PR-1464,1,1,58,0,58
karaf,PR-1465,1,1,1,1,2
karaf,PR-1466,1,1,1,1,2
karaf,PR-1467,2,1,1,1,2
karaf,PR-1468,1,1,1,1,2
karaf,PR-1469,1,1,1,1,2
karaf,PR-1470,1,1,1,1,2
karaf,PR-1471,1,1,1,1,2
karaf,PR-1472,1,1,1,1,2
karaf,PR-1473,1,1,5,3,8
karaf,PR-1474,1,1,22,1,23
karaf,PR-1475,1,2,11,0,11
karaf,PR-1476,1,1,1,1,2
karaf,PR-1477,1,1,19,10,29
karaf,PR-1478,1,1,1,1,2
karaf,PR-1479,1,7,39,8,47
karaf,PR-1480,2,1,1,1,2
karaf,PR-1481,2,1,1,1,2
karaf,PR-1482,1,6,26,0,26
karaf,PR-1483,1,1,1,1,2
karaf,PR-1483,2,1,1,1,2
karaf,PR-1485,1,2,10,2,12
karaf,PR-1486,1,1,1,1,2
karaf,PR-1487,1,3,22,4,26
karaf,PR-1487,2,3,22,4,26
karaf,PR-1488,1,1,2,2,4
karaf,PR-1489,1,1,5,3,8
karaf,PR-1490,1,34,308,870,1178
karaf,PR-1490,2,34,313,873,1186
karaf,PR-1493,2,1,12,5,17
karaf,PR-1496,1,1,19,0,19
karaf,PR-1495,2,1,1,1,2
karaf,PR-1494,2,1,1,1,2
karaf,PR-1492,2,5,45,8,53
karaf,PR-1492,3,5,45,8,53
karaf,PR-1497,1,1,3,1,4
karaf,PR-1498,1,1,1,1,2
karaf,PR-1497,2,1,3,1,4
karaf,PR-1499,1,1,1,1,2
karaf,PR-1500,1,1,1,1,2
karaf,PR-1501,1,2,7,1,8
karaf,PR-1503,1,1,1,1,2
karaf,PR-1504,1,1,1,1,2
karaf,PR-1505,1,1,2,2,4
karaf,PR-1501,2,3,16,6,22
karaf,PR-1501,3,3,16,6,22
karaf,PR-1500,2,1,1,1,2
karaf,PR-1506,1,1,0,9,9
karaf,PR-1506,2,1,8,8,16
karaf,PR-1504,2,1,1,1,2
karaf,PR-1502,3,1,2,2,4
karaf,PR-1505,2,1,2,2,4
karaf,PR-1507,1,1,1,1,2
karaf,PR-1490,3,40,703,1081,1784
karaf,PR-1504,3,1,1,1,2
karaf,PR-1508,1,1,7,7,14
karaf,PR-1507,2,1,1,1,2
karaf,PR-1507,3,1,1,1,2
karaf,PR-1504,4,1,1,1,2
karaf,PR-1502,4,1,2,2,4
karaf,PR-1509,1,1,1,1,2
karaf,PR-1510,1,1,1,1,2
karaf,PR-1511,1,1,1,1,2
karaf,PR-1512,1,1,1,1,2
karaf,PR-1511,2,1,1,1,2
karaf,PR-1514,1,1,1,1,2
karaf,PR-1516,1,1,1,1,2
karaf,PR-1517,1,1,1,1,2
karaf,PR-1502,5,1,2,2,4
karaf,PR-1515,2,2,2,2,4
karaf,PR-1519,2,4,3,8,11
karaf,PR-1521,2,1,1,1,2
karaf,PR-1523,1,1,1,1,2
karaf,PR-1524,1,1,1,1,2
karaf,PR-1525,1,1,1,1,2
karaf,PR-1502,6,1,2,2,4
karaf,PR-1526,1,3,3,3,6
karaf,PR-1527,1,3,4,3,7
karaf,PR-1521,4,1,1,1,2
karaf,PR-1502,7,2,3,3,6
karaf,PR-1426,5,2,2,2,4
karaf,PR-1528,1,1,1,1,2
karaf,PR-1522,6,1,1,1,2
karaf,PR-1426,6,2,4,4,8
karaf,PR-1529,1,1,1,1,2
karaf,PR-1530,1,1,1,1,2
karaf,PR-1531,1,1,1,1,2
karaf,PR-1532,1,1,1,1,2
karaf,PR-1533,1,1,1,1,2
karaf,PR-1534,1,1,1,1,2
karaf,PR-1518,3,1,1,1,2
karaf,PR-1490,4,40,703,1081,1784
karaf,PR-1535,1,1,2,1,3
karaf,PR-1536,1,9,415,1,416
karaf,PR-1536,2,7,413,1,414
karaf,PR-1537,1,1,12,4,16
karaf,PR-1538,1,2,0,648,648
karaf,PR-1539,1,1,1,1,2
karaf,PR-1540,1,1,1,1,2
karaf,PR-1541,1,1,1,1,2
karaf,PR-1542,1,1,1,1,2
karaf,PR-1543,1,1,1,1,2
karaf,PR-1542,2,1,1,1,2
karaf,PR-1544,1,1,0,1,1
karaf,PR-1545,1,1,1,1,2
karaf,PR-1546,1,1,1,1,2
karaf,PR-1547,1,1,1,1,2
karaf,PR-1537,2,1,12,4,16
karaf,PR-1548,1,2,24,1,25
karaf,PR-1536,3,7,413,1,414
karaf,PR-1549,1,1,1,0,1
karaf,PR-1549,2,1,2,2,4
karaf,PR-1550,1,1,10,0,10
karaf,PR-1551,1,1,2,3,5
karaf,PR-1550,2,1,2,0,2
karaf,PR-1553,1,1,1,1,2
karaf,PR-1553,2,1,1,1,2
karaf,PR-1552,2,4,11,5,16
karaf,PR-1552,4,5,12,6,18
karaf,PR-1554,1,1,1,1,2
karaf,PR-1555,1,1,6,6,12
karaf,PR-1556,1,1,1,1,2
karaf,PR-1556,2,1,1,1,2
karaf,PR-1552,5,5,12,6,18
karaf,PR-1557,1,1,1,1,2
karaf,PR-1558,1,1,1,1,2
karaf,PR-1559,1,1,1,1,2
karaf,PR-1560,1,1,2,2,4
karaf,PR-1561,1,1,1,1,2
karaf,PR-1552,6,5,12,6,18
karaf,PR-1562,1,1,1,1,2
karaf,PR-1563,1,1,1,1,2
karaf,PR-1564,1,1,2,2,4
karaf,PR-1565,1,1,1,1,2
karaf,PR-1562,2,1,1,1,2
karaf,PR-1563,2,1,1,1,2
karaf,PR-1566,1,1,1,1,2
karaf,PR-1565,2,1,1,1,2
karaf,PR-1567,3,1,1,1,2
karaf,PR-1568,1,1,1,1,2
karaf,PR-1569,1,1,1,1,2
karaf,PR-1570,1,3,3,3,6
karaf,PR-1571,1,1,1,1,2
karaf,PR-1572,2,1,1,1,2
karaf,PR-1571,2,1,1,1,2
karaf,PR-1568,2,1,1,1,2
karaf,PR-1570,2,3,3,3,6
karaf,PR-1573,1,4,4,4,8
karaf,PR-1568,3,1,1,1,2
karaf,PR-1574,1,1,1,1,2
karaf,PR-1575,1,1,1,1,2
karaf,PR-1576,1,1,1,1,2
karaf,PR-1576,2,1,1,1,2
karaf,PR-1577,1,1,1,1,2
karaf,PR-1578,1,1,1,1,2
karaf,PR-1579,1,1,1,1,2
karaf,PR-1580,1,1,1,1,2
karaf,PR-1581,1,1,1,1,2
karaf,PR-1582,1,1,1,1,2
karaf,PR-1583,1,1,1,1,2
karaf,PR-1584,1,1,1,1,2
karaf,PR-1586,1,2,2,2,4
karaf,PR-1578,2,1,1,1,2
karaf,PR-1579,2,1,1,1,2
karaf,PR-1583,2,1,1,1,2
karaf,PR-1579,3,1,1,1,2
karaf,PR-1588,1,2,3,3,6
karaf,PR-1587,2,1,1,1,2
karaf,PR-1589,1,4,13,2,15
karaf,PR-1585,5,1,1,1,2
karaf,PR-1585,6,1,1,1,2
karaf,PR-1590,1,1,2,2,4
karaf,PR-1592,1,3,4,3,7
karaf,PR-1593,1,1,1,1,2
karaf,PR-1594,1,1,1,1,2
karaf,PR-1596,1,2,2,2,4
karaf,PR-1595,2,1,1,1,2
karaf,PR-1597,1,1,1,1,2
karaf,PR-1598,1,1,1,1,2
karaf,PR-1595,3,1,1,1,2
karaf,PR-1599,1,1,1,1,2
karaf,PR-1599,2,1,1,0,1
karaf,PR-1600,1,1,1,1,2
karaf,PR-1601,1,1,1,1,2
karaf,PR-1602,1,1,1,1,2
karaf,PR-1602,2,1,1,1,2
karaf,PR-1604,1,1,18,1,19
karaf,PR-1605,1,1,1,1,2
karaf,PR-1606,1,1,1,1,2
karaf,PR-1607,1,3,6,6,12
karaf,PR-1607,2,3,6,15,21
karaf,PR-1608,1,1,1,1,2
karaf,PR-1609,1,1,10,3,13
karaf,PR-1610,1,1,1,1,2
karaf,PR-1611,1,1,1,1,2
karaf,PR-1612,1,1,1,1,2
karaf,PR-1613,1,1,2,2,4
karaf,PR-1614,1,1,1,1,2
karaf,PR-1615,1,1,1,1,2
karaf,PR-1616,1,1,1,1,2
karaf,PR-1618,1,1,1,1,2
karaf,PR-1619,1,1,1,1,2
karaf,PR-1620,2,1,4,0,4
karaf,PR-1621,1,8,499,9,508
karaf,PR-1622,1,1,1,0,1
karaf,PR-1623,1,1,50,1,51
karaf,PR-1623,2,1,55,1,56
karaf,PR-1623,3,2,66,1,67
karaf,PR-1623,4,2,76,1,77
karaf,PR-1624,2,3,124,0,124
karaf,PR-1624,3,3,136,0,136
karaf,PR-1625,1,2,17,2,19
karaf,PR-1625,2,2,17,2,19
karaf,PR-1627,2,6,128,41,169
karaf,PR-1627,3,6,127,41,168
karaf,PR-1627,4,8,134,43,177
karaf,PR-1627,5,8,141,43,184
karaf,PR-1627,6,8,141,43,184
karaf,PR-1626,2,5,240,8,248
karaf,PR-1626,3,5,240,8,248
karaf,PR-1628,2,1,3,1,4
karaf,PR-1628,3,1,6,1,7
karaf,PR-1629,2,8,175,23,198
karaf,PR-1630,1,3,43,3,46
karaf,PR-1631,1,23,1471,49,1520
karaf,PR-1632,1,1,8,0,8
karaf,PR-1633,1,6,109,29,138
karaf,PR-1634,1,1,1,1,2
karaf,PR-1635,1,1,1,1,2
karaf,PR-1634,2,1,1,1,2
karaf,PR-1636,1,1,1,1,2
karaf,PR-1637,1,1,1,1,2
karaf,PR-1638,1,2,6,1,7
karaf,PR-1639,1,1,1,1,2
karaf,PR-1640,1,1,1,1,2
karaf,PR-1639,2,1,1,1,2
karaf,PR-1641,1,1,1,1,2
karaf,PR-1642,1,3,123,41,164
karaf,PR-1641,2,1,1,1,2
karaf,PR-1643,1,3,3,3,6
karaf,PR-1644,1,1,1,1,2
karaf,PR-1645,1,2,2,2,4
karaf,PR-1643,2,3,3,3,6
karaf,PR-1647,1,2,2,2,4
karaf,PR-1648,1,1,1,0,1
karaf,PR-1641,3,2,14,52,66
karaf,PR-1643,3,3,3,3,6
karaf,PR-1648,2,2,2,1,3
karaf,PR-1649,1,5,111,13,124
karaf,PR-1649,2,6,117,13,130
karaf,PR-1648,3,3,3,1,4
karaf,PR-1648,4,4,4,2,6
karaf,PR-1648,5,5,5,3,8
karaf,PR-1641,4,2,14,52,66
karaf,PR-1643,4,3,3,3,6
karaf,PR-1650,1,1,1,1,2
karaf,PR-1651,1,1,1,1,2
karaf,PR-1652,1,1,1,1,2
karaf,PR-1653,1,1,1,1,2
karaf,PR-1654,1,1,1,1,2
karaf,PR-1655,1,1,1,1,2
karaf,PR-1656,1,4,27,1,28
karaf,PR-1643,5,7,19,9,28
karaf,PR-1645,2,23,2,1303,1305
karaf,PR-1657,1,1,7,0,7
karaf,PR-1649,3,6,117,13,130
karaf,PR-1654,2,1,1,1,2
karaf,PR-1658,1,2,8,1,9
karaf,PR-1656,2,4,27,1,28
karaf,PR-1659,1,1,1,1,2
karaf,PR-1660,1,1,1,1,2
karaf,PR-1661,1,1,1,1,2
karaf,PR-1641,5,2,14,52,66
karaf,PR-1656,3,5,28,1,29
karaf,PR-1626,5,3,132,9,141
karaf,PR-1626,6,4,132,10,142
karaf,PR-1662,1,4,223,43,266
karaf,PR-1662,2,4,221,43,264
karaf,PR-1662,3,13,539,43,582
karaf,PR-1662,4,13,535,43,578
karaf,PR-1645,4,23,2,1303,1305
karaf,PR-1663,1,3,6,1,7
karaf,PR-1664,1,1,1,1,2
karaf,PR-1666,1,1,1,2,3
karaf,PR-1665,2,1,1,1,2
karaf,PR-1667,1,1,1,1,2
karaf,PR-1668,1,1,1,1,2
karaf,PR-1669,1,1,2,2,4
karaf,PR-1670,1,1,1,1,2
karaf,PR-1671,1,1,1,1,2
karaf,PR-1672,1,1,1,1,2
karaf,PR-1673,1,1,1,1,2
karaf,PR-1674,1,1,2,2,4
karaf,PR-1675,1,1,1,1,2
karaf,PR-1676,1,1,1,1,2
karaf,PR-1676,2,1,1,1,2
karaf,PR-1678,1,1,1,2,3
karaf,PR-1679,1,4,16,16,32
karaf,PR-1680,1,2,48,35,83
karaf,PR-1680,2,2,64,35,99
karaf,PR-1680,3,2,48,35,83
karaf,PR-1677,2,38,1988,3,1991
karaf,PR-1677,3,38,1988,3,1991
karaf,PR-1677,4,38,1982,3,1985
karaf,PR-1683,1,2,2,2,4
karaf,PR-1684,1,1,1,1,2
karaf,PR-1685,1,1,1,1,2
karaf,PR-1686,1,1,1,1,2
karaf,PR-1687,1,1,1,1,2
karaf,PR-1688,1,1,1,1,2
karaf,PR-1689,1,1,1,1,2
karaf,PR-1691,1,1,1,1,2
karaf,PR-1693,1,1,1,1,2
karaf,PR-1694,1,1,1,1,2
karaf,PR-1695,1,1,1,1,2
karaf,PR-1696,1,1,1,1,2
karaf,PR-1694,3,3,10,61,71
karaf,PR-1697,1,2,2,2,4
karaf,PR-1698,1,2,7,2,9
karaf,PR-1698,2,2,7,2,9
karaf,PR-1699,1,1,1,1,2
karaf,PR-1700,1,1,59,0,59
karaf,PR-1701,1,4,6,6,12
karaf,PR-1702,1,1,1,1,2
karaf,PR-1703,1,2,3,3,6
karaf,PR-1704,1,1,6,10,16
karaf,PR-1705,1,1,1,1,2
karaf,PR-1706,1,3,3,1,4
karaf,PR-1707,1,2,2,2,4
karaf,PR-1708,1,4,7,7,14
karaf,PR-1709,1,1,1,1,2
karaf,PR-1710,1,7,34,8,42
karaf,PR-1711,1,2,36,31,67
karaf,PR-1712,1,12,370,22,392
karaf,PR-1713,1,2,28,6,34
karaf,PR-1714,1,2,3,3,6
karaf,PR-1715,1,1,1,1,2
karaf,PR-1716,1,1,28,16,44
karaf,PR-1715,2,1,1,1,2
karaf,PR-1715,3,1,1,1,2
karaf,PR-1717,1,1,3,1,4
karaf,PR-1718,1,1,1,1,2
karaf,PR-1719,1,1,1,1,2
karaf,PR-1720,1,1,1,3,4
karaf,PR-1721,1,1,1,1,2
karaf,PR-1721,2,1,1,1,2
karaf,PR-1722,1,1,1,1,2
karaf,PR-1723,1,3,44,2,46
karaf,PR-1723,2,3,51,2,53
karaf,PR-1724,1,1,79,14,93
karaf,PR-1725,1,4,90,3,93
karaf,PR-1725,2,4,90,3,93
karaf,PR-1726,1,7,15,15,30
karaf,PR-1727,1,1,1,1,2
karaf,PR-1729,1,1,1,1,2
karaf,PR-1730,1,1,1,1,2
karaf,PR-1731,1,1,1,1,2
karaf,PR-1732,1,1,2,2,4
karaf,PR-1733,1,1,1,1,2
karaf,PR-1734,1,1,1,1,2
karaf,PR-1735,1,1,1,1,2
karaf,PR-1736,1,1,1,1,2
karaf,PR-1737,1,1,1,1,2
karaf,PR-1738,1,1,1,1,2
karaf,PR-1738,2,1,1,1,2
karaf,PR-1731,2,1,1,1,2
karaf,PR-1736,2,1,1,1,2
karaf,PR-1734,2,1,1,1,2
karaf,PR-1737,2,1,1,1,2
karaf,PR-1731,4,1,3,3,6
karaf,PR-1734,3,1,1,1,2
karaf,PR-1738,3,1,1,1,2
karaf,PR-1740,1,1,1,1,2
karaf,PR-1741,1,1,1,1,2
karaf,PR-1742,1,1,1,1,2
karaf,PR-1743,1,1,1,1,2
karaf,PR-1734,4,1,1,1,2
karaf,PR-1728,2,1,1,1,2
karaf,PR-1744,1,1,1,1,2
karaf,PR-1728,3,1,1,1,2
karaf,PR-1734,5,1,1,1,2
karaf,PR-1742,2,1,1,1,2
karaf,PR-1740,2,1,1,1,2
karaf,PR-1746,1,1,1,1,2
log4j,PR-441,2,7,686,543,1229
log4j,PR-442,1,1,1,1,2
log4j,PR-392,9,2,63,3,66
log4j,PR-443,1,3,178,117,295
log4j,PR-444,1,5,78,41,119
log4j,PR-443,3,3,181,118,299
log4j,PR-445,1,1,1,1,2
log4j,PR-446,1,1,1,1,2
log4j,PR-447,1,2,104,0,104
log4j,PR-448,1,1,1,1,2
log4j,PR-450,1,1,7,0,7
log4j,PR-450,2,1,7,0,7
log4j,PR-451,2,2,5,6,11
log4j,PR-452,1,6,270,157,427
log4j,PR-453,1,1,2,4,6
log4j,PR-454,1,6,81,2,83
log4j,PR-455,1,2,69,24,93
log4j,PR-455,2,2,74,24,98
log4j,PR-452,2,6,185,159,344
log4j,PR-452,4,6,184,159,343
log4j,PR-452,7,6,204,159,363
log4j,PR-452,8,6,212,159,371
log4j,PR-457,1,3,142,15,157
log4j,PR-458,1,18,742,269,1011
log4j,PR-392,10,2,66,3,69
log4j,PR-460,1,9,232,112,344
log4j,PR-458,2,18,752,269,1021
log4j,PR-458,3,18,761,269,1030
log4j,PR-458,5,18,768,286,1054
log4j,PR-392,11,2,66,3,69
log4j,PR-462,1,9,244,21,265
log4j,PR-462,3,9,244,21,265
log4j,PR-463,1,13,390,145,535
log4j,PR-463,2,13,390,145,535
log4j,PR-463,4,13,390,145,535
log4j,PR-463,5,14,400,145,545
log4j,PR-463,6,15,429,152,581
log4j,PR-464,1,1,1,1,2
log4j,PR-392,12,2,66,3,69
log4j,PR-465,1,14,15,15,30
log4j,PR-466,1,2,738,726,1464
log4j,PR-466,2,2,741,729,1470
log4j,PR-468,1,300,4275,4248,8523
log4j,PR-469,2,6,62,7,69
log4j,PR-470,1,2,33,3,36
log4j,PR-470,3,3,35,3,38
log4j,PR-471,1,3,63,50,113
log4j,PR-471,2,4,135,76,211
log4j,PR-472,1,1,16,6,22
log4j,PR-473,2,2,21,0,21
log4j,PR-474,1,1,1,1,2
log4j,PR-475,2,18,143,9,152
log4j,PR-475,3,24,355,15,370
log4j,PR-476,1,75,2641,626,3267
log4j,PR-477,1,1,3,3,6
log4j,PR-478,2,3,58,3,61
log4j,PR-475,4,27,366,20,386
log4j,PR-479,1,11,260,13,273
log4j,PR-481,1,1,16,15,31
log4j,PR-476,2,75,2643,627,3270
log4j,PR-484,2,8,73,36,109
log4j,PR-484,4,8,82,37,119
log4j,PR-486,1,2,4,1,5
log4j,PR-488,1,5,193,9,202
log4j,PR-489,1,3,49,2,51
log4j,PR-490,1,17,744,126,870
log4j,PR-489,2,4,57,4,61
log4j,PR-489,4,3,76,2,78
log4j,PR-493,1,1,1,1,2
log4j,PR-495,1,10,722,157,879
log4j,PR-507,1,3,14,0,14
log4j,PR-511,3,4,20,22,42
log4j,PR-528,1,3,33,7,40
log4j,PR-528,2,3,33,12,45
log4j,PR-542,2,3,62,2,64
log4j,PR-543,1,4,152,0,152
log4j,PR-542,3,3,62,2,64
log4j,PR-544,1,2,81,1,82
log4j,PR-543,2,4,152,0,152
log4j,PR-544,2,3,120,2,122
log4j,PR-547,4,2,10,0,10
log4j,PR-551,2,4,292,0,292
log4j,PR-543,7,4,272,0,272
log4j,PR-553,2,8,258,7,265
log4j,PR-555,1,2,128,44,172
log4j,PR-553,3,8,257,30,287
log4j,PR-555,2,2,129,44,173
log4j,PR-566,1,7,47,61,108
log4j,PR-568,1,2,18,40,58
log4j,PR-568,2,2,18,42,60
log4j,PR-567,7,3,8,1,9
log4j,PR-568,3,3,22,42,64
log4j,PR-570,1,2,10,2,12
log4j,PR-572,1,2,15,1,16
log4j,PR-572,2,3,19,1,20
log4j,PR-573,2,2,62,33,95
log4j,PR-574,1,36,2837,1,2838
log4j,PR-576,1,1,6,9,15
log4j,PR-577,1,2,6,2,8
log4j,PR-580,1,1,11,16,27
log4j,PR-579,2,1,13,11,24
log4j,PR-573,8,12,536,175,711
log4j,PR-573,9,13,537,176,713
log4j,PR-585,1,1,68,39,107
log4j,PR-585,2,1,68,39,107
log4j,PR-573,11,14,540,176,716
log4j,PR-588,1,2,56,11,67
log4j,PR-589,1,3,21,12,33
log4j,PR-590,1,2,4,0,4
log4j,PR-589,2,4,24,12,36
log4j,PR-589,4,3,24,4,28
log4j,PR-591,1,9,413,609,1022
log4j,PR-591,2,9,413,609,1022
log4j,PR-593,1,2,9,2,11
log4j,PR-594,1,34,37,14,51
log4j,PR-593,5,5,146,2,148
log4j,PR-593,6,5,144,2,146
log4j,PR-597,1,2,52,32,84
log4j,PR-593,7,5,144,2,146
log4j,PR-574,3,36,2836,1,2837
log4j,PR-574,4,36,2836,2,2838
log4j,PR-602,1,1,2,4,6
log4j,PR-601,3,2,15,6,21
log4j,PR-601,4,4,83,12,95
log4j,PR-608,1,9,354,8,362
log4j,PR-607,2,11,84,54,138
log4j,PR-608,2,8,379,8,387
log4j,PR-608,3,8,392,8,400
log4j,PR-598,4,6,200,2,202
log4j,PR-617,1,2,21,1,22
log4j,PR-623,4,6,21,61,82
log4j,PR-625,1,1,1,1,2
log4j,PR-644,5,2,50,4,54
log4j,PR-646,3,2,8,9,17
log4j,PR-647,2,13,203,16,219
log4j,PR-647,3,13,204,17,221
log4j,PR-650,1,1,7,3,10
log4j,PR-646,5,3,9,10,19
log4j,PR-652,2,4,0,12,12
log4j,PR-651,6,2,5,11,16
log4j,PR-655,1,3,16,0,16
log4j,PR-656,1,1,3,66,69
log4j,PR-657,1,1,241,0,241
log4j,PR-644,6,2,45,4,49
log4j,PR-659,1,3,52,12,64
log4j,PR-644,7,2,63,4,67
log4j,PR-657,2,1,241,0,241
log4j,PR-605,3,1,1,1,2
log4j,PR-415,3,1,1,1,2
log4j,PR-374,7,3,3,3,6
log4j,PR-661,1,2,2,2,4
log4j,PR-610,3,1,1,1,2
log4j,PR-662,1,1,1,1,2
log4j,PR-663,1,1,1,1,2
log4j,PR-666,1,1,1,1,2
log4j,PR-667,1,1,2,1,3
log4j,PR-653,6,11,796,0,796
log4j,PR-671,1,4,11,5,16
log4j,PR-653,8,11,942,0,942
log4j,PR-672,1,1,1,0,1
log4j,PR-671,2,4,11,5,16
log4j,PR-676,1,1,1,1,2
log4j,PR-675,3,3,153,1,154
log4j,PR-653,11,11,986,0,986
log4j,PR-679,1,1,0,246,246
log4j,PR-680,1,1,1,1,2
log4j,PR-681,1,1,1,1,2
log4j,PR-680,2,1,1,1,2
log4j,PR-682,1,2,95,2,97
log4j,PR-683,1,7,236,94,330
log4j,PR-684,1,1,4,0,4
log4j,PR-682,2,7,213,5,218
log4j,PR-653,12,11,961,0,961
log4j,PR-685,1,1,2,2,4
log4j,PR-686,1,3,5,2,7
log4j,PR-682,3,7,212,5,217
log4j,PR-687,1,1,1,1,2
log4j,PR-683,2,7,236,94,330
log4j,PR-675,4,3,153,1,154
log4j,PR-688,1,1,24,4,28
log4j,PR-653,13,11,962,0,962
log4j,PR-686,2,3,5,2,7
log4j,PR-689,1,1,1,0,1
log4j,PR-680,3,1,1,1,2
log4j,PR-653,14,11,962,0,962
log4j,PR-653,15,11,962,0,962
log4j,PR-690,1,1,10,9,19
log4j,PR-690,2,1,10,9,19
log4j,PR-683,3,7,236,94,330
log4j,PR-683,4,8,250,95,345
log4j,PR-680,4,3,46,1,47
log4j,PR-691,1,3,3,3,6
log4j,PR-693,1,1,1,1,2
log4j,PR-694,1,1,1,1,2
log4j,PR-696,1,2,96,2,98
log4j,PR-698,3,3,90,8,98
log4j,PR-699,1,1,1,1,2
log4j,PR-700,1,1,4,1,5
log4j,PR-701,1,1,14,1,15
log4j,PR-702,1,1,1,0,1
log4j,PR-698,5,3,96,8,104
log4j,PR-698,6,3,96,8,104
log4j,PR-703,1,1,9,1,10
log4j,PR-704,2,39,902,269,1171
log4j,PR-704,3,39,910,269,1179
log4j,PR-704,4,30,779,209,988
log4j,PR-704,6,35,809,218,1027
log4j,PR-707,1,11,40,12,52
log4j,PR-709,1,2,13,9,22
log4j,PR-710,1,2,6,5,11
log4j,PR-711,1,1,2,5,7
log4j,PR-708,2,7,33,6,39
log4j,PR-712,1,1,22,0,22
log4j,PR-694,2,1,1,1,2
log4j,PR-713,1,3,47,4,51
log4j,PR-714,3,3,9,9,18
log4j,PR-715,1,1,2,1,3
log4j,PR-717,1,3,10,45,55
log4j,PR-713,2,3,47,4,51
log4j,PR-712,2,1,22,0,22
log4j,PR-718,1,1,1,1,2
log4j,PR-717,3,3,19,49,68
log4j,PR-719,1,1,1,1,2
log4j,PR-707,2,18,230,31,261
log4j,PR-707,3,17,228,31,259
log4j,PR-711,2,8,162,31,193
log4j,PR-709,2,9,170,32,202
log4j,PR-708,3,19,398,69,467
log4j,PR-710,2,11,329,135,464
log4j,PR-720,1,2,45,13,58
log4j,PR-721,1,2,30,19,49
log4j,PR-709,3,8,168,32,200
log4j,PR-722,3,8,150,10,160
log4j,PR-723,2,2,12,0,12
log4j,PR-724,1,2,2,2,4
log4j,PR-707,5,17,227,32,259
log4j,PR-709,4,8,165,29,194
log4j,PR-708,5,18,380,52,432
log4j,PR-683,5,8,250,95,345
log4j,PR-683,6,8,216,79,295
log4j,PR-708,6,17,302,48,350
log4j,PR-723,3,2,12,0,12
log4j,PR-709,5,7,86,23,109
log4j,PR-722,5,8,211,13,224
log4j,PR-723,4,2,12,0,12
log4j,PR-711,3,6,70,10,80
log4j,PR-710,3,10,235,108,343
log4j,PR-708,7,17,302,48,350
log4j,PR-709,6,7,84,23,107
log4j,PR-711,5,6,45,10,55
log4j,PR-710,4,10,228,94,322
log4j,PR-708,9,17,371,41,412
log4j,PR-725,1,1,1,1,2
log4j,PR-708,11,17,381,47,428
log4j,PR-726,1,2,39,63,102
log4j,PR-721,2,2,44,25,69
log4j,PR-711,6,6,60,10,70
log4j,PR-726,3,3,49,64,113
log4j,PR-727,1,1,1,1,2
log4j,PR-727,3,1,1,1,2
log4j,PR-728,1,1,1,1,2
log4j,PR-729,1,3,9,3,12
log4j,PR-730,1,2,4,51,55
log4j,PR-731,1,6,251,0,251
log4j,PR-731,3,6,251,0,251
log4j,PR-731,4,6,251,0,251
log4j,PR-732,1,19,400,76,476
log4j,PR-733,1,4,92,7,99
log4j,PR-734,1,1,1,1,2
log4j,PR-733,2,4,95,8,103
tvm,PR-7658,1,2,7,2,9
tvm,PR-7763,4,2,24,11,35
tvm,PR-8830,3,3,26,1,27
tvm,PR-8975,2,1,16,4,20
tvm,PR-8975,3,2,22,6,28
tvm,PR-8975,4,2,22,6,28
tvm,PR-8975,6,2,39,6,45
tvm,PR-8975,7,2,49,6,55
tvm,PR-8975,8,2,44,6,50
tvm,PR-9329,5,10,143,53,196
tvm,PR-9357,7,3,221,0,221
tvm,PR-9628,6,9,706,12,718
tvm,PR-9730,1,33,4350,150,4500
tvm,PR-9730,2,30,4285,140,4425
tvm,PR-9765,1,1,2,2,4
tvm,PR-9767,1,1,10,4,14
tvm,PR-9767,2,2,13,7,20
tvm,PR-9730,3,30,4285,140,4425
tvm,PR-9730,5,30,4285,140,4425
tvm,PR-9730,6,36,4331,141,4472
tvm,PR-9329,7,10,142,53,195
tvm,PR-10008,3,10,106,103,209
tvm,PR-9767,5,2,13,7,20
tvm,PR-9765,4,1,2,2,4
tvm,PR-9329,10,10,142,53,195
tvm,PR-8830,5,3,26,1,27
tvm,PR-9767,6,2,13,7,20
tvm,PR-10008,5,10,106,103,209
tvm,PR-10162,2,2,5,5,10
tvm,PR-10209,2,1,1,0,1
tvm,PR-10250,2,84,7057,0,7057
tvm,PR-10162,4,3,22,24,46
tvm,PR-10162,5,3,23,25,48
tvm,PR-10162,7,3,22,24,46
tvm,PR-10250,3,84,7057,0,7057
tvm,PR-10162,8,3,22,24,46
tvm,PR-10308,3,6,426,32,458
tvm,PR-10325,1,2,158,65,223
tvm,PR-10250,4,84,7057,0,7057
tvm,PR-10250,5,84,7057,0,7057
tvm,PR-10325,2,2,158,65,223
tvm,PR-10308,4,6,426,32,458
tvm,PR-10209,3,1,1,0,1
tvm,PR-10162,9,3,22,24,46
tvm,PR-10008,6,10,106,103,209
tvm,PR-9767,7,2,13,7,20
tvm,PR-9765,5,1,2,2,4
tvm,PR-9329,11,10,142,53,195
tvm,PR-8830,6,3,26,1,27
tvm,PR-10250,6,84,7057,0,7057
tvm,PR-10251,4,14,301,143,444
tvm,PR-10308,5,6,426,32,458
tvm,PR-10446,1,16,363,155,518
tvm,PR-10162,11,3,22,24,46
tvm,PR-10325,5,2,158,65,223
tvm,PR-10474,2,2,36,57,93
tvm,PR-10542,1,1,1,1,2
tvm,PR-10546,2,2,41,5,46
tvm,PR-10516,4,3,8,4,12
tvm,PR-10529,1,1,29,1,30
tvm,PR-10516,5,3,8,4,12
tvm,PR-10529,3,2,37,5,42
tvm,PR-10650,10,21,523,43,566
tvm,PR-10650,11,21,524,44,568
tvm,PR-10650,12,21,524,44,568
tvm,PR-10650,13,21,526,44,570
tvm,PR-10650,14,20,376,44,420
tvm,PR-10250,8,84,7057,0,7057
tvm,PR-10516,7,5,25,9,34
tvm,PR-10758,2,2,6,0,6
tvm,PR-10758,3,3,7,0,7
tvm,PR-10758,4,3,7,0,7
tvm,PR-10529,4,2,37,5,42
tvm,PR-10816,3,19,436,156,592
tvm,PR-10816,4,21,443,160,603
tvm,PR-10529,5,2,37,5,42
tvm,PR-10529,6,2,37,5,42
tvm,PR-10529,7,2,37,5,42
tvm,PR-10758,7,3,7,0,7
tvm,PR-10873,2,10,100,71,171
tvm,PR-10758,8,4,11,5,16
tvm,PR-10873,3,10,129,72,201
tvm,PR-10916,3,6,587,232,819
tvm,PR-10929,4,5,127,2,129
tvm,PR-10929,5,5,127,2,129
tvm,PR-10529,9,2,37,5,42
tvm,PR-10940,2,19,154,290,444
tvm,PR-10963,1,1,2,2,4
tvm,PR-10963,2,1,4,2,6
tvm,PR-10973,1,3,5,3,8
tvm,PR-10989,2,2,9,0,9
tvm,PR-10989,3,2,9,0,9
tvm,PR-10162,12,2,20,23,43
tvm,PR-10940,4,39,323,643,966
tvm,PR-11069,1,1,36,54,90
tvm,PR-11068,1,1,61,49,110
tvm,PR-11070,1,1,36,54,90
tvm,PR-11087,1,9,342,16,358
tvm,PR-11089,1,63,67,67,134
tvm,PR-10529,10,2,37,5,42
tvm,PR-10940,6,39,361,673,1034
tvm,PR-10940,7,40,365,676,1041
tvm,PR-11114,1,1,1,1,2
tvm,PR-11116,1,4,7,7,14
tvm,PR-11089,2,63,67,67,134
tvm,PR-11116,2,4,7,7,14
tvm,PR-11089,4,64,68,67,135
tvm,PR-11155,1,1,44,1,45
tvm,PR-11176,1,1,8,1,9
tvm,PR-11159,3,2,26,1,27
tvm,PR-11116,4,4,18,7,25
tvm,PR-11087,9,11,383,21,404
tvm,PR-11089,5,65,69,68,137
tvm,PR-11089,6,65,69,68,137
tvm,PR-11249,1,2,18,10,28
tvm,PR-11249,2,2,27,10,37
tvm,PR-11249,4,2,27,10,37
tvm,PR-11249,5,2,28,10,38
tvm,PR-11087,21,11,370,23,393
tvm,PR-10940,11,41,379,691,1070
tvm,PR-11358,5,3,296,56,352
tvm,PR-10529,13,2,37,5,42
tvm,PR-10940,12,41,379,691,1070
tvm,PR-10529,14,2,37,5,42
tvm,PR-11390,1,1,4,5,9
tvm,PR-11390,2,1,1,1,2
tvm,PR-11398,1,1,5,0,5
tvm,PR-11398,2,1,5,0,5
tvm,PR-11406,1,1,1,1,2
tvm,PR-10758,14,4,11,5,16
tvm,PR-11408,1,1,1,0,1
tvm,PR-11408,2,2,2,1,3
tvm,PR-11408,3,4,5,4,9
tvm,PR-11408,4,4,5,3,8
tvm,PR-11408,5,5,6,4,10
tvm,PR-11408,6,5,7,4,11
tvm,PR-11408,7,5,7,4,11
tvm,PR-10940,13,41,379,691,1070
tvm,PR-11505,1,1,174,2,176
tvm,PR-11505,2,1,174,2,176
tvm,PR-11505,4,3,235,2,237
tvm,PR-11505,5,3,235,2,237
tvm,PR-11505,6,3,235,2,237
tvm,PR-11564,3,10,264,1,265
tvm,PR-11564,4,10,277,1,278
tvm,PR-11577,2,2,32,0,32
tvm,PR-11579,1,1,30,0,30
tvm,PR-11599,2,1,11,2,13
tvm,PR-11599,3,1,11,2,13
tvm,PR-11602,1,1,6,3,9
tvm,PR-11602,2,1,7,4,11
tvm,PR-11620,1,1,4,1,5
tvm,PR-11699,1,2,20,0,20
tvm,PR-11599,15,1,49,11,60
tvm,PR-11599,16,1,49,11,60
tvm,PR-11779,1,1,8,0,8
tvm,PR-11599,17,1,49,11,60
tvm,PR-11793,2,6,488,0,488
tvm,PR-11816,1,1,23,35,58
tvm,PR-11817,1,1,23,35,58
tvm,PR-11793,4,3,418,0,418
tvm,PR-11793,5,4,438,1,439
tvm,PR-11599,18,1,48,11,59
tvm,PR-11893,1,4,44,19,63
tvm,PR-11793,7,6,450,3,453
tvm,PR-11793,14,6,519,9,528
tvm,PR-11793,15,6,521,11,532
tvm,PR-11793,16,6,521,11,532
tvm,PR-11910,3,1,1,2,3
tvm,PR-11910,4,1,1,2,3
tvm,PR-11986,1,1,4,6,10
tvm,PR-11986,2,1,4,6,10
tvm,PR-11995,1,2,16,16,32
tvm,PR-11986,3,1,4,6,10
tvm,PR-11995,2,2,16,16,32
tvm,PR-11995,3,2,16,16,32
tvm,PR-11793,17,6,523,11,534
tvm,PR-11793,20,6,524,11,535
tvm,PR-11995,4,2,16,16,32
tvm,PR-11793,22,6,526,11,537
tvm,PR-11793,23,6,530,11,541
tvm,PR-11995,5,2,16,16,32
tvm,PR-11793,35,7,833,25,858
tvm,PR-11793,38,7,951,25,976
tvm,PR-12024,1,1,71,49,120
tvm,PR-12025,1,1,71,49,120
tvm,PR-11995,6,2,16,16,32
tvm,PR-12028,8,7,300,207,507
tvm,PR-12028,11,7,303,210,513
tvm,PR-12028,12,7,316,209,525
tvm,PR-12027,4,2,72,0,72
tvm,PR-11793,39,6,945,11,956
tvm,PR-11995,7,2,16,16,32
tvm,PR-12042,1,4,18,13,31
tvm,PR-12045,1,4,5,20,25
tvm,PR-11995,8,2,16,16,32
tvm,PR-11995,9,2,16,16,32
tvm,PR-11995,10,2,16,16,32
tvm,PR-11793,40,6,702,11,713
tvm,PR-11995,11,2,16,16,32
tvm,PR-12063,2,20,709,552,1261
tvm,PR-12063,4,20,708,551,1259
tvm,PR-12063,5,20,708,551,1259
tvm,PR-11995,12,2,16,16,32
tvm,PR-11966,4,7,202,32,234
tvm,PR-11966,5,7,202,32,234
tvm,PR-11966,6,7,202,32,234
tvm,PR-12028,24,12,476,371,847
tvm,PR-12084,3,6,114,36,150
tvm,PR-11995,13,2,16,16,32
tvm,PR-11995,14,2,16,16,32
tvm,PR-12066,6,33,751,332,1083
tvm,PR-11966,7,7,202,32,234
tvm,PR-12087,6,33,2384,5,2389
tvm,PR-12087,7,35,2386,5,2391
tvm,PR-11995,15,2,16,16,32
tvm,PR-11995,16,2,16,16,32
tvm,PR-11995,17,2,16,16,32
tvm,PR-11995,18,2,16,16,32
tvm,PR-12087,9,38,2392,8,2400
tvm,PR-12063,6,20,712,551,1263
tvm,PR-12063,7,21,705,551,1256
tvm,PR-12066,7,33,750,332,1082
tvm,PR-12124,1,11,279,16,295
tvm,PR-11995,19,2,16,16,32
tvm,PR-12127,1,2,120,25,145
tvm,PR-11966,8,7,201,32,233
tvm,PR-12125,4,11,514,55,569
tvm,PR-12124,2,11,280,16,296
tvm,PR-12066,9,37,777,350,1127
tvm,PR-12125,5,11,514,55,569
tvm,PR-12134,1,2,34,2,36
tvm,PR-12027,6,2,72,0,72
tvm,PR-11809,6,3,2,15,17
tvm,PR-12125,6,11,514,55,569
tvm,PR-12140,2,17,1003,880,1883
tvm,PR-12124,3,11,280,16,296
tvm,PR-11995,20,2,16,16,32
tvm,PR-12125,8,11,516,57,573
tvm,PR-12125,9,11,516,57,573
tvm,PR-11599,22,1,40,11,51
tvm,PR-11599,23,1,48,11,59
tvm,PR-11995,21,2,16,16,32
tvm,PR-11599,26,1,53,11,64
tvm,PR-11995,22,2,16,16,32
tvm,PR-12144,5,1,115,89,204
tvm,PR-11995,23,2,16,16,32
tvm,PR-11995,24,2,16,16,32
tvm,PR-11995,25,2,16,16,32
tvm,PR-12063,8,21,704,551,1255
tvm,PR-12125,11,11,508,57,565
tvm,PR-12178,1,11,313,11,324
tvm,PR-12125,14,12,551,57,608
tvm,PR-12028,29,12,792,694,1486
tvm,PR-12125,15,12,507,58,565
tvm,PR-12125,16,12,507,58,565
tvm,PR-12127,2,2,120,25,145
tvm,PR-12193,3,1,57,0,57
tvm,PR-12124,5,11,280,18,298
tvm,PR-11995,27,2,16,16,32
tvm,PR-12124,7,12,288,45,333
tvm,PR-12125,20,13,549,59,608
tvm,PR-12087,10,39,2563,5,2568
tvm,PR-12193,4,1,57,0,57
tvm,PR-12087,11,39,2564,5,2569
tvm,PR-12125,22,13,559,60,619
tvm,PR-12207,2,14,216,214,430
tvm,PR-11995,28,2,16,16,32
tvm,PR-12028,39,12,925,802,1727
tvm,PR-12087,12,39,2524,5,2529
tvm,PR-12066,19,35,1052,350,1402
tvm,PR-12028,42,12,1465,1144,2609
tvm,PR-12207,3,14,216,214,430
tvm,PR-12125,25,13,570,60,630
tvm,PR-12125,27,13,570,60,630
tvm,PR-12223,3,4,29,4,33
tvm,PR-11995,29,2,16,16,32
tvm,PR-12028,44,12,1856,1265,3121
tvm,PR-12028,54,15,1956,1379,3335
tvm,PR-12231,6,6,79,3,82
tvm,PR-11966,9,7,201,32,233
tvm,PR-12236,3,2,16,3,19
tvm,PR-12231,9,6,79,3,82
tvm,PR-12207,9,14,184,195,379
tvm,PR-11995,30,2,16,16,32
tvm,PR-12127,3,2,144,27,171
tvm,PR-12127,4,2,149,27,176
tvm,PR-12243,1,2,205,0,205
tvm,PR-11995,31,2,16,16,32
tvm,PR-12245,1,5,19,17,36
tvm,PR-11995,32,2,16,16,32
tvm,PR-12242,2,1,2,2,4
tvm,PR-11966,10,7,201,32,233
tvm,PR-12087,13,39,2524,5,2529
tvm,PR-12252,2,3,267,1,268
tvm,PR-12254,1,10,106,103,209
tvm,PR-12253,2,2,37,10,47
tvm,PR-12259,1,2,80,11,91
tvm,PR-12207,10,14,187,195,382
tvm,PR-12253,4,3,53,10,63
tvm,PR-12207,11,16,221,225,446
tvm,PR-12231,11,9,148,3,151
tvm,PR-12263,3,7,117,25,142
tvm,PR-12207,12,16,221,225,446
tvm,PR-12127,5,2,149,27,176
tvm,PR-12263,4,7,84,31,115
tvm,PR-11995,33,2,16,16,32
tvm,PR-12231,12,9,148,3,151
tvm,PR-12087,14,38,2392,8,2400
tvm,PR-12231,13,9,148,3,151
tvm,PR-12087,17,40,2544,5,2549
tvm,PR-12087,18,40,2544,5,2549
tvm,PR-11893,3,6,58,49,107
tvm,PR-12127,14,3,277,4,281
tvm,PR-11893,4,5,57,49,106
tvm,PR-11995,34,2,16,16,32
tvm,PR-11966,11,7,201,32,233
tvm,PR-12028,60,101,5740,1946,7686
tvm,PR-12283,1,13,572,64,636
tvm,PR-12254,2,10,106,103,209
tvm,PR-12284,1,10,278,15,293
tvm,PR-12028,61,15,1965,1380,3345
tvm,PR-12283,2,13,557,59,616
tvm,PR-12028,62,101,5740,1947,7687
tvm,PR-12286,2,11,320,59,379
tvm,PR-11966,12,7,201,32,233
tvm,PR-12028,64,15,1968,1381,3349
tvm,PR-12290,1,1,1,1,2
tvm,PR-12287,2,7,77,21,98
tvm,PR-12294,1,6,1101,0,1101
tvm,PR-12283,7,13,591,64,655
tvm,PR-12295,1,3,81,27,108
tvm,PR-12125,40,13,558,58,616
tvm,PR-11995,35,2,16,16,32
tvm,PR-12125,42,13,596,63,659
tvm,PR-11995,36,2,16,16,32
tvm,PR-12314,3,1,41,7,48
tvm,PR-12315,1,2,57,7,64
tvm,PR-12320,1,18,641,181,822
tvm,PR-12321,3,3,43,0,43
tvm,PR-12319,2,10,546,3,549
tvm,PR-12323,1,1,1,1,2
tvm,PR-12322,2,14,552,57,609
tvm,PR-12284,5,12,377,23,400
tvm,PR-11793,52,12,805,27,832
tvm,PR-11793,53,12,806,27,833
tvm,PR-11793,54,12,811,27,838
tvm,PR-12315,2,2,61,7,68
tvm,PR-12323,2,2,6,7,13
tvm,PR-11793,55,12,811,27,838
tvm,PR-12323,6,2,11,6,17
tvm,PR-12178,12,15,366,14,380
tvm,PR-11793,56,12,811,27,838
tvm,PR-11793,57,12,811,27,838
tvm,PR-11793,58,12,811,27,838
tvm,PR-12342,4,6,162,37,199
tvm,PR-12134,2,2,42,5,47
tvm,PR-12347,1,15,42,211,253
tvm,PR-12347,3,15,43,218,261
tvm,PR-12134,3,2,42,5,47
tvm,PR-12352,2,7,226,4,230
tvm,PR-12227,2,3,4,4,8
tvm,PR-12358,2,27,1632,56,1688
tvm,PR-12363,1,2,43,0,43
tvm,PR-12134,4,2,35,5,40
tvm,PR-12364,1,1,2,1,3
tvm,PR-12369,1,2,19,17,36
tvm,PR-12028,68,15,1969,1398,3367
tvm,PR-12376,1,1,1,1,2
tvm,PR-12389,4,1,43,2,45
tvm,PR-12369,4,3,22,19,41
tvm,PR-12391,1,5,709,970,1679
tvm,PR-12395,1,2,11,2,13
tvm,PR-12125,54,13,589,62,651
tvm,PR-12398,1,19,1445,40,1485
tvm,PR-12399,1,1,10,2,12
tvm,PR-12125,56,13,589,62,651
tvm,PR-12403,1,7,436,16,452
tvm,PR-12309,10,5,503,52,555
tvm,PR-12401,2,1,5,2,7
tvm,PR-12407,2,3,53,4,57
tvm,PR-12336,13,5,616,0,616
tvm,PR-12408,2,4,38,15,53
tvm,PR-12411,1,5,312,44,356
tvm,PR-12125,57,13,590,62,652
tvm,PR-12414,1,5,97,4,101
tvm,PR-12412,2,21,446,351,797
tvm,PR-12412,5,31,707,584,1291
tvm,PR-12421,1,1,1,1,2
tvm,PR-12421,2,2,4,2,6
tvm,PR-12125,60,13,590,62,652
tvm,PR-12125,62,13,590,62,652
tvm,PR-12428,3,2,95,0,95
tvm,PR-12412,6,31,725,592,1317
tvm,PR-12416,9,12,30,195,225
tvm,PR-12412,7,31,726,592,1318
tvm,PR-12411,3,5,313,44,357
tvm,PR-12416,11,18,37,218,255
tvm,PR-12412,9,31,749,592,1341
tvm,PR-12416,12,18,37,222,259
tvm,PR-12441,6,7,331,50,381
tvm,PR-12412,11,31,799,592,1391
tvm,PR-12447,1,5,98,31,129
tvm,PR-12454,1,3,448,0,448
tvm,PR-12455,1,9,474,82,556
tvm,PR-12456,1,1,2,2,4
tvm,PR-12455,2,9,482,86,568
tvm,PR-12403,2,8,579,17,596
tvm,PR-12447,2,5,96,30,126
tvm,PR-12454,2,3,448,0,448
tvm,PR-12455,3,10,487,86,573
tvm,PR-12441,7,7,331,50,381
tvm,PR-12403,3,8,581,17,598
tvm,PR-12397,4,2,7,1,8
tvm,PR-12454,3,3,448,0,448
tvm,PR-12411,4,5,278,44,322
tvm,PR-12455,4,10,489,88,577
tvm,PR-12406,3,5,565,25,590
tvm,PR-12460,1,1,1,34,35
tvm,PR-12390,4,3,41,2,43
tvm,PR-12460,2,2,2,35,37
tvm,PR-12411,6,5,309,44,353
tvm,PR-12460,4,2,5,35,40
tvm,PR-12462,2,11,327,3,330
tvm,PR-12463,2,2,44,1,45
tvm,PR-12200,8,2,22,1,23
tvm,PR-12416,17,25,80,261,341
tvm,PR-12450,4,9,289,46,335
tvm,PR-12471,1,2,6,4,10
tvm,PR-12474,1,2,8,6,14
tvm,PR-12474,2,3,24,22,46
tvm,PR-12390,8,3,46,2,48
tvm,PR-12479,1,1,15,5,20
tvm,PR-12474,4,5,32,27,59
tvm,PR-11070,4,1,36,54,90
tvm,PR-11069,4,1,36,54,90
tvm,PR-12473,2,2,1226,850,2076
tvm,PR-12361,6,3,10,4,14
tvm,PR-12482,4,6,678,0,678
tvm,PR-12483,1,1,1,0,1
tvm,PR-12488,1,5,266,0,266
tvm,PR-12489,2,19,246,127,373
tvm,PR-12490,1,1,1,0,1
tvm,PR-12406,4,5,565,25,590
tvm,PR-12492,2,22,958,64,1022
tvm,PR-12490,3,3,6,1,7
tvm,PR-12493,4,1,544,0,544
tvm,PR-11995,37,2,18,18,36
tvm,PR-12411,11,6,328,46,374
tvm,PR-12496,1,19,27,9,36
tvm,PR-12496,2,19,69,60,129
tvm,PR-12497,4,2,76,1,77
tvm,PR-12490,5,7,94,158,252
tvm,PR-12490,6,8,95,159,254
tvm,PR-12389,5,2,117,3,120
tvm,PR-11793,59,12,811,27,838
tvm,PR-12502,3,2,6,3,9
tvm,PR-12505,3,10,126,30,156
tvm,PR-12492,4,22,986,64,1050
tvm,PR-12507,4,6,116,55,171
tvm,PR-12505,4,10,124,30,154
tvm,PR-11995,38,2,20,20,40
tvm,PR-12414,4,5,110,4,114
tvm,PR-12505,5,10,127,30,157
tvm,PR-12507,5,6,116,55,171
tvm,PR-12513,2,7,137,75,212
tvm,PR-12497,9,2,76,1,77
tvm,PR-12447,6,5,101,30,131
tvm,PR-12509,3,24,91,80,171
tvm,PR-12515,4,6,249,23,272
tvm,PR-11995,39,2,20,20,40
tvm,PR-12492,5,14,632,62,694
tvm,PR-12447,7,5,101,30,131
tvm,PR-12520,11,24,353,681,1034
tvm,PR-12447,9,5,107,30,137
tvm,PR-11995,40,2,20,20,40
tvm,PR-12515,5,9,255,28,283
tvm,PR-12515,6,9,247,28,275
tvm,PR-12530,1,2,20,4,24
tvm,PR-12531,1,11,923,83,1006
tvm,PR-12526,3,22,1855,6,1861
tvm,PR-12530,3,3,24,21,45
tvm,PR-12539,1,1,1,1,2
tvm,PR-12540,1,2,75,10,85
tvm,PR-12534,3,6,279,1,280
tvm,PR-12490,9,10,103,163,266
tvm,PR-12512,2,4,23,15,38
tvm,PR-12204,5,5,1188,0,1188
tvm,PR-12490,10,10,103,163,266
tvm,PR-12411,12,6,374,49,423
tvm,PR-12390,12,3,48,2,50
tvm,PR-11793,60,12,811,27,838
tvm,PR-12521,3,4,155,56,211
tvm,PR-12545,2,8,238,163,401
tvm,PR-12526,4,23,1860,6,1866
tvm,PR-12490,12,10,111,163,274
tvm,PR-12555,1,1,1,1,2
tvm,PR-12555,2,1,1,1,2
tvm,PR-12490,13,10,112,163,275
tvm,PR-12564,1,2,10,4,14
tvm,PR-12506,7,19,1289,62,1351
tvm,PR-11995,42,2,20,20,40
tvm,PR-12555,3,1,1,1,2
tvm,PR-12552,5,19,2078,62,2140
tvm,PR-12555,4,1,1,1,2
tvm,PR-12555,5,2,2,1,3
tvm,PR-12550,2,9,1516,13,1529
tvm,PR-12490,14,10,112,163,275
tvm,PR-12549,2,22,2636,1411,4047
tvm,PR-12545,4,27,264,187,451
tvm,PR-12549,3,22,2643,1411,4054
tvm,PR-12515,9,10,269,30,299
tvm,PR-12564,6,23,277,271,548
tvm,PR-12552,6,19,2077,62,2139
tvm,PR-12576,1,20,2162,62,2224
tvm,PR-12515,10,12,336,36,372
tvm,PR-12582,2,21,2285,62,2347
tvm,PR-12436,7,3,437,0,437
tvm,PR-12581,2,2,18,6,24
tvm,PR-11995,43,2,20,20,40
tvm,PR-12587,3,10,464,7,471
tvm,PR-12588,1,1,7,7,14
tvm,PR-12389,6,3,118,4,122
tvm,PR-12454,4,3,448,0,448
tvm,PR-12455,5,10,489,88,577
tvm,PR-12594,1,3,27,10,37
tvm,PR-12603,2,21,2489,62,2551
tvm,PR-11995,44,2,20,20,40
tvm,PR-12520,19,26,456,752,1208
tvm,PR-12609,3,35,30,24,54
tvm,PR-11793,61,12,811,27,838
tvm,PR-12526,6,23,1860,6,1866
tvm,PR-12450,8,12,302,93,395
tvm,PR-12614,1,23,1859,6,1865
tvm,PR-12485,16,7,353,3,356
tvm,PR-12485,17,7,353,3,356
tvm,PR-12612,4,6,287,91,378
tvm,PR-12492,6,14,632,62,694
tvm,PR-12506,9,19,1308,62,1370
tvm,PR-12552,7,19,2096,62,2158
tvm,PR-12576,2,20,2181,62,2243
tvm,PR-12582,3,21,2304,62,2366
tvm,PR-12603,3,21,2508,62,2570
tvm,PR-12609,5,36,31,25,56
tvm,PR-11995,45,2,20,20,40
tvm,PR-12622,3,3,15,2,17
tvm,PR-12622,4,3,17,4,21
tvm,PR-12506,10,19,1308,62,1370
tvm,PR-12552,8,19,2096,62,2158
tvm,PR-12582,4,21,2304,62,2366
tvm,PR-12576,3,20,2181,62,2243
tvm,PR-12603,4,21,2508,62,2570
tvm,PR-11995,46,2,20,20,40
tvm,PR-12515,13,13,722,36,758
tvm,PR-11995,47,2,20,20,40
tvm,PR-12515,14,13,732,36,768
tvm,PR-12515,15,13,737,36,773
tvm,PR-12549,4,22,2616,1411,4027
tvm,PR-12603,5,21,2507,62,2569
tvm,PR-12574,11,4,126,27,153
tvm,PR-12574,12,4,126,27,153
tvm,PR-12639,1,1,1,1,2
tvm,PR-12473,5,4,1152,768,1920
tvm,PR-12640,3,4,105,50,155
tvm,PR-11995,48,2,20,20,40
tvm,PR-12644,1,4,137,1,138
tvm,PR-12648,1,2,29,1,30
tvm,PR-12649,1,21,162,84,246
tvm,PR-12654,1,3,434,1,435
tvm,PR-12635,2,21,2752,62,2814
tvm,PR-12655,1,2,107,4,111
tvm,PR-12656,2,4,53,25,78
tvm,PR-12412,14,37,819,605,1424
tvm,PR-12656,3,4,54,25,79
tvm,PR-11995,49,2,20,20,40
tvm,PR-12644,6,4,98,1,99
tvm,PR-12603,6,21,2507,62,2569
tvm,PR-12635,3,21,2752,62,2814
tvm,PR-12656,4,4,55,26,81
tvm,PR-12628,10,10,366,28,394
tvm,PR-12649,2,20,160,84,244
tvm,PR-12485,23,7,366,3,369
tvm,PR-12652,7,3,382,213,595
tvm,PR-12662,2,1,58,1,59
tvm,PR-12647,4,2,17,3,20
tvm,PR-12667,1,5,724,5,729
tvm,PR-11995,50,2,20,20,40
tvm,PR-12485,26,7,410,3,413
tvm,PR-12499,3,5,408,111,519
tvm,PR-12485,27,7,410,3,413
tvm,PR-12550,5,9,1508,13,1521
tvm,PR-12574,13,4,126,27,153
tvm,PR-12574,15,4,141,24,165
tvm,PR-12652,8,4,396,227,623
tvm,PR-11995,51,2,20,20,40
tvm,PR-12361,17,16,624,2105,2729
tvm,PR-12643,2,14,194,18,212
tvm,PR-12643,3,14,198,18,216
tvm,PR-12684,1,2,27,6,33
tvm,PR-12671,3,1,13,8,21
tvm,PR-12667,2,5,723,5,728
tvm,PR-12495,9,3,85,30,115
tvm,PR-12495,10,3,83,30,113
tvm,PR-12695,1,13,739,286,1025
tvm,PR-12671,6,1,16,8,24
tvm,PR-12697,2,1,0,1,1
tvm,PR-11995,53,2,20,20,40
tvm,PR-11995,54,2,20,20,40
tvm,PR-12699,1,2,32,11,43
tvm,PR-12644,12,4,100,1,101
tvm,PR-11995,55,2,20,20,40
tvm,PR-12318,18,4,348,2,350
tvm,PR-12490,26,13,111,167,278
tvm,PR-12692,2,17,197,125,322
tvm,PR-12674,6,9,487,33,520
tvm,PR-12652,9,4,416,231,647
tvm,PR-12644,13,4,100,1,101
tvm,PR-12718,1,1,1,0,1
tvm,PR-12606,10,4,470,27,497
tvm,PR-12718,4,1,1,0,1
tvm,PR-11995,56,2,20,20,40
tvm,PR-12694,6,9,325,0,325
tvm,PR-12711,4,4,87,93,180
tvm,PR-12711,6,4,86,93,179
tvm,PR-12711,7,4,83,96,179
tvm,PR-12711,8,4,81,94,175
tvm,PR-12606,11,8,567,42,609
tvm,PR-12720,4,15,1058,50,1108
tvm,PR-12644,16,4,102,3,105
tvm,PR-12720,5,15,1055,50,1105
tvm,PR-12490,28,14,112,167,279
tvm,PR-12720,6,15,1079,50,1129
tvm,PR-11995,57,2,20,20,40
tvm,PR-12644,17,4,102,3,105
tvm,PR-12731,1,2,2,2,4
tvm,PR-12499,5,5,408,100,508
tvm,PR-12720,7,15,1144,50,1194
tvm,PR-12738,1,3,30,21,51
tvm,PR-12738,2,4,31,22,53
tvm,PR-12644,18,4,112,11,123
tvm,PR-11893,5,5,50,13,63
tvm,PR-12740,2,6,51,13,64
tvm,PR-12644,19,4,112,11,123
tvm,PR-12644,20,4,113,12,125
tvm,PR-12761,3,2,389,1,390
tvm,PR-12761,4,2,389,2,391
tvm,PR-12761,5,2,389,2,391
tvm,PR-12787,1,2,112,78,190
tvm,PR-12787,2,2,112,78,190
tvm,PR-12791,1,2,53,6,59
tvm,PR-12789,7,4,380,57,437
tvm,PR-12787,4,3,114,81,195
tvm,PR-12789,9,4,374,57,431
tvm,PR-12789,12,4,388,56,444
tvm,PR-12846,2,1,3,3,6
tvm,PR-12850,6,6,41,12,53
tvm,PR-12869,1,1,1,0,1
tvm,PR-12846,3,1,3,3,6
tvm,PR-12881,2,1,2,0,2
tvm,PR-12889,1,2,30,6,36
tvm,PR-12850,7,6,41,12,53
tvm,PR-12761,8,3,478,1,479
tvm,PR-12915,2,3,188,13,201
tvm,PR-12915,3,3,188,13,201
tvm,PR-12915,5,3,187,13,200
tvm,PR-12850,9,8,50,14,64
tvm,PR-12873,6,7,698,7,705
tvm,PR-12932,4,8,110,47,157
tvm,PR-12850,12,8,76,14,90
tvm,PR-12932,5,8,104,47,151
tvm,PR-12935,2,7,74,30,104
tvm,PR-12931,3,5,192,1,193
tvm,PR-12842,2,1,1,1,2
tvm,PR-12761,9,3,478,1,479
tvm,PR-12932,6,8,104,47,151
tvm,PR-12941,1,45,185,150,335
tvm,PR-12935,6,8,126,30,156
tvm,PR-12941,2,45,185,150,335
tvm,PR-12932,7,8,104,47,151
tvm,PR-12846,4,1,3,3,6
tvm,PR-12961,2,3,190,2,192
tvm,PR-12932,8,8,104,47,151
tvm,PR-12973,2,5,37,6,43
tvm,PR-12948,7,3,330,6,336
tvm,PR-12973,3,5,41,6,47
tvm,PR-12973,4,5,41,6,47
tvm,PR-12761,10,3,478,1,479
tvm,PR-13022,1,4,136,26,162
tvm,PR-13023,1,4,153,45,198
tvm,PR-13024,2,5,329,70,399
tvm,PR-13024,3,8,346,77,423
tvm,PR-12948,9,4,337,7,344
tvm,PR-13033,4,10,1115,0,1115
tvm,PR-13051,3,11,432,598,1030
tvm,PR-13024,4,8,346,77,423
tvm,PR-13058,3,155,510,459,969
tvm,PR-13051,4,11,430,582,1012
tvm,PR-13041,2,3,363,0,363
tvm,PR-13072,2,7,63,33,96
tvm,PR-13051,5,11,422,574,996
tvm,PR-12846,5,1,3,3,6
tvm,PR-13079,2,9,54,7,61
tvm,PR-13081,1,3,45,1,46
tvm,PR-13041,3,3,363,0,363
tvm,PR-13022,2,4,154,26,180
tvm,PR-13080,2,14,453,36,489
tvm,PR-13081,2,3,45,1,46
tvm,PR-13041,4,3,363,0,363
tvm,PR-13024,5,8,346,77,423
tvm,PR-13080,3,14,453,36,489
tvm,PR-13022,3,4,154,26,180
tvm,PR-13084,1,1,7,5,12
tvm,PR-13086,1,17,201,48,249
tvm,PR-13085,3,3,89,4,93
tvm,PR-13072,4,10,76,40,116
tvm,PR-13072,5,10,74,40,114
tvm,PR-13092,1,15,418,31,449
tvm,PR-13093,1,2,24,1,25
tvm,PR-13095,1,7,561,3,564
tvm,PR-13096,1,1,1,0,1
tvm,PR-13097,1,4,351,175,526
tvm,PR-13100,2,4,215,0,215
tvm,PR-13051,6,11,422,574,996
tvm,PR-13086,2,2,17,1,18
tvm,PR-13093,4,3,37,6,43
tvm,PR-13107,2,2,179,14,193
tvm,PR-13085,5,3,92,5,97
tvm,PR-13109,2,3,43,68,111
tvm,PR-13110,1,1,56,2,58
tvm,PR-13111,1,9,306,38,344
tvm,PR-13112,1,2,34,4,38
tvm,PR-13093,5,3,37,6,43
tvm,PR-12761,11,3,478,1,479
tvm,PR-13115,1,1,2,0,2
tvm,PR-13100,3,4,213,0,213
tvm,PR-12761,12,3,479,1,480
tvm,PR-13033,7,10,1103,0,1103
tvm,PR-13117,1,3,138,0,138
tvm,PR-13117,2,3,138,0,138
tvm,PR-13118,1,1,0,6,6
tvm,PR-13119,1,2,37,5,42
tvm,PR-13117,3,3,137,0,137
tvm,PR-13097,2,5,469,298,767
tvm,PR-13023,2,4,155,45,200
tvm,PR-13120,1,2,20,1,21
tvm,PR-13111,2,9,302,36,338
tvm,PR-13118,2,1,0,6,6
tvm,PR-13123,2,2,27,0,27
tvm,PR-13058,7,154,466,415,881
tvm,PR-13124,3,1,4,0,4
tvm,PR-13121,3,2,82,0,82
tvm,PR-13125,1,4,6,41,47
tvm,PR-13123,3,2,27,0,27
tvm,PR-13109,4,4,35,89,124
tvm,PR-13126,1,1,2,2,4
tvm,PR-13086,6,9,30,14,44
tvm,PR-13085,6,5,181,4,185
tvm,PR-13127,3,2,14,1,15
tvm,PR-13128,1,1,50,4,54
tvm,PR-13129,1,4,285,8,293
tvm,PR-13134,1,1,14,11,25
tvm,PR-13135,1,6,461,1,462
tvm,PR-13100,5,5,136,4,140
tvm,PR-13135,2,7,473,13,486
tvm,PR-13135,3,6,462,1,463
tvm,PR-13136,4,1,14,4,18
tvm,PR-13051,9,11,445,592,1037
tvm,PR-13130,4,22,3652,126,3778
tvm,PR-13136,7,2,36,4,40
tvm,PR-13139,1,3,4,28,32
tvm,PR-13140,1,1,2,0,2
tvm,PR-12971,13,31,1888,11,1899
tvm,PR-13139,2,3,9,36,45
tvm,PR-13084,2,1,2,8,10
tvm,PR-12971,14,31,1888,11,1899
tvm,PR-13110,2,1,60,6,66
tvm,PR-13142,1,3,325,107,432
tvm,PR-13145,1,2,5,15,20
tvm,PR-13108,2,1,0,10,10
tvm,PR-13147,1,2,29,2,31
tvm,PR-13138,3,5,42,0,42
tvm,PR-13149,1,4,26,26,52
tvm,PR-13151,1,2,47,24,71
tvm,PR-12971,16,31,1889,11,1900
tvm,PR-13136,8,2,37,4,41
tvm,PR-13140,2,1,2,0,2
tvm,PR-13153,1,3,216,17,233
tvm,PR-13135,4,6,464,1,465
tvm,PR-13155,1,1,0,1,1
tvm,PR-13051,10,11,446,592,1038
tvm,PR-13100,6,5,144,4,148
tvm,PR-13092,3,16,420,34,454
tvm,PR-13092,4,17,433,52,485
tvm,PR-13158,4,1,5,1,6
tvm,PR-12971,17,31,1889,11,1900
tvm,PR-13145,2,2,6,14,20
tvm,PR-13095,3,7,564,3,567
tvm,PR-13159,1,8,129,173,302
tvm,PR-13160,1,2,2,2,4
tvm,PR-13161,2,15,161,226,387
tvm,PR-13162,2,6,184,37,221
tvm,PR-13163,1,5,33,19,52
tvm,PR-12971,18,31,1892,11,1903
tvm,PR-13108,3,1,0,10,10
tvm,PR-13161,3,16,162,227,389
tvm,PR-13147,2,3,30,5,35
tvm,PR-13163,2,5,33,19,52
tvm,PR-13163,3,5,43,19,62
tvm,PR-13161,4,16,162,227,389
tvm,PR-13092,5,17,439,52,491
tvm,PR-13033,9,10,1219,0,1219
tvm,PR-13153,3,3,217,17,234
tvm,PR-13119,3,2,78,22,100
tvm,PR-13153,4,3,217,17,234
tvm,PR-13165,1,2,2,2,4
tvm,PR-13080,4,15,515,57,572
tvm,PR-12971,19,31,1892,11,1903
tvm,PR-13166,2,8,160,44,204
tvm,PR-13166,3,8,163,44,207
tvm,PR-13163,4,5,43,19,62
tvm,PR-13108,4,1,0,10,10
tvm,PR-13170,1,1,20,15,35
tvm,PR-13171,1,1,1,0,1
tvm,PR-13161,5,16,166,228,394
tvm,PR-13072,7,10,85,40,125
tvm,PR-13172,1,1,1,1,2
tvm,PR-13174,2,4,53,16,69
tvm,PR-13012,14,21,842,92,934
tvm,PR-13161,6,16,167,229,396
tvm,PR-13175,1,12,42,6,48
tvm,PR-13163,5,5,43,19,62
tvm,PR-13176,1,6,203,2,205
tvm,PR-13178,1,7,766,1,767
tvm,PR-13163,6,5,33,19,52
tvm,PR-13080,5,15,515,57,572
tvm,PR-13119,4,2,78,22,100
tvm,PR-13153,5,3,217,17,234
tvm,PR-13177,5,6,42,18,60
tvm,PR-13180,1,1,186,0,186
tvm,PR-13181,1,7,178,37,215
tvm,PR-13177,6,6,42,18,60
tvm,PR-13180,2,1,186,0,186
tvm,PR-13181,2,7,178,37,215
tvm,PR-13161,10,17,156,220,376
tvm,PR-13182,4,4,124,2,126
tvm,PR-13184,2,2,53,31,84
tvm,PR-13161,11,17,182,232,414
tvm,PR-13180,4,1,177,0,177
tvm,PR-13182,7,4,124,2,126
tvm,PR-13181,3,7,178,37,215
tvm,PR-13188,1,11,124,66,190
tvm,PR-13183,4,2,26,4,30
tvm,PR-13183,5,2,26,4,30
tvm,PR-13182,8,4,124,2,126
tvm,PR-13189,1,3,94,38,132
tvm,PR-13190,1,7,766,1,767
tvm,PR-13183,6,2,26,4,30
tvm,PR-13080,6,16,516,58,574
tvm,PR-13194,3,6,257,50,307
tvm,PR-13161,12,17,182,232,414
tvm,PR-12971,20,31,1892,11,1903
tvm,PR-13184,3,2,52,30,82
tvm,PR-13012,15,20,768,92,860
tvm,PR-13181,4,7,166,37,203
tvm,PR-13012,16,20,786,91,877
tvm,PR-13198,1,1,1,1,2
tvm,PR-13199,1,1,23,6,29
tvm,PR-12873,11,7,703,6,709
tvm,PR-13200,1,2,20,20,40
tvm,PR-13189,2,3,41,7,48
tvm,PR-13161,15,17,196,246,442
tvm,PR-13196,3,1,3,1,4
tvm,PR-13197,4,2,82,1,83
tvm,PR-13197,5,2,82,1,83
tvm,PR-13181,5,7,168,38,206
tvm,PR-13110,6,1,424,19,443
tvm,PR-13198,2,2,4,2,6
tvm,PR-13192,6,11,705,0,705
tvm,PR-13195,8,19,969,1373,2342
tvm,PR-13203,1,3,60,27,87
tvm,PR-13165,2,2,2,2,4
tvm,PR-13181,7,7,168,38,206
tvm,PR-13110,7,1,424,19,443
tvm,PR-13110,9,1,427,19,446
tvm,PR-13207,2,1,9,0,9
tvm,PR-13206,4,23,3401,46,3447
tvm,PR-13195,9,19,969,1373,2342
tvm,PR-13206,7,30,3432,46,3478
tvm,PR-13080,7,16,516,58,574
tvm,PR-13212,1,12,344,12,356
tvm,PR-13213,1,2,182,67,249
tvm,PR-13214,1,1,1,0,1
tvm,PR-13216,1,2,58,0,58
tvm,PR-13129,2,4,291,8,299
tvm,PR-13218,1,25,58,60,118
tvm,PR-13219,1,1,3,0,3
tvm,PR-13012,17,20,792,91,883
tvm,PR-13221,3,5,47,99,146
tvm,PR-13199,3,1,25,6,31
tvm,PR-12931,10,8,391,1,392
tvm,PR-13012,18,20,792,91,883
tvm,PR-13072,8,11,123,41,164
tvm,PR-13213,2,2,128,66,194
tvm,PR-13224,3,1,2,2,4
tvm,PR-13212,2,12,339,11,350
tvm,PR-13206,9,30,3486,46,3532
tvm,PR-13228,1,1,3,0,3
tvm,PR-13129,3,4,297,8,305
tvm,PR-13212,3,12,339,11,350
tvm,PR-13229,1,2,10,11,21
tvm,PR-13230,3,2,14,6,20
tvm,PR-13177,16,13,235,137,372
tvm,PR-13023,3,4,155,45,200
tvm,PR-13024,7,8,346,77,423
tvm,PR-13233,1,15,1002,826,1828
tvm,PR-13012,19,20,783,91,874
tvm,PR-13233,4,17,1024,829,1853
tvm,PR-13023,4,4,155,45,200
tvm,PR-13180,6,1,174,0,174
tvm,PR-12873,12,7,703,6,709
tvm,PR-13177,17,13,239,137,376
tvm,PR-12873,13,7,645,6,651
tvm,PR-13177,18,13,239,137,376
tvm,PR-12873,14,7,645,6,651
tvm,PR-13235,3,2,9,7,16
tvm,PR-13228,2,1,3,0,3
tvm,PR-13236,1,2,133,0,133
tvm,PR-13024,8,6,193,32,225
tvm,PR-13238,1,1,6,5,11
tvm,PR-13130,10,16,3268,73,3341
tvm,PR-13024,9,6,193,32,225
tvm,PR-13217,3,18,4034,122,4156
tvm,PR-13239,1,1,1,1,2
tvm,PR-13241,2,1,31,5,36
tvm,PR-13238,2,1,6,5,11
tvm,PR-13243,1,2,6,1,7
tvm,PR-12842,3,1,1,1,2
tvm,PR-13244,2,1,1,1,2
tvm,PR-13236,2,2,133,0,133
tvm,PR-13024,10,6,193,32,225
tvm,PR-13130,11,16,3285,73,3358
tvm,PR-13177,19,13,239,137,376
tvm,PR-13073,6,15,20,19,39
tvm,PR-13130,12,16,3286,73,3359
tvm,PR-12873,15,7,663,6,669
tvm,PR-13243,2,2,6,1,7
tvm,PR-13243,3,2,6,1,7
tvm,PR-13236,3,2,133,0,133
tvm,PR-13244,3,1,1,1,2
tvm,PR-13177,20,13,239,137,376
tvm,PR-13235,4,2,9,7,16
tvm,PR-13024,11,6,193,32,225
tvm,PR-12842,4,1,1,1,2
tvm,PR-13246,3,4,79,1,80
tvm,PR-13235,6,2,9,23,32
tvm,PR-13247,1,1,1,1,2
tvm,PR-13250,1,5,299,0,299
tvm,PR-13252,1,1,1,0,1
tvm,PR-13254,1,2,35,1,36
tvm,PR-13255,2,2,218,62,280
tvm,PR-13259,4,1,3,1,4
tvm,PR-13256,3,9,1178,205,1383
tvm,PR-13130,13,16,3286,73,3359
tvm,PR-13254,2,2,35,1,36
tvm,PR-13233,6,17,1036,841,1877
tvm,PR-12873,16,7,663,6,669
tvm,PR-13266,3,6,7,11,18
tvm,PR-13267,1,1,9,0,9
tvm,PR-13268,1,1,1,1,2
tvm,PR-13270,1,2,14,0,14
tvm,PR-13260,4,1,18,12,30
tvm,PR-12873,17,7,663,6,669
tvm,PR-13270,2,2,14,0,14
tvm,PR-13268,3,1,1,1,2
tvm,PR-13273,1,2,2,2,4
tvm,PR-13271,4,31,1079,987,2066
tvm,PR-13269,5,1,39,10,49
tvm,PR-13250,2,5,299,0,299
tvm,PR-13269,6,1,39,10,49
tvm,PR-13195,21,32,1308,1475,2783
tvm,PR-13275,3,6,129,11,140
tvm,PR-12915,8,3,187,13,200
tvm,PR-13257,4,1,1,1,2
tvm,PR-13268,4,1,1,1,2
tvm,PR-13254,3,2,37,1,38
tvm,PR-13256,4,9,1178,205,1383
tvm,PR-13277,2,1,8,1,9
tvm,PR-13275,4,6,129,11,140
tvm,PR-13278,1,2,41,6,47
tvm,PR-13271,5,31,1101,1010,2111
tvm,PR-13280,1,1,1,0,1
tvm,PR-13281,1,3,208,13,221
tvm,PR-13269,7,1,39,10,49
tvm,PR-13271,6,33,1120,1011,2131
tvm,PR-13283,1,1,50,5,55
tvm,PR-13282,2,5,320,0,320
tvm,PR-13195,22,34,1311,1481,2792
tvm,PR-13283,2,1,104,5,109
tvm,PR-13283,3,1,104,5,109
tvm,PR-13195,24,34,1311,1481,2792
tvm,PR-13283,4,2,212,97,309
tvm,PR-13289,2,2,45,15,60
tvm,PR-13195,26,29,1207,1424,2631
tvm,PR-13195,27,36,1401,1510,2911
tvm,PR-13256,6,10,1171,206,1377
tvm,PR-13278,3,2,41,6,47
tvm,PR-13267,4,1,9,0,9
tvm,PR-13291,1,1,0,2,2
tvm,PR-13292,1,2,114,20,134
tvm,PR-13294,1,2,136,1,137
tvm,PR-13267,5,2,10,2,12
tvm,PR-13294,2,2,136,1,137
tvm,PR-13294,4,2,136,1,137
tvm,PR-13285,3,1,227,20,247
tvm,PR-13271,7,33,1121,1012,2133
tvm,PR-13283,5,2,230,97,327
tvm,PR-13130,14,12,3093,41,3134
tvm,PR-13294,5,2,136,1,137
tvm,PR-13287,4,3,38,8,46
tvm,PR-13294,6,2,136,1,137
tvm,PR-13283,6,2,239,97,336
tvm,PR-13297,1,2,34,2,36
tvm,PR-13271,9,33,1127,1021,2148
tvm,PR-13294,7,2,136,1,137
tvm,PR-13217,4,14,3849,90,3939
tvm,PR-13298,1,1,48,0,48
tvm,PR-13299,1,19,4395,91,4486
tvm,PR-13294,8,2,136,1,137
tvm,PR-13283,7,2,237,98,335
tvm,PR-13012,20,19,782,90,872
tvm,PR-13300,2,39,10632,1019,11651
tvm,PR-13287,5,4,45,10,55
tvm,PR-13294,9,2,136,1,137
tvm,PR-13301,1,1,19,3,22
tvm,PR-13297,2,3,43,8,51
tvm,PR-13294,10,2,136,1,137
tvm,PR-13294,11,2,136,1,137
tvm,PR-13302,1,1,2,2,4
tvm,PR-13294,12,2,136,1,137
tvm,PR-13294,13,2,136,1,137
tvm,PR-13195,34,61,1965,1852,3817
tvm,PR-13294,14,2,145,1,146
tvm,PR-13195,35,61,1966,1852,3818
tvm,PR-13294,17,2,172,12,184
tvm,PR-13277,3,1,8,1,9
tvm,PR-13256,9,10,1170,206,1376
tvm,PR-13281,2,3,208,13,221
tvm,PR-13305,1,5,12,0,12
tvm,PR-13306,1,2,21,2,23
tvm,PR-13158,7,1,16,1,17
tvm,PR-13159,2,19,264,204,468
tvm,PR-13253,4,4,714,242,956
tvm,PR-13308,1,2,23,1,24
tvm,PR-13195,36,61,1966,1852,3818
tvm,PR-13311,1,1,1,4,5
tvm,PR-13313,2,5,58,7,65
tvm,PR-13301,2,2,87,3,90
tvm,PR-13314,1,2,56,11,67
tvm,PR-13310,4,2,5,3,8
tvm,PR-13313,3,5,57,6,63
tvm,PR-12873,18,7,663,6,669
tvm,PR-13310,5,2,5,3,8
tvm,PR-13317,1,2,27,1,28
tvm,PR-13073,7,16,21,20,41
tvm,PR-13294,18,2,172,12,184
tvm,PR-13301,3,2,87,3,90
tvm,PR-13318,1,2,16,6,22
tvm,PR-13313,4,5,47,6,53
tvm,PR-13319,2,2,7,4,11
tvm,PR-13294,22,2,174,11,185
tvm,PR-13320,2,2,9,5,14
tvm,PR-13254,4,3,10,37,47
tvm,PR-13307,3,4,17,0,17
tvm,PR-13305,3,5,14,0,14
tvm,PR-13309,2,8,247,205,452
tvm,PR-13250,3,7,365,12,377
tvm,PR-13321,1,1,7,0,7
tvm,PR-13323,1,3,42,29,71
tvm,PR-13308,2,2,23,1,24
tvm,PR-13313,5,5,47,6,53
tvm,PR-13325,1,1,0,3,3
tvm,PR-13322,5,2,272,29,301
tvm,PR-13326,1,3,328,191,519
tvm,PR-13324,5,4,209,0,209
tvm,PR-13317,2,3,36,3,39
tvm,PR-13324,9,6,212,6,218
tvm,PR-13317,3,2,32,1,33
tvm,PR-13319,3,4,12,7,19
tvm,PR-13294,23,2,176,11,187
tvm,PR-13294,25,2,119,12,131
tvm,PR-13329,2,2,660,6,666
tvm,PR-13294,26,2,119,12,131
tvm,PR-13309,4,8,247,201,448
tvm,PR-13294,27,2,69,13,82
tvm,PR-13281,3,4,224,29,253
tvm,PR-13326,2,3,326,191,517
tvm,PR-13217,5,14,3849,90,3939
tvm,PR-13322,8,2,301,29,330
tvm,PR-13322,9,2,304,29,333
tvm,PR-13331,4,2,1,10,11
tvm,PR-13332,1,3,38,7,45
tvm,PR-13294,28,2,69,13,82
tvm,PR-12948,12,4,336,7,343
tvm,PR-13334,2,9,194,3,197
tvm,PR-13327,4,14,647,192,839
tvm,PR-13301,4,2,182,2,184
tvm,PR-13336,4,18,73,56,129
tvm,PR-13338,2,2,219,5,224
tvm,PR-13334,3,9,194,3,197
tvm,PR-13338,3,3,221,7,228
tvm,PR-13340,3,1,65,0,65
tvm,PR-13341,2,2,2,1,3
tvm,PR-13342,2,18,110,21,131
tvm,PR-13294,29,2,58,1,59
tvm,PR-12873,19,7,663,6,669
tvm,PR-13339,3,4,330,440,770
tvm,PR-13343,1,2,17,8,25
tvm,PR-12931,16,8,394,1,395
tvm,PR-13336,5,22,77,60,137
tvm,PR-13334,4,9,201,3,204
tvm,PR-13344,1,2,25,36,61
tvm,PR-13332,2,2,26,1,27
tvm,PR-12873,20,7,662,5,667
tvm,PR-13346,1,1,0,6,6
tvm,PR-13347,1,1,6,5,11
tvm,PR-13348,1,1,2,1,3
tvm,PR-12873,21,7,662,5,667
tvm,PR-13345,2,1,18,12,30
tvm,PR-13340,4,1,70,0,70
tvm,PR-13332,3,2,27,1,28
tvm,PR-13353,1,2,67,1,68
tvm,PR-13335,16,9,528,1287,1815
tvm,PR-13354,1,3,42,2,44
tvm,PR-13331,6,5,104,16,120
tvm,PR-13346,3,2,3,1,4
tvm,PR-13282,6,5,321,0,321
tvm,PR-13350,2,1,4,9,13
tvm,PR-13346,5,2,2,0,2
tvm,PR-13356,3,1,21,1,22
tvm,PR-13357,1,4,57,21,78
tvm,PR-13358,1,10,186,114,300
tvm,PR-13327,7,16,652,197,849
tvm,PR-13343,4,8,78,51,129
tvm,PR-13282,7,5,321,0,321
tvm,PR-13358,2,10,186,114,300
tvm,PR-13335,26,9,561,1304,1865
tvm,PR-13347,3,2,15,46,61
tvm,PR-13345,5,2,94,12,106
tvm,PR-13361,2,9,348,341,689
tvm,PR-13362,2,5,593,2,595
tvm,PR-12915,9,3,183,13,196
tvm,PR-13362,3,5,591,2,593
tvm,PR-13363,1,3,3,3,6
tvm,PR-13363,2,6,22,22,44
tvm,PR-13335,27,9,563,1306,1869
tvm,PR-13335,28,9,569,1308,1877
tvm,PR-13365,1,4,15,14,29
tvm,PR-13362,5,21,625,84,709
tvm,PR-13367,1,1,1,1,2
tvm,PR-13362,6,20,627,71,698
tvm,PR-13369,2,2,40,23,63
tvm,PR-13370,1,1,2,2,4
tvm,PR-13372,1,2,56,28,84
tvm,PR-13130,17,14,3342,42,3384
tvm,PR-13367,2,1,1,1,2
tvm,PR-13282,8,5,321,0,321
tvm,PR-12873,22,7,663,5,668
tvm,PR-13335,31,9,571,1308,1879
tvm,PR-13335,34,9,575,1313,1888
tvm,PR-13335,35,10,577,1314,1891
tvm,PR-13335,37,10,579,1311,1890
tvm,PR-13335,38,10,581,1313,1894
tvm,PR-13335,39,10,609,1313,1922
tvm,PR-13335,40,10,609,1313,1922
tvm,PR-13335,43,10,610,1313,1923
tvm,PR-13335,44,10,612,1314,1926
tvm,PR-13335,51,11,658,1321,1979
tvm,PR-13335,52,11,658,1321,1979
tvm,PR-13335,53,11,654,1319,1973
tvm,PR-13335,54,11,654,1319,1973
tvm,PR-13335,55,11,636,1351,1987
tvm,PR-13437,1,1,9,2,11
tvm,PR-13073,11,14,14,14,28
tvm,PR-13431,3,2,10,14,24
tvm,PR-13432,3,4,25,11,36
tvm,PR-13438,2,1,179,85,264
tvm,PR-13300,4,40,10008,1047,11055
tvm,PR-13073,12,13,13,13,26
tvm,PR-13423,9,3,82,0,82
tvm,PR-13300,5,40,10008,1047,11055
tvm,PR-13441,1,2,105,1,106
tvm,PR-13442,1,2,8,6,14
tvm,PR-13444,1,1,7,4,11
tvm,PR-13442,2,3,14,7,21
tvm,PR-13420,4,6,80,21,101
tvm,PR-13445,1,1,2,0,2
tvm,PR-13420,5,6,80,21,101
tvm,PR-13242,26,19,1496,507,2003
tvm,PR-13448,1,4,22,6,28
tvm,PR-13449,2,4,46,4,50
tvm,PR-13442,3,3,14,7,21
tvm,PR-13242,27,18,1626,506,2132
tvm,PR-13420,6,6,81,22,103
tvm,PR-13451,2,1,2,2,4
tvm,PR-13452,1,1,23,5,28
tvm,PR-13454,1,1,4,0,4
tvm,PR-13445,2,1,2,0,2
tvm,PR-13423,10,3,82,0,82
tvm,PR-13073,13,13,15,14,29
tvm,PR-13012,24,18,750,89,839
tvm,PR-13455,1,1,1,1,2
tvm,PR-13456,1,1,3,3,6
tvm,PR-13457,1,1,3,3,6
tvm,PR-13441,2,2,1,2,3
tvm,PR-13073,15,14,13,14,27
tvm,PR-13012,25,19,789,89,878
tvm,PR-13459,6,2,600,135,735
tvm,PR-13453,4,2,76,1,77
tvm,PR-13460,2,1,10,1,11
tvm,PR-13377,11,14,370,232,602
tvm,PR-13073,16,14,13,14,27
tvm,PR-13459,7,2,638,145,783
tvm,PR-13450,6,7,587,3,590
tvm,PR-13463,1,2,74,1,75
tvm,PR-13464,1,1,62,54,116
tvm,PR-13465,1,1,62,54,116
tvm,PR-13463,2,2,79,1,80
tvm,PR-12789,14,4,404,57,461
tvm,PR-13393,15,4,650,0,650
tvm,PR-13469,3,1,53,26,79
tvm,PR-12789,15,5,422,76,498
tvm,PR-13456,2,1,3,3,6
tvm,PR-12789,16,5,418,76,494
tvm,PR-13431,4,3,12,16,28
tvm,PR-13432,5,5,57,11,68
tvm,PR-13377,12,14,391,230,621
tvm,PR-13217,9,6,795,91,886
tvm,PR-13377,13,14,381,230,611
tvm,PR-13469,4,1,56,26,82
tvm,PR-13472,1,2,2,6,8
tvm,PR-13435,2,3,17,2,19
tvm,PR-13468,2,2,13,10,23
tvm,PR-13473,1,1,2,2,4
tvm,PR-13283,10,2,258,98,356
tvm,PR-13315,2,1,13,4,17
tvm,PR-13438,4,4,211,99,310
tvm,PR-13463,4,2,54,1,55
tvm,PR-13217,10,6,796,92,888
tvm,PR-13283,11,2,263,98,361
tvm,PR-13471,4,4,7,4,11
tvm,PR-13474,1,1,0,2,2
tvm,PR-13475,2,3,30,41,71
tvm,PR-13400,5,3,7,7,14
tvm,PR-12789,17,5,412,76,488
tvm,PR-13476,1,1,1,1,2
tvm,PR-13393,16,3,655,0,655
tvm,PR-13410,3,3,67,1,68
tvm,PR-13349,11,23,560,50,610
tvm,PR-13393,17,3,655,0,655
tvm,PR-13349,12,23,560,50,610
tvm,PR-13242,29,18,1644,507,2151
tvm,PR-13377,14,14,382,231,613
tvm,PR-13377,15,14,382,231,613
tvm,PR-13393,19,3,688,0,688
tvm,PR-13402,3,9,569,46,615
tvm,PR-13481,2,3,53,1,54
tvm,PR-13483,1,2,7,19,26
tvm,PR-13393,20,3,688,0,688
tvm,PR-13242,30,18,1644,507,2151
tvm,PR-13481,3,2,52,1,53
tvm,PR-13484,1,4,58,26,84
tvm,PR-13485,1,1,1,1,2
tvm,PR-13393,21,3,688,0,688
tvm,PR-13349,14,18,418,46,464
tvm,PR-13481,4,2,53,1,54
tvm,PR-13486,1,1,1,0,1
tvm,PR-13450,8,8,4858,3,4861
tvm,PR-13393,22,3,688,0,688
tvm,PR-13400,6,3,7,7,14
tvm,PR-13487,1,2,21,14,35
tvm,PR-13484,3,4,70,26,96
tvm,PR-13488,1,2,230,192,422
tvm,PR-13363,5,6,77,46,123
tvm,PR-13393,23,3,688,0,688
tvm,PR-13363,6,6,84,40,124
tvm,PR-13363,9,6,77,49,126
tvm,PR-13489,3,1,9,9,18
tvm,PR-13490,1,1,3,1,4
tvm,PR-13489,4,1,9,9,18
tvm,PR-13489,6,2,13,10,23
tvm,PR-13489,7,2,13,10,23
tvm,PR-13494,6,7,297,26,323
tvm,PR-13495,1,1,6,0,6
tvm,PR-13450,9,8,4858,3,4861
tvm,PR-13496,1,3,37,13,50
tvm,PR-13472,2,2,2,6,8
tvm,PR-13497,1,2,41,33,74
tvm,PR-13488,2,2,230,192,422
tvm,PR-13498,1,4,34,16,50
tvm,PR-13488,3,2,228,192,420
tvm,PR-13465,2,1,62,54,116
tvm,PR-13429,5,2,17,2,19
tvm,PR-13212,4,12,542,11,553
tvm,PR-13299,3,8,557,12,569
tvm,PR-13431,5,3,14,14,28
tvm,PR-13499,1,1,1,1,2
tvm,PR-13504,3,2,18,18,36
tvm,PR-13479,3,3,8,2,10
tvm,PR-13502,4,3,27,7,34
tvm,PR-13503,4,14,15,12,27
tvm,PR-13450,10,8,4750,3,4753
tvm,PR-13450,11,8,4753,3,4756
tvm,PR-13400,9,4,8,8,16
tvm,PR-13498,2,4,39,17,56
tvm,PR-13400,10,5,9,9,18
tvm,PR-13499,3,1,5,3,8
tvm,PR-13256,10,10,1172,206,1378
tvm,PR-13450,12,8,4753,3,4756
tvm,PR-13510,1,9,198,23,221
tvm,PR-13511,1,3,25,13,38
tvm,PR-13256,11,10,1179,206,1385
tvm,PR-13512,1,3,44,0,44
tvm,PR-13513,1,2,8,4,12
tvm,PR-13012,26,19,780,89,869
tvm,PR-13511,2,4,31,13,44
tvm,PR-13514,4,14,570,7,577
tvm,PR-13515,2,4,76,2,78
tvm,PR-13516,1,1,2,4,6
tvm,PR-13518,1,6,117,51,168
tvm,PR-13519,1,2,10,9,19
tvm,PR-13522,1,16,227,29,256
tvm,PR-13469,5,1,56,26,82
tvm,PR-13500,2,9,260,236,496
tvm,PR-13299,4,8,557,16,573
tvm,PR-13523,1,2,2,0,2
tvm,PR-13524,1,1,0,4,4
tvm,PR-13518,2,7,121,53,174
tvm,PR-13469,7,1,52,26,78
tvm,PR-13518,3,7,120,50,170
tvm,PR-13349,15,13,364,25,389
tvm,PR-13450,16,9,4774,4,4778
tvm,PR-13349,17,13,366,25,391
tvm,PR-13400,12,3,5,3,8
tvm,PR-13242,31,18,1725,506,2231
tvm,PR-13522,3,16,406,32,438
tvm,PR-13299,5,7,536,16,552
tvm,PR-13530,5,5,744,419,1163
tvm,PR-13518,6,9,147,51,198
tvm,PR-13522,4,16,411,32,443
tvm,PR-13522,5,16,412,32,444
tvm,PR-13530,6,5,744,419,1163
tvm,PR-13518,7,11,634,121,755
tvm,PR-13518,8,11,638,110,748
tvm,PR-13521,5,3,111,3,114
tvm,PR-13534,4,9,591,6,597
tvm,PR-13299,6,7,536,16,552
tvm,PR-13428,3,1,6,0,6
tvm,PR-13535,3,5,181,17,198
tvm,PR-13534,5,9,591,6,597
tvm,PR-13536,2,2,71,1,72
tvm,PR-13538,1,8,287,4,291
tvm,PR-13530,7,4,745,419,1164
tvm,PR-13522,6,16,412,32,444
tvm,PR-13428,4,1,6,0,6
tvm,PR-13541,2,1,1,1,2
tvm,PR-13538,3,8,288,4,292
tvm,PR-13542,1,109,11,219,230
tvm,PR-13514,7,15,579,11,590
tvm,PR-13530,8,4,751,419,1170
tvm,PR-13283,12,2,263,98,361
tvm,PR-13518,10,11,635,109,744
tvm,PR-13514,8,15,607,11,618
tvm,PR-13514,9,15,599,11,610
tvm,PR-13300,9,41,10432,1179,11611
tvm,PR-13548,1,1,6,5,11
tvm,PR-13536,3,2,71,1,72
tvm,PR-13402,4,9,569,46,615
tvm,PR-13550,1,3,53,0,53
tvm,PR-13521,6,3,111,3,114
tvm,PR-13417,4,3,76,1,77
tvm,PR-13551,1,1,5,1,6
tvm,PR-13529,2,11,69,49,118
tvm,PR-13552,1,1,3,3,6
tvm,PR-13456,3,1,3,3,6
tvm,PR-13300,10,42,10437,1184,11621
tvm,PR-13414,6,3,18,7,25
tvm,PR-13012,27,16,762,89,851
tvm,PR-13300,13,42,10426,1185,11611
tvm,PR-13414,7,3,16,7,23
tvm,PR-13554,1,2,38,22,60
tvm,PR-13242,33,18,1774,506,2280
tvm,PR-13556,1,1,2,2,4
tvm,PR-13557,1,2,77,11,88
tvm,PR-13300,15,42,10428,1185,11613
tvm,PR-12789,18,253,14168,1875,16043
tvm,PR-13558,1,1,1,1,2
tvm,PR-13242,34,19,1775,506,2281
tvm,PR-13562,1,2,5,4,9
tvm,PR-13560,3,2,56,14,70
tvm,PR-13500,4,9,304,280,584
tvm,PR-13522,7,17,412,32,444
tvm,PR-13417,6,3,77,1,78
tvm,PR-12789,19,5,412,76,488
tvm,PR-13522,8,17,372,32,404
tvm,PR-13446,2,5,1698,0,1698
tvm,PR-13514,11,16,657,12,669
tvm,PR-13561,2,9,67,35,102
tvm,PR-13565,2,2,142,7,149
tvm,PR-13566,2,1,1,1,2
tvm,PR-13414,9,3,18,7,25
tvm,PR-13514,14,16,655,11,666
tvm,PR-13561,3,9,67,35,102
tvm,PR-13012,28,16,762,89,851
tvm,PR-13316,3,2,11,3898,3909
tvm,PR-13566,3,1,1,1,2
tvm,PR-13568,1,5,150,81,231
tvm,PR-13565,3,2,142,7,149
tvm,PR-13514,16,17,658,11,669
